cells	sample
AAACCCACAAGTTGGG	Hashtag2
AAACGAAAGAAAGTCT	Negative
AAACGAAAGAGGTATT	Negative
AAACGAAAGTATGAAC	Negative
AAACGAAGTCCTACGG	Hashtag2
AAACGCTAGCTGTTAC	Negative
AAACGCTAGTTCACTG	Negative
AAACGCTGTAGAATGT	Negative
AAAGAACCAATCTCTT	Hashtag2
AAAGAACCACGTACAT	Hashtag2
AAAGAACCATGGCTGC	Negative
AAAGAACGTCCTTGTC	Negative
AAAGAACTCCTAGAGT	Negative
AAAGAACTCCTTTAGT	Negative
AAAGGATAGTTGGAGC	Hashtag2
AAAGGATTCACCCTTG	Negative
AAAGGATTCAGGAGAC	Hashtag2
AAAGGATTCCCGAACG	Negative
AAAGGATTCGTCGACG	Negative
AAAGGGCCAGTTGTCA	Negative
AAAGGGCGTACCAGAG	Negative
AAAGGGCTCACGATAC	Hashtag4
AAAGGGCTCAGAGTGG	Negative
AAAGGGCTCTTGATTC	Negative
AAAGGTAAGCTGACAG	Negative
AAAGGTACAAGACTGG	Negative
AAAGGTACAATACCTG	Negative
AAAGGTAGTCTACATG	Negative
AAAGGTAGTTCACGAT	Negative
AAAGGTATCCTGTAAG	Negative
AAAGTCCGTCAAGTTC	Negative
AAAGTCCTCTTCGACC	Negative
AAAGTGACACTCGATA	Negative
AAAGTGAGTAGCTTAC	Hashtag2
AAAGTGAGTCATCTAG	Hashtag2
AAAGTGAGTTCCTAAG	Negative
AAATGGAAGGTGAGCT	Negative
AAATGGAAGTGTAGTA	Hashtag2
AAATGGAGTAGTGGCA	Hashtag2
AAATGGAGTGCAAGAC	Negative
AAATGGATCATGAAAG	Negative
AAATGGATCCTAGCGG	Hashtag4
AACAAAGAGATTAGTG	Hashtag2
AACAAAGAGTTACGTC	Negative
AACAAAGCACGGTGCT	Negative
AACAAAGTCGTAGAGG	Negative
AACAACCAGTTGCCTA	Negative
AACAACCCAGCTGCCA	Negative
AACAACCGTTGGGACA	Negative
AACAACCTCCAGTGTA	Hashtag2
AACAACCTCCTCAGAA	Negative
AACAAGACACAGTCGC	Negative
AACAAGAGTAGCGATG	Hashtag2
AACAAGAGTTAACAGA	Hashtag4
AACAAGATCCCGAACG	Hashtag2
AACAAGATCGCCATAA	Negative
AACACACAGTCTCCTC	Negative
AACACACCAACTGCCG	Hashtag2
AACACACCAATGAACA	Hashtag2
AACACACCACATTCGA	Negative
AACACACGTTACACTG	Negative
AACAGGGAGCGAACTG	Negative
AACAGGGAGCGAGGAG	Negative
AACAGGGCACCCAAGC	Negative
AACAGGGTCTCCAAGA	Hashtag2
AACAGGGTCTTAGCAG	Negative
AACAGGGTCTTGCGCT	Negative
AACCAACGTGACCGAA	Negative
AACCAACTCATGTCAG	Negative
AACCACAAGGTGCAGT	Negative
AACCACAAGTGGTTAA	Hashtag2
AACCACATCACCCTCA	Negative
AACCACATCCCGAGAC	Negative
AACCACATCGGCACTG	Negative
AACCATGAGAATTCAG	Negative
AACCATGCAAGTGGGT	Negative
AACCATGCACAACGCC	Hashtag2
AACCATGTCAGACCGC	Negative
AACCATGTCATGGCCG	Hashtag2
AACCATGTCGAGTGAG	Hashtag2
AACCCAAAGTAGACAT	Hashtag4
AACCCAAGTATCGCTA	Hashtag2
AACCCAATCGCAAGAG	Negative
AACCTGAAGGTAGACC	Negative
AACCTGACACTTGTGA	Hashtag2
AACCTGACAGAACTTC	Negative
AACCTGACAGCTCTGG	Negative
AACCTGACAGTCTCTC	Negative
AACCTGAGTCTACATG	Negative
AACCTGAGTGGAGGTT	Negative
AACCTTTAGAATCTAG	Hashtag2
AACCTTTAGAGCCATG	Negative
AACCTTTAGTCAGAGC	Negative
AACCTTTCAAGACTGG	Negative
AACCTTTTCATACGAC	Hashtag2
AACCTTTTCGGTGTAT	Negative
AACGAAAAGATGACAT	Hashtag2
AACGAAACAGTCAGCC	Hashtag2
AACGAAAGTAACCAGG	Hashtag2
AACGAAAGTCTCACGG	Negative
AACGAAATCAAGCCTA	Negative
AACGAAATCCGTATGA	Negative
AACGAAATCTAGTGTG	Hashtag4
AACGGGAAGTGATAGT	Hashtag2
AACGGGACACGGCCAT	Negative
AACGGGAGTATAGCTC	Negative
AACGGGAGTCCCTAAA	Hashtag2
AACGGGAGTTTCACAG	Negative
AACGTCAAGCATAGGC	Hashtag2
AACGTCAAGGAAAGGT	Hashtag2
AACGTCAGTACGGCAA	Negative
AACGTCAGTTTACACG	Hashtag2
AACGTCATCATCACCC	Hashtag2
AACGTCATCGTTATCT	Negative
AACTTCTAGCCGAATG	Hashtag2
AACTTCTCAAATCGTC	Negative
AACTTCTCAACCACGC	Hashtag2
AACTTCTCAGTCTCTC	Negative
AACTTCTGTGATACTC	Negative
AACTTCTTCACTTGGA	Negative
AACTTCTTCGGCGATC	Negative
AACTTCTTCTTCCCAG	Negative
AAGAACAAGAAACACT	Negative
AAGAACAAGGTAAGGA	Negative
AAGAACAAGTGGCAGT	Hashtag2
AAGAACAGTTAATCGC	Hashtag2
AAGAACATCGAGATAA	Negative
AAGACAACATAATCCG	Hashtag4
AAGACTCCACGCGGTT	Negative
AAGACTCCATGTTACG	Hashtag2
AAGACTCTCGCCAGTG	Negative
AAGACTCTCGGTGTTA	Negative
AAGATAGCATGTCTAG	Hashtag2
AAGCATCAGACTTCCA	Negative
AAGCATCCATTCAGCA	Negative
AAGCCATAGCGTGTCC	Hashtag2
AAGCCATAGGCATCGA	Negative
AAGCCATAGGCCTTCG	Hashtag4
AAGCCATTCCACGTAA	Negative
AAGCCATTCCCGTGAG	Negative
AAGCCATTCTCTCTAA	Hashtag2
AAGCGAGAGACAGCGT	Negative
AAGCGAGCAACGCCCA	Negative
AAGCGAGCAAGCTCTA	Negative
AAGCGAGCACTATCCC	Negative
AAGCGAGCAGTTAGGG	Hashtag2
AAGCGTTAGCAATAGT	Hashtag2
AAGCGTTCAAATCCCA	Hashtag2
AAGCGTTCAACTGAAA	Negative
AAGCGTTTCCAACTAG	Negative
AAGCGTTTCTGAATGC	Hashtag2
AAGGAATTCCGATAGT	Negative
AAGGAATTCGCCGATG	Negative
AAGGAATTCGTGCACG	Negative
AAGGAATTCTGCGGGT	Hashtag2
AAGGAATTCTTAAGGC	Hashtag2
AAGGTAAAGAAACCCG	Negative
AAGGTAAAGGTAAGTT	Hashtag2
AAGGTAAGTTCCAGGC	Negative
AAGGTAAGTTGGACTT	Negative
AAGTACCCAGGAACCA	Negative
AAGTACCCAGTTGCGC	Negative
AAGTACCGTATGTCCA	Negative
AAGTACCTCCGTCCTA	Hashtag2
AAGTCGTCACTGCGAC	Negative
AAGTGAACACTGAGGA	Negative
AAGTGAAGTCTTGCGG	Negative
AAGTTCGCACGGGTAA	Hashtag2
AAGTTCGCATGGCACC	Negative
AAGTTCGTCGACGCTG	Negative
AAGTTCGTCTCCACTG	Hashtag2
AATAGAGGTCATCGGC	Negative
AATAGAGGTGGACCAA	Negative
AATAGAGTCTCTAAGG	Negative
AATCACGGTATGAGCG	Hashtag2
AATCACGGTGAATGTA	Negative
AATCGACCAAGTGTCT	Hashtag2
AATCGACCATATACCG	Hashtag2
AATCGACGTAGCGTCC	Hashtag2
AATCGACGTCCACACG	Negative
AATCGACGTGGATGAC	Negative
AATCGACTCTACGGTA	Negative
AATCGACTCTCTGCTG	Hashtag4
AATCGTGAGATTGAGT	Negative
AATCGTGGTACCGGCT	Hashtag2
AATCGTGGTATCGTTG	Negative
AATCGTGGTCCTACAA	Negative
AATCGTGGTCGTGATT	Negative
AATCGTGTCCGGACTG	Negative
AATGAAGAGTGGGAAA	Negative
AATGAAGGTATTAAGG	Negative
AATGAAGGTTGACTGT	Negative
AATGACCAGCGATGCA	Negative
AATGACCAGCTACGTT	Negative
AATGACCAGTCCCGGT	Negative
AATGACCCACACACTA	Negative
AATGACCGTCTGCATA	Negative
AATGACCTCGAAACAA	Negative
AATGACCTCGCGCCAA	Hashtag2
AATGCCACAAGTACCT	Hashtag2
AATGCCACATAGATCC	Hashtag2
AATGCCAGTGTAGTGG	Negative
AATGCCATCCCAAGTA	Negative
AATGCCATCGTGGTAT	Negative
AATGGAACAGTAGAAT	Hashtag2
AATGGAAGTGTCCATA	Negative
AATGGAATCACGGGCT	Negative
AATGGAATCATGTCTT	Negative
AATGGCTCAAACTAAG	Hashtag2
AATGGCTCATCTGTTT	Negative
AATTCCTAGCCGTTGC	Negative
AATTCCTCAATCCAGT	Negative
AATTTCCAGATAGCTA	Negative
AATTTCCAGATCCTAC	Negative
AATTTCCCAGGTCCGT	Hashtag2
AATTTCCGTCCCTCAT	Negative
AATTTCCGTGTGATGG	Hashtag2
ACAAAGAAGGTACAGC	Negative
ACAAAGAGTGACAACG	Negative
ACAAAGATCTAAGCCA	Hashtag2
ACAACCACACGCGCAT	Hashtag2
ACAACCACAGGTGAGT	Hashtag2
ACAACCATCTCTATAC	Hashtag2
ACAAGCTCACGAGGTA	Hashtag2
ACAAGCTCAGAAACCG	Hashtag4
ACAAGCTGTAGTGATA	Negative
ACAAGCTGTTGCTCGG	Negative
ACACAGTAGGCAGGTT	Hashtag2
ACACAGTAGGTAGATT	Hashtag4
ACACAGTCAGGACGAT	Negative
ACACAGTCAGGGTTGA	Hashtag2
ACACAGTGTCGTATGT	Negative
ACACAGTGTCTTGAAC	Hashtag2
ACACAGTGTGTTATCG	Negative
ACACCAAAGCTCATAC	Negative
ACACGCGAGGCAGGTT	Hashtag2
ACACGCGAGGCTAAAT	Negative
ACACGCGGTAATTAGG	Hashtag2
ACACGCGGTTAACCTG	Negative
ACACTGAAGACTGTTC	Hashtag2
ACACTGACAGCCTTCT	Negative
ACACTGATCACTGAAC	Negative
ACACTGATCGAAGCAG	Hashtag2
ACACTGATCTCGACGG	Hashtag2
ACAGAAAAGGTAGATT	Negative
ACAGAAAGTACAGGTG	Hashtag2
ACAGAAAGTCACTAGT	Negative
ACAGAAATCGTGGTAT	Negative
ACAGCCGAGCCGAATG	Hashtag2
ACAGCCGAGGTCATCT	Negative
ACAGCCGCAAGTACCT	Hashtag2
ACAGGGACAGGCTTGC	Negative
ACAGGGACATCTCCCA	Negative
ACATCCCAGCATTGTC	Hashtag2
ACATCCCAGGACAACC	Negative
ACATCCCCACTACACA	Hashtag2
ACATCCCTCGCACGAC	Hashtag4
ACATCGAAGCACACAG	Negative
ACATCGAGTCACCGCA	Negative
ACATGCAAGCACGTCC	Hashtag2
ACATGCAAGTAGGTTA	Negative
ACATGCACAGGAACCA	Negative
ACATGCAGTAGGAGTC	Negative
ACATGCATCCGCGAGT	Negative
ACATTTCAGTGAGTGC	Negative
ACATTTCCAACCCTCT	Hashtag2
ACATTTCGTCATCCCT	Hashtag2
ACCAAACCAAGTGCTT	Negative
ACCAAACGTAACCCTA	Negative
ACCAAACGTGACTGAG	Negative
ACCAAACTCACATCAG	Negative
ACCAAACTCTTCGGTC	Hashtag2
ACCAACAAGATCCTAC	Negative
ACCAACAAGTCTAACC	Negative
ACCAACACATGTTCAG	Negative
ACCAACAGTCGCACAC	Negative
ACCAACAGTTACTCAG	Negative
ACCAACATCAAGGCTT	Negative
ACCACAAAGTCGAAGC	Hashtag2
ACCACAACACAGACGA	Negative
ACCACAACATGTGGCC	Hashtag2
ACCACAAGTCACGCTG	Negative
ACCATTTCACTGGCGT	Negative
ACCATTTTCGATTTCT	Negative
ACCATTTTCGCACGAC	Negative
ACCCAAAAGATGAAGG	Negative
ACCCAAAAGCTTAGTC	Negative
ACCCAAAAGGAGACCT	Negative
ACCCAAACATAAGCAA	Hashtag2
ACCCAAAGTACTTGTG	Negative
ACCCAAAGTGAATGAT	Hashtag2
ACCCAAAGTTGGATCT	Hashtag2
ACCCAAATCCCTTGGT	Negative
ACCCTCAAGCTGACTT	Negative
ACCCTCATCCCAGGCA	Negative
ACCCTCATCTACGGTA	Hashtag2
ACCCTCATCTCACCCA	Hashtag2
ACCCTTGAGGATATAC	Hashtag2
ACCCTTGCACTTCTCG	Negative
ACCCTTGCATGGCGCT	Negative
ACCGTTCCACATGTTG	Negative
ACCGTTCGTGCCCACA	Negative
ACCGTTCGTGTGGTCC	Negative
ACCTACCAGCCATGCC	Negative
ACCTACCAGGTGAGAA	Negative
ACCTACCAGTGGTGAC	Negative
ACCTACCCAAGCGAAC	Negative
ACCTACCTCAGACCGC	Hashtag2
ACCTGAAAGGACATCG	Negative
ACCTGAAAGGTCGTAG	Negative
ACCTGAAGTCGTGATT	Negative
ACCTGTCAGGAAGTAG	Negative
ACCTGTCAGGGTGGGA	Negative
ACCTGTCCAATCGCGC	Negative
ACCTGTCCACGCGGTT	Hashtag2
ACGATCATCATGAGGG	Hashtag2
ACGATCATCGACATTG	Negative
ACGATCATCTCACTCG	Negative
ACGATCATCTTTCCAA	Negative
ACGATGTCAATAACGA	Negative
ACGATGTGTACGCTAT	Negative
ACGATGTTCATAAGGA	Negative
ACGCACGAGATAACGT	Negative
ACGCACGAGCCATGCC	Hashtag2
ACGCACGAGTTCGGTT	Hashtag2
ACGCACGCACTACCGG	Negative
ACGCACGTCGTTCTGC	Hashtag2
ACGGAAGCATTGAGGG	Negative
ACGGAAGGTGATTCTG	Negative
ACGGAAGTCTGACGCG	Hashtag2
ACGGGTCAGAAACCCG	Negative
ACGGGTCAGGGCCTCT	Negative
ACGGGTCAGGTTTACC	Hashtag2
ACGGGTCCAACAACAA	Negative
ACGGGTCCACGACAAG	Negative
ACGGGTCGTACACGTT	Negative
ACGGGTCGTCCTCCAT	Hashtag2
ACGGGTCTCACCTCTG	Negative
ACGGGTCTCCGACATA	Hashtag2
ACGGTCGAGAAGTCCG	Negative
ACGGTCGAGGGTCTTT	Negative
ACGGTTATCAGACATC	Negative
ACGGTTATCGATTGAC	Negative
ACGTAACAGCGCCGTT	Negative
ACGTAACCAGGATTCT	Negative
ACGTAACCATCGTGGC	Negative
ACGTAACTCCACGAAT	Negative
ACGTACACAGCGGATA	Negative
ACGTACAGTAGAGCTG	Hashtag2
ACGTACAGTGCATGTT	Negative
ACGTACAGTTGATGTC	Negative
ACGTACATCACCCTCA	Negative
ACGTAGTAGCGCCTCA	Negative
ACGTAGTAGTGAGTGC	Negative
ACGTAGTCAAATCAGA	Hashtag2
ACGTAGTCAACGATTC	Hashtag4
ACGTAGTCAAGATCCT	Negative
ACGTAGTGTATGCAAA	Negative
ACGTCCTAGGCACTAG	Hashtag2
ACGTCCTCATCCAATG	Negative
ACGTCCTGTCAAGTTC	Negative
ACGTCCTGTGAAGCGT	Negative
ACGTCCTGTGAGACGT	Negative
ACGTCCTGTGGCTTGC	Negative
ACGTCCTGTGGTCTAT	Negative
ACGTCCTGTTCCACAA	Hashtag2
ACGTCCTTCTGTGCAA	Hashtag2
ACGTTCCGTTTACCTT	Hashtag2
ACGTTCCTCGAGAGAC	Negative
ACTACGACACACCGAC	Negative
ACTACGATCCGCACGA	Negative
ACTATCTCACCTGTCT	Negative
ACTCCCAAGAGCCATG	Negative
ACTCCCAAGCAATTCC	Hashtag2
ACTCCCAAGGGACCAT	Negative
ACTCCCAAGTCTCGTA	Hashtag2
ACTCCCAAGTTGCGAG	Negative
ACTCCCACACGCGCTA	Hashtag2
ACTCCCACATCCTAAG	Negative
ACTCCCAGTAGCGAGT	Negative
ACTCTCGGTAGCGCCT	Negative
ACTCTCGTCTCATGGA	Negative
ACTCTCGTCTCGGTCT	Hashtag2
ACTGATGAGCAGGTCA	Hashtag2
ACTGATGGTGCCTATA	Negative
ACTGATGGTTCCGCAG	Negative
ACTGATGGTTGTGCCG	Negative
ACTGCAAAGAGCAGAA	Hashtag2
ACTGCAAAGTCCCTAA	Negative
ACTGCAACAAGAGCTG	Negative
ACTGCAATCAGCGCAC	Negative
ACTGTCCAGCGATCGA	Negative
ACTGTCCAGCTGCCAC	Hashtag2
ACTGTCCAGGTTAAAC	Hashtag2
ACTGTCCGTAGCCAGA	Hashtag2
ACTGTCCTCACTGGGC	Hashtag2
ACTGTCCTCGCGGACT	Negative
ACTGTCCTCTGGCTGG	Negative
ACTGTGAGTCAAGCGA	Negative
ACTGTGATCAATCCAG	Negative
ACTGTGATCGTGGAAG	Hashtag2
ACTGTGATCTGTAAGC	Hashtag2
ACTTAGGCACTCTAGA	Hashtag2
ACTTAGGCATAATGCC	Negative
ACTTAGGGTCGCGGTT	Hashtag2
ACTTAGGTCATCACCC	Negative
ACTTATCCAGCCTATA	Negative
ACTTATCGTATACGGG	Negative
ACTTATCTCGTCTACC	Negative
ACTTCCGAGCAATTAG	Negative
ACTTCCGAGCATGTTC	Negative
ACTTCGCAGACAGCGT	Negative
ACTTCGCAGAGGACTC	Negative
ACTTCGCTCGCGTGCA	Negative
ACTTTCAAGAGTTGAT	Negative
ACTTTCAAGCGTGAAC	Negative
ACTTTCACAAGTGACG	Hashtag2
ACTTTCAGTGAGTTGG	Negative
ACTTTCATCTTTCGAT	Hashtag2
ACTTTGTCAAATAGCA	Hashtag2
ACTTTGTCAAGTGGTG	Negative
ACTTTGTCAATGTGGG	Hashtag2
ACTTTGTGTCTAGTGT	Hashtag2
ACTTTGTGTGGAAATT	Hashtag2
ACTTTGTGTTCAACGT	Negative
ACTTTGTTCAGACCTA	Negative
ACTTTGTTCAGCGCGT	Hashtag2
ACTTTGTTCCCATTTA	Negative
AGAAATGAGACGGTTG	Hashtag2
AGAAATGCACTTGAAC	Hashtag2
AGAAATGTCCGCTTAC	Hashtag2
AGAACAAAGCCACTCG	Negative
AGAACAACAACAGCTT	Negative
AGAACAACAGCATACT	Hashtag2
AGAACAATCCAATGCA	Negative
AGAACCTCACAGCCAC	Hashtag2
AGAACCTCAGTCTCTC	Negative
AGAACCTTCAGGCGAA	Negative
AGAAGCGAGGGCTAAC	Negative
AGAAGCGCAGGAGGAG	Hashtag2
AGAAGCGGTGGCTTAT	Negative
AGAAGCGTCATTGTGG	Hashtag2
AGAAGCGTCGCTAAAC	Negative
AGAAGTACAGGTGTTT	Negative
AGAAGTACAGTTCTAG	Negative
AGAAGTATCACCTCAC	Negative
AGACAAACAGAGAGGG	Negative
AGACAAAGTAAGTCAA	Negative
AGACAAAGTCGAACAG	Negative
AGACAAAGTGACGCCT	Hashtag2
AGACAAATCGCCTTTG	Negative
AGACACTAGAGAAGGT	Hashtag2
AGACACTCACCCTGAG	Negative
AGACACTGTCAGACTT	Negative
AGACACTGTCCTTTGC	Negative
AGACAGGAGAAATTCG	Hashtag2
AGACAGGAGAAGGCTC	Negative
AGACAGGAGGGCAGAG	Negative
AGACAGGAGTCACTCA	Negative
AGACAGGGTCCCTCAT	Hashtag2
AGACAGGTCACCGACG	Negative
AGACCATGTTAAACCC	Hashtag2
AGACCCGAGATCGACG	Negative
AGACCCGCAAATGGCG	Hashtag2
AGACCCGCAATCTGCA	Negative
AGACCCGCATACCAGT	Negative
AGACCCGCATTGGGAG	Negative
AGACTCAAGCGTTCAT	Negative
AGACTCAAGTTTGTCG	Negative
AGACTCACACGCGCAT	Negative
AGAGAATAGGTAGCCA	Negative
AGAGAATAGGTTCCAT	Negative
AGAGAATGTGAGTTTC	Hashtag2
AGAGAATGTTTCGACA	Hashtag2
AGAGAATTCAGCGTCG	Negative
AGAGAGCAGCTAGAGC	Hashtag2
AGAGAGCCAGTTCACA	Negative
AGAGAGCCATGCAGGA	Negative
AGAGCAGAGAGCATCG	Negative
AGAGCAGAGAGTACCG	Hashtag2
AGAGCAGGTCAGCTTA	Negative
AGAGCAGTCCTATTTG	Hashtag2
AGAGCCCCATCGATCA	Negative
AGAGCCCGTCGATTAC	Hashtag2
AGAGCCCGTGAATGTA	Negative
AGAGCCCTCCCATGGG	Negative
AGAGCCCTCCGGCAGT	Negative
AGATAGACACTCAGAT	Hashtag2
AGATAGACATACCACA	Hashtag2
AGATCCAAGCCACTCG	Hashtag2
AGATCCACAATGTGGG	Hashtag4
AGATCCACAGACATCT	Negative
AGATCCAGTTGTCCCT	Negative
AGATCGTAGACCAAAT	Negative
AGATCGTAGCGGTAGT	Hashtag2
AGATCGTAGCTTTGTG	Negative
AGATCGTCATTGACAC	Negative
AGATCGTGTACACGTT	Negative
AGATCGTTCACTACGA	Hashtag2
AGATGAAGTCTCTCTG	Hashtag2
AGATGAATCCGTTGGG	Negative
AGATGCTAGATCGGTG	Hashtag2
AGATGCTTCATAAGGA	Negative
AGATGCTTCATCACCC	Negative
AGATGCTTCCGCGGAT	Negative
AGCATCAAGCTTAAGA	Negative
AGCATCACAAGCCCAC	Hashtag2
AGCATCAGTCGCATGC	Negative
AGCCAATAGCCTCTTC	Negative
AGCCAATAGCTAGAAT	Hashtag2
AGCCAATCAGACACAG	Hashtag2
AGCCAATTCCCGTGTT	Negative
AGCCAATTCCTTTGAT	Negative
AGCCACGAGCTGAAGC	Hashtag2
AGCCACGAGGACAACC	Negative
AGCCACGCAGCAGTGA	Negative
AGCCACGGTAGTCGTT	Hashtag2
AGCCAGCAGTCTAGAA	Negative
AGCCAGCCACAGTGTT	Hashtag2
AGCCAGCGTTCTAAGC	Hashtag2
AGCGATTAGTGTTCCA	Negative
AGCGATTCACCTTCGT	Negative
AGCGATTCAGGTCAGA	Hashtag2
AGCGATTCATTCGATG	Negative
AGCGATTTCGGTCGGT	Negative
AGCGCCAAGGACCCAA	Negative
AGCGCCACACTGGACC	Hashtag2
AGCGCCAGTGCACGCT	Negative
AGCGCCAGTTGGGTAG	Negative
AGCGCTGAGCAACCAG	Negative
AGCGCTGAGGGCAACT	Negative
AGCGCTGAGTTCCGGC	Hashtag2
AGCGCTGCAGATGCGA	Hashtag2
AGCGCTGGTAGCCCTG	Negative
AGCGCTGGTATGATCC	Negative
AGCGCTGGTTACACAC	Negative
AGCGCTGTCAAGCTGT	Negative
AGCGCTGTCAGGTAAA	Negative
AGCGTATAGTGCACAG	Hashtag2
AGCGTATGTCGTTGCG	Hashtag2
AGCGTATGTGCATGAG	Hashtag2
AGCGTATGTGTTAAAG	Negative
AGCGTATTCCATATGG	Negative
AGCGTATTCCGTATGA	Hashtag2
AGCGTCGGTAACAAGT	Negative
AGCTACAAGGTAAGTT	Negative
AGCTACAGTCCCTGAG	Negative
AGCTACAGTGTCACAT	Negative
AGCTCAAAGAAGTCAT	Hashtag2
AGCTCAAAGCGAAACC	Negative
AGCTCAAAGTATTAGG	Hashtag2
AGCTCAATCCAATGCA	Hashtag2
AGCTCAATCTGGGCGT	Negative
AGCTTCCGTCAAGTTC	Negative
AGCTTCCGTGAGAGGG	Negative
AGCTTCCTCCATCTGC	Negative
AGCTTCCTCCGATCTC	Hashtag4
AGGAAATAGCAATAAC	Negative
AGGAAATAGGGAGGCA	Negative
AGGAAATAGTCCCGAC	Negative
AGGAAATGTAGGACCA	Negative
AGGAAATGTCAACGCC	Hashtag2
AGGAAATTCACACGAT	Negative
AGGAAATTCCCATTCG	Hashtag2
AGGAATAAGCATGGGT	Negative
AGGAATAAGCGTGTCC	Negative
AGGAATAAGGGAGTGG	Hashtag2
AGGAATACACGGTGCT	Hashtag2
AGGAATAGTACTCAAC	Hashtag2
AGGAATAGTCCAGCCA	Hashtag2
AGGAATAGTTGTTGTG	Hashtag2
AGGAATATCCGGTAAT	Negative
AGGACGAAGTACAGAT	Negative
AGGACGAAGTGGACGT	Negative
AGGACGAGTCCCGTGA	Hashtag2
AGGACGATCTTTCGAT	Negative
AGGACTTAGAAGTGTT	Hashtag2
AGGACTTAGCACCGTC	Negative
AGGACTTCAAGATGTA	Negative
AGGACTTCACCAGCTG	Negative
AGGACTTCAGTCAGTT	Hashtag2
AGGACTTTCATGAGGG	Negative
AGGACTTTCCAGTGCG	Hashtag2
AGGAGGTCAGCTGTGC	Negative
AGGATAAAGATTCGAA	Negative
AGGATAACAAGGTCAG	Hashtag2
AGGATAACACAAATAG	Hashtag2
AGGATAACACCGTCTT	Hashtag2
AGGATAACACGCTATA	Negative
AGGATAAGTGACATCT	Hashtag2
AGGATAAGTTACCCAA	Negative
AGGATCTAGCTTGTTG	Hashtag2
AGGATCTGTCTTCAAG	Negative
AGGATCTGTGAGTCAG	Hashtag2
AGGATCTGTGCTGATT	Negative
AGGCATTAGGCAGCTA	Negative
AGGCATTAGTTTCGAC	Negative
AGGCATTGTAAGTAGT	Negative
AGGCATTGTTGCATAC	Negative
AGGCCACAGGCCCACT	Negative
AGGCCACAGTATCTGC	Negative
AGGCCACCACAATTCG	Hashtag2
AGGCCACGTATCGTAC	Negative
AGGCCACTCCAGTTCC	Hashtag2
AGGCTGCAGAGCCGTA	Hashtag2
AGGCTGCGTCCGGATC	Negative
AGGCTGCGTCTACTGA	Negative
AGGCTGCTCCCGATCT	Negative
AGGCTGCTCGATCCAA	Negative
AGGCTGCTCGCCTATC	Negative
AGGCTGCTCTGCCCTA	Hashtag2
AGGGAGTCAACCCGCA	Hashtag2
AGGGAGTCATGGATCT	Negative
AGGGAGTCATTAAGCC	Hashtag2
AGGGCCTAGCGGCTCT	Negative
AGGGCCTAGGATTTAG	Negative
AGGGCCTAGTCCTGCG	Negative
AGGGCCTAGTTTCAGC	Negative
AGGGCCTGTGAATATG	Negative
AGGGCTCAGTAACCGG	Negative
AGGGCTCCATGTGACT	Negative
AGGGCTCGTACAATAG	Negative
AGGGCTCGTCGGTGAA	Negative
AGGGCTCGTTATGTGC	Negative
AGGGCTCTCTCTATGT	Negative
AGGGTCCAGGCCTGCT	Negative
AGGGTCCAGTGCACAG	Hashtag2
AGGGTCCCAAACCATC	Negative
AGGGTCCTCCCATAGA	Negative
AGGGTCCTCGGAAGGT	Negative
AGGGTGAAGATGGTAT	Negative
AGGGTGAAGGTCCTGC	Negative
AGGGTGACAACCCTAA	Negative
AGGGTGACAAGGATGC	Hashtag2
AGGGTGATCCCATGGG	Negative
AGGGTGATCCCATTTA	Hashtag2
AGGGTGATCCTCACTG	Negative
AGGGTTTCAAGCTACT	Hashtag2
AGGGTTTGTCCAAGAG	Negative
AGGGTTTGTTCTTCAT	Hashtag2
AGGGTTTTCCTAACAG	Hashtag2
AGGGTTTTCGCGTGCA	Negative
AGGTAGGCACCTCTGT	Negative
AGGTAGGCATTGACAC	Hashtag2
AGGTAGGGTGTCCGGT	Hashtag2
AGGTAGGTCTTCCAGC	Negative
AGGTCATAGAGTAACT	Hashtag2
AGGTCATAGCGCTTCG	Negative
AGGTCATCAAAGTGTA	Hashtag2
AGGTCATCACTCTGCT	Negative
AGGTCTAAGACGACTG	Negative
AGGTCTAAGGAGTATT	Negative
AGGTCTAAGTCCCGGT	Hashtag2
AGGTCTACAATCGAAA	Negative
AGGTCTACATCCAACA	Hashtag2
AGGTCTACATCTCGTC	Negative
AGGTCTAGTCCATAGT	Negative
AGGTCTAGTGTTGCCG	Hashtag2
AGGTCTATCCGCACTT	Hashtag2
AGGTGTTAGAAGCGGG	Negative
AGGTGTTAGAGAGCAA	Negative
AGGTGTTCATAAGCGG	Negative
AGGTGTTGTACAGGTG	Hashtag2
AGGTGTTGTTACCTGA	Negative
AGGTGTTTCTCCCAAC	Negative
AGGTTACAGGTACATA	Hashtag2
AGGTTACGTAAGATAC	Hashtag2
AGGTTACTCGGCATAT	Hashtag2
AGGTTGTAGCCTCTCT	Negative
AGGTTGTGTCCATAGT	Negative
AGGTTGTTCGATTTCT	Negative
AGTAACCAGGACAAGA	Hashtag2
AGTAACCCATACTGTG	Negative
AGTAACCGTGAAAGTT	Negative
AGTAACCGTTACCTTT	Negative
AGTAACCGTTGCCATA	Hashtag2
AGTAACCTCCCTGTTG	Negative
AGTAACCTCCTGGCTT	Negative
AGTACCAAGTCAACAA	Hashtag2
AGTACCATCATTGCTT	Negative
AGTACTGAGCCTATCA	Hashtag2
AGTACTGAGTGAATAC	Negative
AGTAGCTAGAATGTTG	Hashtag2
AGTAGCTAGTCGGCAA	Hashtag4
AGTAGCTCACCTCAGG	Negative
AGTAGCTTCAAGGACG	Negative
AGTAGCTTCAATCTCT	Negative
AGTAGCTTCATGTCAG	Hashtag2
AGTAGTCAGACGAGCT	Negative
AGTAGTCAGCTTTCCC	Negative
AGTAGTCCACCCTATC	Negative
AGTAGTCCAGTCAGCC	Negative
AGTAGTCGTTGCATAC	Hashtag2
AGTAGTCTCTTAGGAC	Hashtag2
AGTCAACGTATCGATC	Negative
AGTCAACTCCCTTCCC	Hashtag2
AGTCACAAGCGCGTTC	Negative
AGTCACAAGTGAGGCT	Hashtag2
AGTCACACACCCTGTT	Hashtag2
AGTCACACATTCTCCG	Hashtag2
AGTCATGCAAGGATGC	Negative
AGTCATGCACTCAGAT	Negative
AGTCATGCACTGGACC	Negative
AGTCATGGTTCTCCTG	Negative
AGTCTCCAGACCAGAC	Hashtag2
AGTCTCCCAGGTATGG	Negative
AGTCTCCGTACGCGTC	Negative
AGTCTCCTCACGGTCG	Negative
AGTGACTAGGACGCTA	Hashtag4
AGTGACTCACACCTTC	Hashtag2
AGTGACTCATGAGATA	Negative
AGTGACTCATTGAAGA	Negative
AGTGACTTCTGCGAGC	Hashtag2
AGTGATCAGCGTGTCC	Hashtag2
AGTGATCCAAGAAATC	Negative
AGTGATCCAAGTATCC	Negative
AGTGATCCACATTCGA	Negative
AGTGATCCATGCGTGC	Negative
AGTGATCGTCTAGATC	Negative
AGTGATCGTCTTAGTG	Negative
AGTGATCGTTAGGGAC	Negative
AGTGATCTCTTAGCAG	Hashtag2
AGTGCCGAGAGTACCG	Negative
AGTGCCGCACAGTCGC	Hashtag2
AGTGCCGCATCCTTCG	Negative
AGTGCCGGTCAAAGTA	Hashtag2
AGTGCCGTCGCGATCG	Hashtag2
AGTGTTGAGGTGAGAA	Negative
AGTGTTGCAACGATCT	Negative
AGTGTTGCATTCGGGC	Negative
AGTGTTGGTCACCCTT	Negative
AGTGTTGTCGATTTCT	Hashtag2
AGTTAGCAGCCATATC	Negative
AGTTAGCAGTGCTACT	Negative
AGTTAGCAGTTACGAA	Hashtag2
AGTTAGCCATGACTAC	Negative
AGTTAGCGTAACTAAG	Negative
AGTTAGCGTATGGTTC	Negative
AGTTAGCGTCTACAAC	Negative
AGTTCCCCAAATACGA	Negative
AGTTCCCTCTTGCAAG	Negative
AGTTCGAAGTGGATAT	Negative
AGTTCGACAGGCGAAT	Negative
AGTTCGAGTGGACTGA	Negative
ATACCGAAGAGATCGC	Hashtag2
ATACCGAGTCTTCCGT	Negative
ATACCTTCACGGCACT	Hashtag2
ATACCTTCAGTCGAGA	Hashtag2
ATACCTTTCTAGATCG	Negative
ATACCTTTCTGGTTGA	Negative
ATACTTCGTACCGGCT	Hashtag2
ATACTTCTCTAGACCA	Negative
ATACTTCTCTCGGTAA	Negative
ATACTTCTCTTCGGAA	Negative
ATAGACCAGATTAGCA	Negative
ATAGACCAGTGCCAGA	Negative
ATAGACCCAAGACGAC	Negative
ATAGACCGTCAAAGAT	Hashtag2
ATAGACCTCACCGCTT	Hashtag2
ATAGACCTCGTTGTGA	Hashtag2
ATAGAGAGTATCGTTG	Hashtag2
ATAGAGAGTCCGGCAT	Hashtag4
ATAGAGATCCCGGTAG	Negative
ATAGGCTCACGCTATA	Hashtag2
ATATCCTAGCACGTCC	Negative
ATATCCTCAAAGGAGA	Negative
ATATCCTTCTGCGTCT	Negative
ATATCCTTCTTTGCAT	Negative
ATCACAGAGTAGTCCT	Negative
ATCACAGAGTGCTAGG	Hashtag4
ATCACAGGTGCGGATA	Negative
ATCACGACATCCTATT	Hashtag2
ATCACGAGTTGGGTTT	Negative
ATCACGATCGATGGAG	Negative
ATCACGATCTGCAGCG	Negative
ATCACTTAGCGAGTAC	Hashtag2
ATCACTTCAAATAAGC	Negative
ATCACTTCAGACACAG	Negative
ATCACTTCATGGCTGC	Hashtag2
ATCACTTGTCTCAAGT	Hashtag2
ATCACTTGTGCATGTT	Hashtag2
ATCACTTGTTCGGACC	Negative
ATCAGGTCAGGAATAT	Hashtag2
ATCAGGTGTTCCGGTG	Hashtag2
ATCAGGTGTTGAGGAC	Negative
ATCAGGTTCCGCGAGT	Negative
ATCATTCGTTGCTAGT	Negative
ATCATTCTCAAGGCTT	Negative
ATCATTCTCAGGGTAG	Negative
ATCCACCCAGACCAAG	Hashtag2
ATCCACCGTCTGGTTA	Hashtag2
ATCCATTGTCGTAATC	Negative
ATCCATTGTTGACTGT	Negative
ATCCATTTCGGTAGGA	Hashtag2
ATCCCTGAGCAGGGAG	Hashtag2
ATCCCTGCAAGAAATC	Negative
ATCCCTGCATCAGCTA	Negative
ATCCCTGTCTAGACCA	Hashtag2
ATCCGTCAGCACCGTC	Negative
ATCCGTCCACTTGGCG	Hashtag2
ATCCGTCGTAACATCC	Negative
ATCCTATCACGCACCA	Hashtag2
ATCCTATGTAGCACGA	Hashtag2
ATCCTATTCACGACTA	Negative
ATCCTATTCAGCTGAT	Negative
ATCGATGAGGTAATCA	Negative
ATCGATGGTGCAGGAT	Hashtag2
ATCGATGGTGCATTTG	Negative
ATCGATGGTTCGTTCC	Negative
ATCGCCTAGCAAGCCA	Hashtag2
ATCGCCTAGGGCGAGA	Hashtag4
ATCGCCTTCAGACCGC	Hashtag2
ATCGCCTTCTCATTTG	Negative
ATCGGATCAATGGCAG	Negative
ATCGGATCACAATGCT	Negative
ATCGGATGTAGAAACT	Hashtag2
ATCGGATGTTGGGATG	Hashtag2
ATCGGATTCACCGGTG	Negative
ATCGGATTCGGAACTT	Negative
ATCGGATTCGTTCATT	Negative
ATCGGCGCAACACGTT	Negative
ATCGGCGCACACGTGC	Negative
ATCGGCGCACTCAAGT	Negative
ATCGGCGCATTCTCTA	Hashtag2
ATCGGCGTCATCACTT	Negative
ATCGGCGTCTTCGGTC	Hashtag2
ATCGTAGAGACAGCTG	Negative
ATCGTAGAGGGCAGGA	Hashtag4
ATCGTAGCAATCGCAT	Hashtag2
ATCGTAGGTGAAAGTT	Negative
ATCGTAGTCAGACCCG	Negative
ATCGTAGTCAGCCTCT	Negative
ATCGTCCCAATACAGA	Negative
ATCGTCCGTGGGCTTC	Negative
ATCGTCCTCTGAGTCA	Negative
ATCGTGACAGCACAAG	Negative
ATCGTGACATTGTACG	Negative
ATCGTGAGTACTTCCC	Hashtag2
ATCGTGAGTCCCGCAA	Negative
ATCGTGATCTTTCAGT	Negative
ATCTCTAAGTCACACT	Hashtag2
ATCTCTATCATCCTGC	Hashtag4
ATCTCTATCGCTGTTC	Negative
ATCTCTATCGGTCTGG	Negative
ATCTCTATCTCGGCTT	Hashtag2
ATCTTCAAGCTGACTT	Hashtag2
ATCTTCACAGACGCTC	Negative
ATCTTCACAGGACTAG	Negative
ATCTTCAGTAGCTGCC	Hashtag2
ATCTTCATCGGTGTTA	Hashtag2
ATGAAAGAGGACATCG	Negative
ATGAAAGAGTCGGCCT	Negative
ATGACCACAACAGTGG	Hashtag2
ATGACCACAGTATTCG	Negative
ATGACCATCATCAGTG	Negative
ATGACCATCCAACTAG	Negative
ATGAGGGAGGTTCTTG	Hashtag2
ATGAGGGCAACGAGGT	Hashtag2
ATGAGGGCAGGCCTGT	Negative
ATGAGGGGTGCTGTCG	Negative
ATGAGGGGTTAACCTG	Negative
ATGAGGGTCAGCGCAC	Hashtag2
ATGAGGGTCGGTAGGA	Hashtag4
ATGAGTCAGTCACGAG	Negative
ATGAGTCCACACCTGG	Negative
ATGAGTCGTCGTACAT	Hashtag2
ATGAGTCGTCTTTCTA	Hashtag2
ATGAGTCGTGCCCTTT	Hashtag2
ATGATCGCACACCAGC	Negative
ATGATCGCAGGTTACT	Hashtag4
ATGATCGTCACCTTAT	Hashtag2
ATGCATGCACCTGCGA	Hashtag2
ATGCATGGTCAGACGA	Negative
ATGCATGGTCCATACA	Negative
ATGCATGGTGGTTTGT	Negative
ATGCCTCAGCTAATGA	Hashtag2
ATGCCTCAGCTGACCC	Negative
ATGCCTCAGGAGCTGT	Hashtag2
ATGCCTCAGGATTCCT	Negative
ATGCCTCGTACCCGCA	Hashtag2
ATGCCTCGTCGTAATC	Hashtag2
ATGCCTCGTGCATCTA	Negative
ATGCCTCTCAGGAAAT	Negative
ATGCCTCTCAGGACGA	Negative
ATGCCTCTCGTGTGGC	Negative
ATGCCTCTCTCCGATC	Negative
ATGCGATAGACCATAA	Negative
ATGCGATCACTCCTTG	Hashtag2
ATGCGATGTAACCCGC	Hashtag2
ATGCGATGTACCCGAC	Negative
ATGCGATTCAGACTGT	Hashtag2
ATGGAGGCACGAAAGC	Negative
ATGGAGGGTGGGACAT	Negative
ATGGAGGGTTGTAAAG	Negative
ATGGAGGTCAGCGGAA	Negative
ATGGAGGTCTCTCAAT	Negative
ATGGATCCAGTCGCTG	Negative
ATGGATCGTCAGGTAG	Negative
ATGGGAGGTGCGGTAA	Negative
ATGGGAGGTGTGTCCG	Hashtag2
ATGGGAGTCAAGGACG	Negative
ATGGGTTAGTCATACC	Negative
ATGGTTGAGCGTATGG	Hashtag2
ATGGTTGAGGATCATA	Negative
ATGGTTGAGTTGTACC	Hashtag2
ATGGTTGGTACTAAGA	Hashtag4
ATGGTTGGTTCTTAGG	Negative
ATGGTTGGTTTGTGGT	Hashtag2
ATGGTTGTCCGGTTCT	Negative
ATGTCCCAGGTGATCG	Hashtag2
ATGTCCCCAAATGGCG	Negative
ATGTCCCCAAGGCAAC	Hashtag2
ATGTCCCCACAGCTGC	Negative
ATGTCCCGTAGCGAGT	Negative
ATGTCCCTCATTTGTC	Negative
ATGTCCCTCGGACTTA	Negative
ATGTCTTAGAGCCGTA	Hashtag4
ATGTCTTAGTAAGGGA	Negative
ATGTCTTCAGGTTCCG	Negative
ATGTCTTCATTACTCT	Hashtag2
ATGTCTTGTCGCGTCA	Negative
ATGTCTTGTCGTTCAA	Negative
ATGTCTTTCCATCTCG	Negative
ATTACCTAGGTACATA	Negative
ATTACCTAGTTGTCGT	Negative
ATTACCTCAACCTATG	Negative
ATTACCTCAGGATGAC	Negative
ATTACCTCAGTAACAA	Negative
ATTACCTGTCCGGTGT	Hashtag2
ATTACCTGTGAGATAT	Negative
ATTACCTGTGAGTTGG	Negative
ATTACCTTCGCGCCAA	Hashtag2
ATTACTCCACAAAGCG	Negative
ATTACTCTCTCTGCCA	Negative
ATTACTCTCTTCTAAC	Hashtag2
ATTATCCAGCGTCGAA	Hashtag2
ATTATCCAGTCGAAAT	Hashtag2
ATTATCCCAGCTATAC	Negative
ATTATCCGTGGTACAG	Negative
ATTCACTCACCGTGAC	Hashtag2
ATTCACTGTTTCACTT	Hashtag2
ATTCACTTCCACGTAA	Hashtag2
ATTCACTTCTGAATGC	Negative
ATTCAGGAGGCATTTC	Hashtag2
ATTCAGGAGTAGATCA	Hashtag4
ATTCAGGGTCGGAACA	Negative
ATTCAGGTCTCCCTAG	Hashtag2
ATTCATCAGAGCCATG	Hashtag2
ATTCATCCAAGTATAG	Negative
ATTCATCCAAGTCCAT	Negative
ATTCATCCACAGTATC	Hashtag2
ATTCATCCACCTGCAG	Hashtag2
ATTCATCGTTTGAAAG	Negative
ATTCATCTCCCATACC	Negative
ATTCCATAGCGACAGT	Negative
ATTCCATAGGTGCATG	Negative
ATTCCATAGTCAACAA	Negative
ATTCCATGTAGATTGA	Negative
ATTCCATTCAGAGCAG	Hashtag2
ATTCCCGCACAGACGA	Negative
ATTCCCGCATTGCAAC	Negative
ATTCCCGTCCGCAAAT	Hashtag2
ATTCCCGTCGAGATGG	Hashtag2
ATTCCTAGTGTCTTAG	Negative
ATTCGTTAGCAGTAAT	Hashtag2
ATTCGTTCACTTGACA	Negative
ATTCGTTCATGACTGT	Negative
ATTCGTTCATTGAAAG	Negative
ATTCGTTTCTGGTCAA	Hashtag2
ATTCTACAGTCAATCC	Hashtag2
ATTCTACTCAAGGTGG	Negative
ATTCTACTCTTGTGCC	Negative
ATTGGGTAGGGAGATA	Hashtag4
ATTGGGTGTAAGGCTG	Negative
ATTGGGTGTACTAACC	Negative
ATTGGGTGTCATGACT	Hashtag2
ATTGGGTTCAAGGTGG	Negative
ATTGGGTTCCATCTAT	Negative
ATTGTTCAGGACTATA	Hashtag2
ATTGTTCAGGGACTGT	Negative
ATTGTTCCAGAAGTGC	Negative
ATTGTTCGTGTTGATC	Negative
ATTGTTCTCGAGTGAG	Hashtag2
ATTGTTCTCGTCGATA	Hashtag2
ATTTACCCACTTGACA	Hashtag2
ATTTACCGTGCTCGTG	Negative
ATTTACCGTGTTCATG	Negative
ATTTACCTCGGAGCAA	Negative
ATTTCACAGGGCTGAT	Negative
ATTTCTGAGGGAGGGT	Negative
ATTTCTGAGGTCACAG	Negative
ATTTCTGCAAATGAAC	Hashtag2
ATTTCTGGTGTCCATA	Negative
ATTTCTGGTTAGGGAC	Negative
ATTTCTGTCCATCGTC	Hashtag2
CAAAGAACACCCTATC	Negative
CAAAGAATCACGAGGA	Negative
CAAAGAATCCGCAGTG	Negative
CAACAACAGGGCAATC	Negative
CAACAACCAGAATGTA	Hashtag2
CAACAACCAGCTGTGC	Hashtag2
CAACAGTAGCAGTCTT	Negative
CAACAGTAGCTAGCCC	Negative
CAACAGTAGTTTCGAC	Hashtag4
CAACAGTGTTCATCGA	Hashtag2
CAACAGTTCAAAGGAT	Negative
CAACCAAAGCGCCGTT	Negative
CAACCAAAGGCAGGTT	Negative
CAACCAACACCCTAGG	Negative
CAACCAACATACTGTG	Negative
CAACCAACATGGACAG	Hashtag2
CAACCAAGTAGACAGC	Hashtag2
CAACCAAGTGGCTGCT	Negative
CAACCAATCAACTCTT	Negative
CAACCAATCTACCACC	Negative
CAACCTCAGATCCTAC	Hashtag2
CAACCTCGTATGGTAA	Hashtag2
CAACCTCGTCATCGGC	Hashtag2
CAACCTCTCAGCCTTC	Negative
CAACGATCAGCTCCTT	Negative
CAACGATCAGGACTTT	Negative
CAACGATGTACAGAAT	Negative
CAACGATGTTTCACTT	Negative
CAACGGCGTCCAAGAG	Negative
CAACGGCTCAAGCCCG	Negative
CAAGACTCATGATCTG	Negative
CAAGACTGTTGCATCA	Hashtag2
CAAGACTTCCGTTTCG	Negative
CAAGACTTCTCGCCTA	Negative
CAAGAGGAGCGTGTCC	Hashtag2
CAAGAGGGTCAAACGG	Negative
CAAGAGGGTTTACCTT	Negative
CAAGAGGTCACCGGGT	Hashtag2
CAAGCTACACCAATTG	Hashtag2
CAAGCTACACTACAGT	Negative
CAAGCTATCCGCTTAC	Negative
CAAGCTATCGCCGAAC	Negative
CAAGCTATCGCTGACG	Hashtag4
CAAGGGAAGTCCCGGT	Negative
CAAGGGACAGAGATTA	Hashtag4
CAAGGGATCGGCTGTG	Negative
CAAGGGATCGGTGAAG	Negative
CAAGGGATCTAGTGAC	Hashtag2
CAATACGCAGACAAGC	Negative
CAATACGCAGGGCTTC	Hashtag2
CAATACGGTTACCGTA	Negative
CAATACGTCGTTCAGA	Negative
CAATACGTCTTGCAAG	Negative
CAATCGAGTATTGCCA	Negative
CAATCGAGTCCGCAGT	Negative
CAATCGAGTGTTACTG	Negative
CAATCGAGTTTCCAAG	Hashtag2
CAATCGATCAGTGTTG	Hashtag2
CAATGACAGATCCCAT	Negative
CAATGACCAGAGTCAG	Hashtag2
CAATGACCATGGCTAT	Negative
CAATTTCAGCGACCCT	Negative
CAATTTCAGCTGGTGA	Negative
CAATTTCAGGCTCTCG	Negative
CAATTTCAGGTCGAGT	Negative
CAATTTCTCGCACGAC	Hashtag2
CACAACAAGCAGTAAT	Hashtag2
CACAACAAGTGCCGAA	Hashtag2
CACAACACAACTTGGT	Hashtag2
CACAACACAGAGATGC	Hashtag2
CACAACACAGTATTCG	Hashtag2
CACAACACAGTTTCGA	Negative
CACAACACATGAAGGC	Negative
CACAACAGTGTGTGTT	Negative
CACAACATCGCGCTGA	Hashtag2
CACAACATCTTACGTT	Negative
CACACAACAGAAGCTG	Hashtag2
CACACAACAGGATCTT	Negative
CACACAACATCCTGTC	Hashtag4
CACAGATAGATTACCC	Negative
CACAGATAGGTCGTCC	Negative
CACAGATCAAACGAGC	Negative
CACAGATGTAATTAGG	Hashtag2
CACAGATTCGGACGTC	Hashtag2
CACAGATTCGTTAGAC	Hashtag2_Hashtag4
CACAGATTCTTGAACG	Hashtag2
CACAGGCGTGGTCTTA	Hashtag2
CACAGGCTCAGAGCGA	Hashtag2
CACAGGCTCCTGGCTT	Hashtag2
CACATGAAGATAGCTA	Negative
CACATGACAAAGGATT	Hashtag4
CACATGACAACGATCT	Negative
CACATGAGTGTACAGG	Negative
CACATGAGTGTTTACG	Negative
CACCAAAAGGTCCGAA	Negative
CACCAAACATCCGGTG	Hashtag2
CACCAAAGTCCTTTGC	Negative
CACCAAATCGGTTAGT	Negative
CACCGTTCAGATAAAC	Negative
CACCGTTGTGTTTCTT	Hashtag2
CACCGTTTCCAACCGG	Negative
CACGAATCAACCAGAG	Negative
CACGAATCAACTCGTA	Negative
CACGAATCACGCCACA	Negative
CACGAATGTATAGGGC	Hashtag2
CACGAATGTGTGTTTG	Hashtag2
CACGGGTAGGTTTACC	Hashtag2
CACGGGTCAAAGGGCT	Negative
CACGGGTCATCATGAC	Hashtag2
CACGGGTGTACCGGAA	Negative
CACGGGTGTACCGTCG	Negative
CACGGGTTCGCTGACG	Hashtag4
CACGTGGCACTAGGCC	Negative
CACGTGGGTTGCATCA	Hashtag2
CACGTTCAGCTGTGCC	Hashtag4
CACGTTCAGTAAGCAT	Hashtag2
CACGTTCAGTATGAGT	Hashtag2
CACGTTCCATAAGCGG	Negative
CACGTTCGTCTTACTT	Negative
CACGTTCTCTTCTTCC	Hashtag2
CACTAAGGTATCGTTG	Negative
CACTAAGGTGTCACAT	Negative
CACTGAACACCAGCTG	Hashtag2
CACTGAACATGAGTAA	Hashtag2
CACTGAAGTTCTCAGA	Hashtag2
CACTGAATCCCTGGTT	Negative
CACTGAATCTTCGTGC	Hashtag2
CACTGGGAGATGGCAC	Negative
CACTGGGAGCGAGGAG	Negative
CACTGGGCATGCGTGC	Negative
CACTGTCAGTGACCTT	Hashtag2
CACTGTCTCACCCTGT	Negative
CACTGTCTCAGCTAGT	Negative
CACTGTCTCAGGTAAA	Negative
CACTGTCTCCCATAGA	Negative
CACTTCGAGGCATCAG	Negative
CACTTCGCAAGAATAC	Negative
CACTTCGCAAGCAGGT	Negative
CACTTCGGTCTTGAGT	Hashtag2
CACTTCGTCTAGACCA	Negative
CACTTCGTCTCTGCTG	Hashtag2
CAGAGCCAGCAGTCTT	Negative
CAGAGCCAGCGGGTAT	Negative
CAGAGCCAGGCTTAGG	Hashtag2
CAGAGCCTCTCTAGGA	Negative
CAGATACGTACGCGTC	Negative
CAGATACGTCTGTAGT	Negative
CAGATACGTGGCAACA	Negative
CAGATACTCATTATCC	Negative
CAGATCACAAGCCTGC	Hashtag2
CAGATCACAATTGAAG	Hashtag2
CAGATCAGTCTCGACG	Hashtag2
CAGATCATCATCACCC	Hashtag2
CAGATTGAGCATGGGT	Negative
CAGATTGAGCTGGTGA	Negative
CAGATTGAGGATACGC	Negative
CAGATTGTCCGATTAG	Negative
CAGCAATCAGATGCGA	Hashtag2
CAGCAATGTAGTGATA	Negative
CAGCACGCAATTGAGA	Hashtag2
CAGCACGCATCCAACA	Hashtag2
CAGCAGCCAGATCACT	Negative
CAGCAGCGTTAATCGC	Negative
CAGCAGCGTTGTGTTG	Negative
CAGCAGCTCAACCTTT	Negative
CAGCAGCTCCGGACTG	Negative
CAGCAGCTCCGTTGGG	Negative
CAGCCAGCAACAAGTA	Negative
CAGCCAGGTAGTCGGA	Hashtag2
CAGCCAGTCCGTACGG	Hashtag2
CAGCCAGTCTCTTAAC	Negative
CAGCGTGGTGAGAGGG	Negative
CAGCGTGGTTGCCATA	Hashtag2
CAGCGTGTCACGGTCG	Negative
CAGCGTGTCATTTGCT	Negative
CAGCGTGTCGCTGACG	Negative
CAGGCCAAGTACAGAT	Negative
CAGGGCTAGCAAACAT	Negative
CAGGGCTAGCAACAAT	Negative
CAGGGCTCACCCTGAG	Hashtag2
CAGGGCTCAGGTCCCA	Hashtag2
CAGGGCTTCGAGTCCG	Negative
CAGGGCTTCTCCACTG	Hashtag2
CAGTGCGTCGCCAGAC	Negative
CAGTTAGCAAGGCGTA	Hashtag2
CAGTTAGCAGTTAGAA	Negative
CAGTTAGGTGTATTGC	Hashtag2
CAGTTCCAGGGTAGCT	Hashtag2
CAGTTCCCACTGTGAT	Hashtag2
CAGTTCCGTGCCTACG	Hashtag2
CAGTTCCTCCAACCAA	Hashtag2
CAGTTCCTCTAGCCAA	Negative
CAGTTCCTCTCTCGCA	Negative
CATAAGCCACTCGATA	Hashtag2
CATAAGCGTATGAAGT	Negative
CATAAGCGTCCGATCG	Negative
CATAAGCTCAATCTCT	Hashtag2
CATAAGCTCCCAGTGG	Negative
CATAAGCTCGAGAGAC	Hashtag2
CATACAGCATCCTGTC	Negative
CATACAGGTGGACAGT	Negative
CATACAGTCAACACCA	Negative
CATACAGTCGCAGAGA	Negative
CATACCCAGGAAGAAC	Negative
CATACTTAGACTCAAA	Negative
CATAGACGTTTGCCGG	Negative
CATAGACTCGTGCAGC	Hashtag2
CATCAAGAGCACCGTC	Hashtag2
CATCAAGAGGAATCGC	Hashtag2
CATCAAGCACTGAGGA	Negative
CATCAAGCAGTTAAAG	Negative
CATCCACCAAGAGCTG	Negative
CATCCACCAGAAGTTA	Negative
CATCCCAAGTAAATGC	Negative
CATCCCAGTAGATTAG	Hashtag2
CATCCCATCCCATGGG	Hashtag2
CATCCCATCTAGCAAC	Negative
CATCCGTAGACCATGG	Negative
CATCCGTCACCACTGG	Hashtag2
CATCCGTGTTACGATC	Negative
CATCCGTGTTCTCACC	Hashtag2
CATCCGTTCCATTGGA	Negative
CATCCGTTCCTTTGAT	Negative
CATCGCTAGAGGTGCT	Negative
CATCGCTCAGACACAG	Negative
CATCGCTCAGACGATG	Negative
CATCGCTGTCCTTTGC	Negative
CATCGGGGTGTTGACT	Negative
CATCGGGTCATGACAC	Hashtag2
CATCGTCAGGCGCTTC	Negative
CATCGTCGTAGAGTTA	Negative
CATCGTCGTATCGGTT	Negative
CATGAGTAGAAACCCG	Negative
CATGAGTAGATGGCGT	Hashtag2
CATGAGTAGGTCTTTG	Hashtag2
CATGAGTCACGTAACT	Negative
CATGAGTCAGAGTGTG	Hashtag2
CATGAGTTCGCGGTAC	Negative
CATGCAAAGCTCGCAC	Negative
CATGCAAAGGTCGTAG	Negative
CATGCAACACAGCATT	Negative
CATGCAAGTAGCTAAA	Negative
CATGCAAGTCAACACT	Negative
CATGCCTCACCGGTCA	Negative
CATGCCTCACGTCGTG	Hashtag2
CATGCCTCAGATACCT	Hashtag2
CATGCCTCATGACAGG	Hashtag2
CATGCCTGTGGCGTAA	Hashtag2
CATGCCTTCGAACGGA	Negative
CATGCGGGTGATCGTT	Hashtag2
CATGGATAGGCACTAG	Hashtag2
CATGGATAGTGCCAGA	Negative
CATGGATGTACAGTCT	Negative
CATGGATGTACCATAC	Negative
CATGGATGTTCGTAAC	Hashtag2
CATGGATTCGTCCTTG	Hashtag2
CATGGTACAATCGCGC	Negative
CATGGTACAGTGACCC	Negative
CATGGTAGTGCTGATT	Negative
CATGGTATCTCGTCGT	Negative
CATTCATAGCGGTATG	Hashtag2
CATTCATCAGGTTTAC	Negative
CATTCATCATCCCGTT	Negative
CATTCATGTCACCCTT	Negative
CATTCATTCTTCCCGA	Negative
CATTCCGAGTCTACCA	Hashtag2
CATTCCGGTGTCCGGT	Negative
CATTCCGTCCTCTTTC	Negative
CATTCCGTCGCATTGA	Hashtag2
CATTCCGTCGTTCTAT	Negative
CATTCCGTCTCTATGT	Hashtag2
CATTCTAAGAAGATCT	Negative
CATTCTAAGCAGTAAT	Negative
CATTCTAAGTGGGAAA	Negative
CATTCTAAGTTAGTAG	Negative
CATTCTACAATAGTGA	Negative
CATTCTAGTGATTAGA	Negative
CATTCTATCCATTTGT	Negative
CATTCTATCGGATTAC	Negative
CATTGAGAGATGGCGT	Negative
CATTGAGGTCTTGAGT	Negative
CATTGAGTCTGTCGTC	Negative
CATTGCCAGCAGCAGT	Hashtag2
CATTGCCGTAACTTCG	Negative
CATTGCCGTATCTCTT	Hashtag4
CATTGCCGTTAAACAG	Hashtag2
CATTGCCTCCTTACCG	Hashtag2
CATTGTTCACAGAGAC	Negative
CATTGTTCATTCGGGC	Negative
CATTGTTTCAAGGTGG	Hashtag2
CATTGTTTCAAGTTGC	Negative
CATTGTTTCACCCTGT	Negative
CATTTCACACCAAATC	Negative
CATTTCACAGTACTAC	Negative
CATTTCACATTCATCT	Negative
CATTTCACATTCCTCG	Negative
CATTTCATCAGGAAAT	Hashtag2
CATTTCATCATTTCGT	Hashtag2
CCAAGCGAGCACTCTA	Hashtag2
CCAAGCGAGGTGCGAT	Negative
CCAAGCGGTCGATTTG	Negative
CCAATTTCACCAGCTG	Hashtag2
CCAATTTCATCGGCCA	Hashtag2
CCAATTTTCATGTCAG	Negative
CCAATTTTCCACGGAC	Negative
CCACAAAAGACAGCTG	Negative
CCACAAAGTCCAGAAG	Negative
CCACAAATCGGTTGTA	Hashtag2
CCACAAATCGTGCATA	Hashtag2
CCACAAATCTCTTAAC	Negative
CCACACTCACTATCCC	Negative
CCACACTCATGAGTAA	Negative
CCACACTTCTGCATGA	Negative
CCACGAGCAGGACTTT	Hashtag2_Hashtag4
CCACGAGTCCGCGAGT	Hashtag4
CCACGAGTCCTAAACG	Negative
CCACGTTAGGCGTTAG	Negative
CCACGTTCAGTGTATC	Negative
CCACGTTCATATGAAG	Negative
CCACGTTTCCTGATAG	Negative
CCACGTTTCGATACTG	Negative
CCACTTGAGGAAGTCC	Negative
CCACTTGCACTCATAG	Hashtag2
CCACTTGGTTGTGGCC	Hashtag2
CCACTTGTCGGCTCTT	Hashtag4
CCACTTGTCTCACTCG	Hashtag2
CCATAAGCAGCGTATT	Negative
CCATAAGCATCGGATT	Negative
CCATAAGCATTGAAAG	Negative
CCATAAGTCCATAAGC	Hashtag2
CCATAAGTCTATCCAT	Negative
CCATCACCACGATAGG	Hashtag4
CCATCACTCACTGGGC	Hashtag2
CCATCACTCAGCAGAG	Hashtag2
CCATCACTCGTTCCCA	Hashtag2
CCCAACTAGAAGCCTG	Hashtag2
CCCAACTCAGGAGGTT	Hashtag2
CCCAACTGTCCACTTC	Hashtag2
CCCAACTTCGCTCTAC	Hashtag2
CCCAACTTCTGCTCTG	Negative
CCCATTGAGCGTGCCT	Negative
CCCATTGCAGCGCTTG	Negative
CCCATTGTCTCGGTCT	Hashtag2
CCCGAAGAGCCTGCCA	Hashtag2
CCCGAAGAGCTCACTA	Negative
CCCGAAGAGGACGCTA	Hashtag2
CCCGAAGGTTCCCACT	Negative
CCCGGAACAGATCCAT	Negative
CCCGGAAGTGGTCCCA	Negative
CCCTAACCATGCGGTC	Hashtag2
CCCTAACGTACGACAG	Hashtag2
CCCTAACTCTGGACTA	Negative
CCCTCAACAGGTTACT	Hashtag2
CCCTCAACATCTGTTT	Negative
CCCTCAAGTGAGACGT	Negative
CCCTCAAGTTGACGGA	Negative
CCCTCAATCCAGTGTA	Hashtag4
CCCTCAATCCTTTAGT	Hashtag4
CCCTCAATCTTGGTGA	Negative
CCCTCTCAGGGCTAAC	Negative
CCCTCTCAGGGCTGAT	Negative
CCCTCTCCATTCACAG	Negative
CCCTGATCAGGTATGG	Negative
CCCTGATGTATGATCC	Negative
CCCTGATGTTAAAGTG	Negative
CCCTGATTCGTAGCTA	Negative
CCCTTAGAGAAGTCAT	Negative
CCCTTAGAGTGATAGT	Negative
CCCTTAGCACTTCAGA	Hashtag4
CCCTTAGGTTCTTCAT	Hashtag2
CCCTTAGTCATAAGGA	Hashtag2
CCCTTAGTCCTACGAA	Negative
CCGAACGAGGTCCCGT	Negative
CCGAACGGTTGGCCTG	Negative
CCGATCTAGAAACTAC	Negative
CCGATCTGTAGATTAG	Negative
CCGATCTGTCTTCTAT	Hashtag2
CCGATGGCATGGCTGC	Hashtag2
CCGATGGGTGACAGCA	Hashtag2
CCGATGGTCTAAGCGT	Negative
CCGCAAGCATTGAAGA	Negative
CCGCAAGTCGCGTTTC	Negative
CCGGACACACCTGAAT	Hashtag2
CCGGGTAAGCTCGTGC	Negative
CCGGGTACACCTGTCT	Hashtag2
CCGGGTACAGGAGGTT	Negative
CCGGGTAGTCTAGGCC	Negative
CCGGGTAGTGTAACGG	Negative
CCGGTAGAGCAGGCAT	Hashtag2
CCGGTAGCACGGTAGA	Hashtag2
CCGGTAGGTATACAGA	Hashtag2
CCGGTAGGTTAACAGA	Hashtag2
CCGGTAGGTTCAAACC	Hashtag2
CCGGTAGTCCCGAGGT	Negative
CCGGTAGTCGAGTGGA	Negative
CCGGTGAAGACTTCCA	Negative
CCGGTGACAAGCGCAA	Hashtag2
CCGGTGACAGTGGGTA	Hashtag2
CCGGTGATCCGCGATG	Negative
CCGTAGGCAGACACCC	Negative
CCGTAGGGTCATCTAG	Negative
CCGTAGGGTGCAAGAC	Hashtag2
CCGTAGGGTGGCGCTT	Negative
CCGTAGGTCAGCCCAG	Negative
CCGTGAGAGCAAGTCG	Negative
CCGTGAGCAACGCCCA	Negative
CCGTGAGGTCAAGCCC	Negative
CCGTGAGGTCCTGTTC	Negative
CCGTTCAAGCCACTCG	Negative
CCGTTCAAGTGTTGTC	Hashtag2
CCGTTCACAGCATTGT	Negative
CCGTTCAGTAGGTGCA	Negative
CCGTTCATCAACCCGG	Negative
CCTAACCAGAGTCTTC	Negative
CCTAACCCACACCTAA	Negative
CCTAACCCATTCCTCG	Negative
CCTAACCGTCCCTGAG	Negative
CCTAAGAAGCACTTTG	Negative
CCTAAGATCAGCTTCC	Negative
CCTACGTAGAGGTTTA	Hashtag2
CCTACGTAGTGTGTTC	Negative
CCTACGTCACGTACAT	Negative
CCTACGTGTAACTTCG	Negative
CCTATCGCAAGATCCT	Negative
CCTATCGGTAAGGTCG	Negative
CCTATCGGTGCAATAA	Negative
CCTCAACAGCCTCGTG	Negative
CCTCAACTCTGAACGT	Negative
CCTCACACAGATTAAG	Negative
CCTCACATCTCCGCAT	Hashtag2
CCTCATGCAACAGAGC	Hashtag2
CCTCATGCAATGGCAG	Hashtag2
CCTCATGCAGCTACCG	Hashtag2
CCTCCAAAGAGGATGA	Negative
CCTCCAAAGCTAAACA	Negative
CCTCCAAAGCTGCCTG	Hashtag2
CCTCCAAGTGCGTTTA	Hashtag2
CCTCCTCAGGAACGAA	Negative
CCTCCTCAGTCGGGAT	Negative
CCTCCTCAGTTAACGA	Negative
CCTCCTCCAGAGTCTT	Negative
CCTCCTCGTCCAGCGT	Hashtag2
CCTCTAGCAGTCAACT	Negative
CCTCTAGGTTGACTAC	Hashtag2
CCTCTAGTCCACGGAC	Hashtag2
CCTCTCCCAAACACGG	Hashtag4
CCTCTCCGTTAGGACG	Negative
CCTCTCCTCAATGTCG	Hashtag2
CCTCTCCTCGAACCAT	Negative
CCTGCATAGATGGGCT	Negative
CCTGCATGTCGCACGT	Negative
CCTGCATTCACTTGGA	Negative
CCTGTTGGTACGTTCA	Negative
CCTGTTGGTAGTGTGG	Negative
CCTGTTGTCCCGATCT	Hashtag2
CCTTCAGAGAGTGACC	Negative
CCTTCAGCAGACTCTA	Negative
CCTTCAGGTTCCCACT	Negative
CCTTCAGGTTGTGCAT	Negative
CCTTGTGAGGGTTTCT	Negative
CCTTGTGCAACGACTT	Negative
CCTTGTGTCCCTGGTT	Negative
CCTTGTGTCCGAGGCT	Negative
CCTTGTGTCGAGCCAC	Negative
CCTTGTGTCTATACTC	Negative
CCTTTGGCATTGCAAC	Negative
CCTTTGGGTACAAGTA	Hashtag2
CCTTTGGGTGTGATGG	Negative
CCTTTGGTCGCACGGT	Negative
CGAAGGAAGAAGCTCG	Negative
CGAAGGAAGAATCGCG	Hashtag2
CGAAGGAAGTTGCGAG	Negative
CGAAGGACAACAGATA	Negative
CGAAGTTAGCTGAGTG	Hashtag2
CGAAGTTCAAAGCTCT	Hashtag4
CGAAGTTCAGGCATTT	Hashtag2
CGAAGTTGTTCAAGTC	Negative
CGAATTGCAAATTGCC	Negative
CGAATTGCAATCCAGT	Negative
CGAATTGCACCTGCAG	Hashtag2
CGAATTGCAGACATCT	Negative
CGAATTGGTTCATCGA	Negative
CGACAGCAGACTCCGC	Negative
CGACAGCCAGGGTCTC	Hashtag2
CGAGAAGAGAAACTGT	Negative
CGAGAAGGTACAGTAA	Hashtag2
CGAGAAGGTTATTCCT	Hashtag2
CGAGAAGGTTTACTGG	Negative
CGAGAAGTCATCGTAG	Negative
CGAGAAGTCCATCACC	Negative
CGAGGAAAGTATAGAC	Hashtag2
CGAGGAACAAGCTGTT	Hashtag2_Hashtag4
CGAGGCTCAAGCTCTA	Hashtag2
CGAGGCTCATCTCAAG	Hashtag2
CGAGGCTCATCTGTTT	Hashtag2
CGAGGCTCATGTGACT	Negative
CGAGGCTGTATTGCCA	Hashtag2
CGAGTGCAGCACGATG	Negative
CGAGTGCCACAGCCTG	Negative
CGAGTGCCACTGGATT	Negative
CGAGTGCCATGACACT	Negative
CGAGTGCGTATGCAAA	Negative
CGAGTGCGTTGGACCC	Negative
CGAGTGCTCAGCCTTC	Negative
CGAGTGCTCCATTTGT	Hashtag2
CGAGTTACAGAAACCG	Negative
CGAGTTATCGGCGATC	Negative
CGATCGGAGCTGTTCA	Hashtag2
CGATCGGTCACTTGGA	Negative
CGATCGGTCGCCACTT	Negative
CGATGCGAGGAGAGTA	Hashtag4
CGATGCGAGGGATCGT	Hashtag2
CGATGCGAGTGCTCAT	Negative
CGATGCGCACAGTGAG	Negative
CGATGCGGTTCACCGG	Negative
CGATGCGTCACTGCTC	Hashtag2
CGATGCGTCCTCTCTT	Negative
CGATGGCCAGCCTATA	Hashtag2
CGATGGCGTATCCTCC	Hashtag2
CGATGGCGTCGAATTC	Hashtag2
CGATGGCGTGAACTAA	Negative
CGATGGCGTGTAACGG	Negative
CGATGGCTCATGTCAG	Negative
CGATGGCTCGACGACC	Hashtag4
CGATGGCTCGCCGAAC	Hashtag2
CGCAGGTAGTGCACCC	Hashtag2
CGCAGGTTCCGATCGG	Hashtag2
CGCAGGTTCGCGTTTC	Negative
CGCATAAAGCACCGAA	Negative
CGCATAAAGCACCGTC	Negative
CGCATAACAGGCATGA	Negative
CGCATAACAGTATTCG	Hashtag2
CGCATAACATGGCTAT	Negative
CGCATAAGTGATTCAC	Negative
CGCATAAGTTGCGAAG	Hashtag2
CGCATGGAGGGACAGG	Negative
CGCATGGCATGGCTAT	Negative
CGCCAGAAGATCCTAC	Negative
CGCCAGAAGGGATCGT	Hashtag2
CGCCAGAAGTCCGTCG	Negative
CGCCAGAGTCTTTATC	Hashtag2
CGCCAGAGTGCAAGAC	Hashtag2
CGCCATTAGGAGACCT	Negative
CGCCATTGTACAGTAA	Negative
CGCCATTGTTAGTCGT	Negative
CGCCATTTCCGTGACG	Hashtag2
CGCGTGAAGCCATTTG	Negative
CGCGTGAGTGACAACG	Negative
CGGAACCAGCAATAAC	Negative
CGGAACCAGTAAACTG	Negative
CGGAACCCATTCTTCA	Hashtag2
CGGAACCGTCAAGCGA	Negative
CGGAACCGTGGACTGA	Negative
CGGAACCTCCATGATG	Negative
CGGAACCTCGCAGTGC	Negative
CGGAACCTCGGAGTAG	Negative
CGGAATTAGCGATGGT	Hashtag2
CGGAATTAGGAGAGTA	Hashtag2
CGGAATTAGTTGTACC	Hashtag2
CGGAATTCAACTGATC	Negative
CGGAATTGTCTACAGT	Hashtag4
CGGAATTTCCATTGGA	Hashtag2
CGGAATTTCCCGAGAC	Hashtag2
CGGACACAGAAGAACG	Negative
CGGACACAGCACAAAT	Negative
CGGACACCAAAGCGTG	Hashtag2
CGGACACGTAACGGTG	Hashtag2
CGGAGAACATACCAGT	Negative
CGGAGAAGTGAGACCA	Negative
CGGAGAATCACTCACC	Negative
CGGCAGTCATGACAAA	Negative
CGGCAGTGTAGCGATG	Negative
CGGCAGTGTGATACTC	Negative
CGGCAGTTCCACAAGT	Negative
CGGGACTAGACCTGGA	Hashtag2
CGGGACTAGCTCGGCT	Hashtag2
CGGGACTGTGTCCTAA	Negative
CGGGCATAGCACAAAT	Negative
CGGGCATAGTATTGCC	Hashtag2
CGGGCATAGTCCCAGC	Negative
CGGGCATCACGAGAAC	Hashtag2
CGGGCATCAGCTACTA	Hashtag2
CGGGCATGTATAGGAT	Hashtag2
CGGGCATGTCTACAAC	Negative
CGGGCATTCATCACCC	Hashtag2
CGGGTCAAGCTAGATA	Negative
CGGGTCACACACCAGC	Negative
CGGGTCAGTATTGAGA	Hashtag2
CGGGTGTAGGGTGAGG	Hashtag2
CGGGTGTCAAACCGGA	Hashtag2
CGGGTGTGTACACTCA	Negative
CGGGTGTGTCCCGTGA	Hashtag2
CGGGTGTTCGAGCTGC	Hashtag2
CGGTCAGCAGCTATTG	Negative
CGGTCAGCAGGAACCA	Negative
CGGTCAGGTGGCTCTG	Negative
CGGTCAGGTTCGTTCC	Negative
CGGTCAGTCGTAACTG	Hashtag2
CGTAAGTGTCAACACT	Negative
CGTAAGTGTCCTGGTG	Negative
CGTAATGAGACTACCT	Negative
CGTAATGCAAGAGGCT	Negative
CGTAATGGTACTCGTA	Hashtag2
CGTAATGGTGCATACT	Hashtag2
CGTAGTAAGATTGACA	Hashtag2
CGTAGTAAGTATCCTG	Negative
CGTAGTACACTACAGT	Hashtag2
CGTAGTATCTACCCAC	Hashtag2
CGTAGTATCTCCACTG	Hashtag2
CGTCAAACAATAGTCC	Hashtag2
CGTCAAACATCCAACA	Hashtag2
CGTCAAACATTGACCA	Hashtag2
CGTCAAATCGGAGTGA	Hashtag2
CGTCCATAGTTGGGAC	Negative
CGTCCATCACTCGATA	Negative
CGTCCATGTGCCTTCT	Hashtag2
CGTGAATAGAGAGGTA	Negative
CGTGAATCAAATTGGA	Negative
CGTGAATCAAGAAATC	Negative
CGTGAATCAGCAGAAC	Negative
CGTGAATCAGCATACT	Negative
CGTGAATCAGTATTCG	Negative
CGTGAATGTATCACGT	Negative
CGTGAATTCGGCTCTT	Negative
CGTGATAAGGAGAGTA	Negative
CGTGATAAGGCAGGTT	Hashtag2
CGTGATAGTGGATTTC	Negative
CGTGATAGTTAAGGGC	Negative
CGTGCTTAGGCCTAGA	Negative
CGTGCTTCATGAGGGT	Negative
CGTGCTTGTACCTAGT	Negative
CGTGTCTAGCCGGAAT	Negative
CGTGTCTAGGTTCACT	Negative
CGTTAGACACCCAATA	Negative
CGTTAGAGTGATCATC	Negative
CGTTCTGCAGTTTCGA	Negative
CGTTCTGTCAGGGATG	Negative
CGTTCTGTCGTAGTGT	Negative
CGTTGGGAGAACCCGA	Hashtag2
CGTTGGGAGCTGACCC	Hashtag2
CGTTGGGCAATTGCTG	Negative
CGTTGGGGTCGTTGCG	Negative
CTAACCCGTCTAGTGT	Hashtag4
CTAACCCGTTCTTGCC	Negative
CTAACCCTCTCGCGTT	Negative
CTAACTTCAAATTGCC	Negative
CTAACTTGTTGTAAAG	Hashtag2
CTAACTTTCACCTACC	Negative
CTAAGTGAGAGAGGGC	Negative
CTAAGTGGTCAATGGG	Negative
CTAAGTGGTCGGTAAG	Negative
CTACAGAAGGTGCGAT	Hashtag2
CTACAGACACGGCCAT	Negative
CTACAGAGTCTACACA	Negative
CTACAGAGTCTGTCAA	Negative
CTACAGAGTTCGTAAC	Negative
CTACATTAGGGCAGAG	Hashtag2
CTACATTTCACCGACG	Hashtag2
CTACCCAAGACATCAA	Hashtag2
CTACCCAAGAGATGCC	Hashtag2
CTACCCAAGAGGTATT	Negative
CTACCCAAGAGTCACG	Negative
CTACCCAAGTGCAAAT	Hashtag2
CTACCCAGTCGTTCAA	Negative
CTACCCATCAGAGTTC	Negative
CTACCTGAGACTACCT	Negative
CTACCTGAGAGCAGTC	Hashtag2
CTACCTGCATTGCTTT	Negative
CTACCTGTCCTTATCA	Hashtag2
CTACGGGAGACCTGGA	Hashtag2
CTACGGGAGGGACAGG	Negative
CTACGGGAGGGTTAGC	Negative
CTACGGGCAGATTCGT	Negative
CTACTATGTTAGGCCC	Negative
CTACTATTCTACGCGG	Hashtag2
CTAGACAGTATCTCTT	Hashtag2
CTAGACAGTCATAACC	Negative
CTAGACAGTTGCCGCA	Negative
CTAGACATCTGCTAGA	Negative
CTAGGTAAGAGAGCAA	Negative
CTAGGTACAACGTTAC	Hashtag2
CTAGGTACAATGTTGC	Negative
CTAGGTAGTGTGGACA	Negative
CTATAGGAGGACTATA	Hashtag2
CTATAGGAGTGTACAA	Negative
CTATAGGGTAGAAACT	Hashtag2
CTATAGGGTAGATGTA	Negative
CTATCCGAGTTGTCAC	Hashtag2
CTATCCGTCTATCGTT	Hashtag2
CTATCTAAGGTCACCC	Hashtag2
CTCAACCAGGATATGT	Negative
CTCAACCCACTTGGCG	Negative
CTCAACCTCAAATAGG	Negative
CTCAACCTCCAATCTT	Negative
CTCAAGACAATTCGTG	Hashtag2
CTCAAGAGTCAAGCCC	Negative
CTCAAGATCCCAAGTA	Negative
CTCAATTAGACCTGGA	Hashtag2
CTCAATTAGCTCCATA	Hashtag2
CTCAATTGTGGACCTC	Hashtag2
CTCACTGAGTTTCTTC	Negative
CTCACTGGTAGAGACC	Negative
CTCACTGTCGAGTACT	Negative
CTCAGAAAGAATCGCG	Hashtag2
CTCAGAAAGTTAACGA	Negative
CTCAGAACAGTGGTGA	Hashtag2
CTCAGAAGTACGATGG	Negative
CTCAGAAGTCCGGTGT	Negative
CTCAGAATCGACATTG	Negative
CTCAGGGCAAACCGGA	Negative
CTCAGGGCAAGGACAC	Hashtag4
CTCAGGGGTAGGTACG	Negative
CTCAGGGGTCTCAGAT	Negative
CTCAGGGTCTGCTCTG	Hashtag2
CTCAGTCCAACGTTAC	Hashtag2
CTCAGTCCACAAAGCG	Negative
CTCAGTCGTGATATAG	Negative
CTCATCGCAAACTCGT	Negative
CTCATCGCACTAGGTT	Negative
CTCATCGCATTGAAGA	Negative
CTCATCGGTGATGGCA	Negative
CTCATCGGTTACTCAG	Negative
CTCATCGGTTTACACG	Hashtag2
CTCATCGTCCGTGGCA	Negative
CTCATCGTCTCCTACG	Negative
CTCATGCAGTTACGAA	Hashtag2
CTCATGCGTGCGAACA	Negative
CTCATGCTCTGTAAGC	Negative
CTCATTACACTTACAG	Negative
CTCATTAGTCCGAAAG	Hashtag2
CTCATTAGTGTTGACT	Negative
CTCATTAGTTAAGTCC	Hashtag2
CTCCAACAGACCGCCT	Negative
CTCCAACAGGCTTCCG	Negative
CTCCAACGTAACACCT	Negative
CTCCACAAGAATCGAT	Hashtag2
CTCCACACAAATCCCA	Hashtag2
CTCCACATCACAAGGG	Negative
CTCCACATCTGTACAG	Negative
CTCCATGAGCATGCGA	Negative
CTCCATGAGGCTCAAG	Hashtag2
CTCCATGTCAATGTCG	Negative
CTCCATGTCGCACTCT	Negative
CTCCCAAGTACGTGAG	Negative
CTCCCTCAGTAAACGT	Hashtag2
CTCCCTCCACTACGGC	Negative
CTCCCTCGTACGTACT	Negative
CTCCCTCGTGTTCATG	Negative
CTCCGATAGCGATTCT	Hashtag2
CTCCGATGTAACGGTG	Negative
CTCCGATGTCAGTTTG	Negative
CTCCGATGTCCTCCTA	Negative
CTCCTCCCACGCAAAG	Hashtag2
CTCCTCCCACTCCACT	Negative
CTCCTCCGTACCTATG	Negative
CTCCTCCGTGAATGTA	Negative
CTCCTCCTCTCCTGCA	Negative
CTCCTCCTCTGCGGAC	Hashtag2
CTCCTCCTCTTCGTAT	Negative
CTCCTTTAGAAGTCAT	Negative
CTCCTTTAGGGAGATA	Negative
CTCCTTTCACATATGC	Negative
CTCCTTTCACCCTATC	Negative
CTCCTTTCAGGTTACT	Negative
CTCCTTTTCACTTTGT	Negative
CTCGAGGAGTAGTCTC	Hashtag2
CTCGAGGCAGGCCTGT	Hashtag2
CTCGAGGGTCGTACAT	Hashtag2
CTCGAGGGTCTTACTT	Negative
CTCGAGGGTGCCTATA	Negative
CTCGAGGGTGTTAAAG	Hashtag2
CTCGAGGTCGGCCCAA	Negative
CTCGAGGTCGTTCATT	Negative
CTCGAGGTCTGCGAGC	Negative
CTCTCAGGTCGTACAT	Negative
CTCTCAGGTGAGTAGC	Hashtag2
CTCTCGACAAGAGGTC	Hashtag2
CTCTCGAGTCGCTTGG	Negative
CTCTCGAGTGGTCTAT	Negative
CTCTCGATCGCCTTTG	Hashtag2
CTCTGGTAGAGTCACG	Hashtag2
CTCTGGTGTAGCTTGT	Negative
CTCTGGTGTCGTACAT	Hashtag2
CTCTGGTGTTTACCTT	Hashtag2
CTGAATGAGAAATTGC	Negative
CTGAATGAGGTAAACT	Hashtag2
CTGAATGCAAGTCATC	Negative
CTGAATGCACAGCCTG	Hashtag2
CTGAATGGTATGCGGA	Negative
CTGAATGGTGCTGCAC	Negative
CTGAATGTCTGCATAG	Hashtag2
CTGAGCGCAACAGCCC	Negative
CTGAGCGCACAATGAA	Hashtag2
CTGAGCGGTCGCTGCA	Hashtag2
CTGAGCGTCAAACCCA	Negative
CTGAGGCAGTTTGCTG	Negative
CTGAGGCGTCACAATC	Hashtag2
CTGAGGCGTGAGATCG	Negative
CTGAGGCGTGCGAGTA	Negative
CTGAGGCTCCCAATAG	Hashtag2
CTGAGGCTCTCATGGA	Negative
CTGATCCAGCATAGGC	Negative
CTGATCCCACTTCAAG	Negative
CTGATCCCATCACAGT	Hashtag2
CTGATCCGTACTCAAC	Hashtag2
CTGCAGGAGGCGCTCT	Negative
CTGCAGGTCCCATTTA	Negative
CTGCAGGTCTGTCCCA	Negative
CTGCATCAGAACGCGT	Negative
CTGCATCAGTGCTCAT	Negative
CTGCATCAGTTCGGTT	Hashtag2
CTGCATCCACTAGGTT	Hashtag2
CTGCATCCAGAACCGA	Hashtag4
CTGCATCCAGGTGACA	Negative
CTGCCATAGAGCAACC	Negative
CTGCCATAGTCTGCAT	Negative
CTGCCATAGTGGTTCT	Hashtag2
CTGCCATCAATTGCAC	Hashtag2
CTGCCATCATAGCTGT	Negative
CTGCCATGTCGAGATG	Hashtag2
CTGCCATGTGCCAAGA	Negative
CTGCCATTCCGATCTC	Negative
CTGCCATTCGCATTGA	Hashtag2
CTGCCTACATAGGTAA	Negative
CTGCGAGAGGGTCAAC	Negative
CTGCGAGCAAACAGGC	Hashtag2
CTGCGAGCAGGCATTT	Negative
CTGCGAGGTCATCACA	Negative
CTGCTCAAGGACTAAT	Negative
CTGCTCAGTGGTCAAG	Negative
CTGCTCATCATCTACT	Negative
CTGGACGAGGTCCAGA	Hashtag2
CTGGACGCAAAGGCTG	Negative
CTGGACGCACTACACA	Hashtag2
CTGGACGGTGTTGACT	Negative
CTGGACGGTTTGCAGT	Negative
CTGGACGTCCGTGGCA	Hashtag2
CTGGACGTCGCCAACG	Negative
CTGGACGTCTGCATAG	Hashtag2
CTGGCAGAGTAGACAT	Negative
CTGGCAGCACGGCACT	Negative
CTGGCAGGTCCAACGC	Hashtag2
CTGGCAGTCCTAGAGT	Hashtag2
CTGGTCTAGGAGCTGT	Hashtag2
CTGGTCTCACACGCCA	Negative
CTGGTCTCAGACAATA	Negative
CTGGTCTCATACATCG	Hashtag2
CTGTACCAGCCAGAGT	Negative
CTGTACCAGTTTCAGC	Hashtag2
CTGTACCCAGCTACTA	Hashtag2
CTGTACCGTCCAACGC	Negative
CTGTAGAAGACGGATC	Hashtag2
CTGTAGAAGAGCTTTC	Negative
CTGTAGAGTGGCCACT	Negative
CTGTATTCAACCAATC	Hashtag2
CTGTATTTCTGGCCGA	Negative
CTGTCGTAGCTGCCAC	Hashtag2
CTGTGAACACTGCGAC	Negative
CTGTGAACAGATACCT	Hashtag2
CTGTGAACATGGAACG	Negative
CTGTGAATCCTGGGAC	Negative
CTGTGGGCACCTTCGT	Negative
CTGTGGGCACTAGAGG	Negative
CTGTGGGGTAGGTAGC	Negative
CTGTGGGGTCCAACGC	Negative
CTGTGGGGTGGCTTGC	Negative
CTGTGGGTCACACGAT	Negative
CTTACCGCACCTATCC	Negative
CTTACCGGTGTGCTTA	Negative
CTTACCGGTTCGGCGT	Hashtag2
CTTACCGTCCAATCTT	Negative
CTTACCGTCGTGGTAT	Negative
CTTAGGAAGCATGCGA	Hashtag2
CTTAGGAAGCCGGATA	Negative
CTTAGGACATATCTCT	Hashtag2
CTTAGGACATGAAAGT	Hashtag2
CTTAGGACATGATGCT	Hashtag2
CTTAGGAGTTCTGACA	Negative
CTTAGGATCCTATTTG	Negative
CTTAGGATCCTGGGTG	Negative
CTTCAATAGTTTCGAC	Hashtag2
CTTCAATCAAGAGTTA	Hashtag2
CTTCAATCAGTTGCGC	Hashtag2
CTTCAATGTCTTCCGT	Hashtag2
CTTCCTTAGACCTCAT	Hashtag2
CTTCCTTAGAGATTCA	Negative
CTTCCTTAGCCTTCTC	Negative
CTTCCTTAGCGACTAG	Negative
CTTCCTTAGCTCCATA	Hashtag2
CTTCCTTAGGCATGCA	Negative
CTTCCTTAGTGGTGAC	Negative
CTTCCTTCAAGAATGT	Negative
CTTCCTTTCCTAGCTC	Hashtag2
CTTCCTTTCTCGTGAA	Hashtag2
CTTCGGTAGCGATCGA	Negative
CTTCGGTCATCGTTCC	Negative
CTTCGGTGTGCAGGAT	Hashtag2
CTTCGGTTCAGAGTTC	Negative
CTTCGGTTCCAAGCCG	Negative
CTTCGGTTCCAATGCA	Negative
CTTCGGTTCGATTGAC	Hashtag2
CTTCGGTTCTCGAACA	Hashtag2_Hashtag4
CTTCGGTTCTGTGTGA	Negative
CTTCTAAAGACAACTA	Hashtag2
CTTCTAAGTAGTCGTT	Hashtag2
CTTCTAAGTTCGTAAC	Negative
CTTCTAATCCTAAACG	Hashtag2
CTTCTCTCACCCAACG	Negative
CTTCTCTGTCTCCTGT	Negative
CTTCTCTTCCAACACA	Negative
CTTGAGAAGTTGAAGT	Negative
CTTGAGACATTACTCT	Negative
CTTGAGATCCGCCTAT	Hashtag2
CTTGAGATCGAAGCAG	Hashtag2
CTTGATTAGGGCAGTT	Negative
CTTGATTCAACCGCTG	Negative
CTTGATTCAACCGTAT	Negative
CTTGATTGTAGAATAC	Negative
CTTGATTGTGAGACGT	Hashtag2
CTTGATTTCAACGAGG	Negative
CTTGATTTCGGAAGGT	Hashtag2
CTTTCAAAGCAGGGAG	Hashtag2
CTTTCAAGTGGACAGT	Negative
CTTTCGGAGAGTGTGC	Negative
CTTTCGGAGGTCTACT	Negative
CTTTCGGGTGTGTCCG	Hashtag2
CTTTCGGTCGGCCTTT	Hashtag2
GAAACCTCAACGATCT	Hashtag2
GAAACCTCAACTGATC	Negative
GAAACCTGTACCCGAC	Negative
GAAACCTGTATCGCTA	Negative
GAAACCTTCCCTCAAC	Hashtag4
GAAATGAAGAGGCTGT	Hashtag4
GAAATGAGTCTGATAC	Hashtag2
GAACACTAGTAGACCG	Negative
GAACACTCACTAGGCC	Hashtag2
GAACACTCATCATCTT	Negative
GAACACTGTCATCCGG	Hashtag2
GAACGTTCAAATGAGT	Negative
GAACGTTCACAATGAA	Hashtag2
GAACGTTGTAACATGA	Hashtag2
GAACGTTGTACGCTAT	Negative
GAACGTTGTAGCTCGC	Negative
GAACTGTAGACTAAGT	Negative
GAACTGTCAAAGCTCT	Negative
GAACTGTGTCCGGCAT	Negative
GAACTGTGTCGGTACC	Negative
GAAGAATCAGGACAGT	Negative
GAAGAATCAGTCTTCC	Negative
GAAGAATGTTGCTAGT	Negative
GAAGAATTCGAGATGG	Negative
GAAGAATTCGTGAGAG	Hashtag2
GAAGAATTCGTTGTAG	Hashtag2
GAAGCCCAGTTGTAAG	Negative
GAAGCCCCAAGTGACG	Hashtag2
GAAGCCCCAGCGGATA	Negative
GAAGCCCCATAATCGC	Negative
GAAGCCCTCAAACTGC	Hashtag2
GAAGCGAAGCGTCAAG	Negative
GAAGCGAAGTCATCGT	Hashtag2
GAAGCGAAGTGGACGT	Negative
GAAGCGAGTCCAGCGT	Negative
GAAGCGAGTGGAAATT	Negative
GAAGCGAGTTAGAGAT	Hashtag2
GAAGCGAGTTGGAGAC	Negative
GAAGCGATCCATACAG	Hashtag2
GAAGCGATCCATCACC	Negative
GAAGCGATCGCTGATA	Hashtag2
GAAGGACCACGCTTAA	Negative
GAAGGACCACTACTTT	Hashtag2
GAAGGACGTCTCAGGC	Hashtag2
GAAGGACTCCTAAGTG	Negative
GAAGGACTCTTCGTGC	Negative
GAAGGGTTCCTCGCAT	Hashtag2
GAAGTAAAGCACCGTC	Hashtag2
GAAGTAAGTTGCCGCA	Negative
GAATAGATCAGACATC	Hashtag2
GAATCACAGAAACCAT	Negative
GAATCACAGAGGGTAA	Negative
GAATCACAGCTGAAGC	Negative
GAATCACCACTGCGAC	Negative
GAATCACCATCCGCGA	Hashtag2
GAATCACTCCGACATA	Negative
GAATCGTAGTCAGCGA	Negative
GAATCGTCACATAACC	Negative
GAATCGTGTGGCAACA	Negative
GAATCGTTCCGAAATC	Negative
GAATCGTTCCGAACGC	Negative
GACACGCCAGAGAAAG	Negative
GACACGCGTATGAAGT	Hashtag2
GACACGCGTTACAGCT	Negative
GACACGCGTTGGCCGT	Negative
GACACGCTCCGTGGTG	Negative
GACAGCCAGAAGTCCG	Hashtag2
GACAGCCAGTGGTTGG	Negative
GACAGCCAGTTATGGA	Hashtag2
GACATCACAGCAATTC	Negative
GACATCAGTGTGTACT	Negative
GACATCATCATTGCCC	Negative
GACCAATAGACTCTAC	Negative
GACCAATAGTGGACGT	Negative
GACCAATGTCATAACC	Negative
GACCAATTCTGGTGCG	Negative
GACCCAGAGGGACACT	Hashtag2
GACCCAGCATCTGCGG	Negative
GACCCAGGTATTCTCT	Negative
GACCCAGTCCCGAGTG	Negative
GACCCTTAGGCTTTCA	Negative
GACCCTTCAGGCGTTC	Hashtag2
GACCGTGCATGTGGTT	Negative
GACCGTGGTAGCGTTT	Hashtag2
GACCGTGGTATTCTCT	Negative
GACCGTGTCCTCACCA	Hashtag2
GACCGTGTCTATGTGG	Negative
GACCTTCAGTCGTCTA	Negative
GACCTTCCACTAGGTT	Negative
GACCTTCGTACAATAG	Negative
GACCTTCGTATTGACC	Negative
GACCTTCGTCCGGTGT	Negative
GACCTTCGTTGGCCTG	Negative
GACGCTGCATGGTGGA	Negative
GACGCTGGTTGGGATG	Negative
GACGCTGTCATAGGCT	Hashtag2
GACGCTGTCCTGGTCT	Negative
GACGCTGTCGAGGCAA	Negative
GACGCTGTCTTCCCGA	Hashtag2
GACGTTACAACCCGCA	Hashtag2
GACGTTATCATTGCTT	Hashtag2
GACGTTATCTCTGAGA	Hashtag2
GACTATGCAACCAACT	Negative
GACTATGCACAAGTGG	Negative
GACTATGCACCATTCC	Negative
GACTATGGTAGTTAGA	Hashtag2
GACTATGGTCAGACGA	Hashtag2
GACTCAAAGCTAATCC	Hashtag2
GACTCAACAGAGTTCT	Hashtag2
GACTCAACAGCGGATA	Hashtag2
GACTCAAGTCGTACAT	Hashtag2
GACTCAAGTCGTTCAA	Hashtag2
GACTCAAGTGAGACGT	Negative
GACTCAATCCGGTTCT	Negative
GACTCAATCGAGAGAC	Negative
GACTCTCAGCCTGAGA	Negative
GACTCTCCATTGAAAG	Negative
GACTCTCGTTGCGGCT	Hashtag2
GACTGATAGCAGCCCT	Negative
GACTGATCACGACGTC	Negative
GACTGATCATCCTTCG	Hashtag2
GACTTCCAGACTTCAC	Negative
GACTTCCAGCGTACAG	Hashtag2
GACTTCCGTACGTGTT	Hashtag2
GACTTCCGTCTAACGT	Negative
GACTTCCTCCGCAAAT	Negative
GACTTCCTCCTTATGT	Hashtag2
GAGAAATCAATACAGA	Hashtag2
GAGAAATGTAAGCGGT	Negative
GAGAAATTCTGCGGCA	Negative
GAGACCCAGCATCAGG	Negative
GAGACCCGTACCCAGC	Negative
GAGACTTAGCCTCCAG	Negative
GAGACTTCAAGTGCAG	Negative
GAGACTTCAATGAAAC	Hashtag2
GAGACTTTCGGCATCG	Hashtag2
GAGACTTTCTCCTACG	Negative
GAGACTTTCTGCTAGA	Negative
GAGACTTTCTTAGCAG	Hashtag2
GAGAGGTCAACCGACC	Negative
GAGAGGTCACAACGTT	Negative
GAGAGGTGTCTTCAAG	Hashtag2
GAGAGGTGTTGACGGA	Negative
GAGAGGTGTTTCGCTC	Negative
GAGAGGTTCGCCGAAC	Negative
GAGAGGTTCTCTTGCG	Negative
GAGATGGAGAGCCCAA	Hashtag2
GAGATGGAGTTCTCTT	Negative
GAGATGGCAATCGCCG	Negative
GAGATGGCACACGCCA	Negative
GAGATGGCAGAGTGAC	Negative
GAGATGGGTCCGCAGT	Hashtag2
GAGCCTGAGCATACTC	Negative
GAGCCTGCATATGAAG	Negative
GAGCCTGGTTCCGCGA	Negative
GAGCCTGTCCCTCTAG	Negative
GAGCCTGTCGACGACC	Negative
GAGCCTGTCTGACAGT	Negative
GAGCCTGTCTTTGATC	Negative
GAGCTGCCACATGGTT	Negative
GAGCTGCTCACTACTT	Hashtag2
GAGCTGCTCCACTGAA	Negative
GAGGCAAAGTATTAGG	Negative
GAGGCAACACGGATCC	Hashtag4
GAGGCAACATCTTCGC	Negative
GAGGCAACATGCTGCG	Negative
GAGGCAAGTCAGGTGA	Negative
GAGGCCTAGCAATAAC	Hashtag2
GAGGCCTGTTAGGCTT	Negative
GAGGGATAGAGGCGGA	Negative
GAGGGATCACCCAAGC	Negative
GAGGGATGTTGCTAGT	Negative
GAGGGATGTTGGGCCT	Negative
GAGGGATTCTCTGCCA	Negative
GAGGGTAAGTCAAGCG	Negative
GAGGGTAAGTGCACCC	Negative
GAGGGTAGTCTATGAC	Hashtag2
GAGGGTAGTCTGTGCG	Hashtag4
GAGGGTAGTGAGGCAT	Negative
GAGTCATAGAGTTGTA	Negative
GAGTCATAGCACGATG	Negative
GAGTCATGTATCGTAC	Negative
GAGTCATTCTCCTACG	Negative
GAGTCTAAGAGTGAAG	Hashtag2
GAGTCTAAGGATCACG	Hashtag2
GAGTCTAGTAGGTCAG	Negative
GAGTCTAGTATGTCTG	Hashtag2
GAGTCTATCAGAGTGG	Negative
GAGTCTATCGGTCTGG	Hashtag2
GAGTGAGCAGCACAAG	Negative
GAGTGAGCATGACTAC	Negative
GAGTGAGGTCAGTCGC	Negative
GAGTGAGTCCCTCTCC	Hashtag2
GAGTGAGTCGATTCCC	Negative
GAGTGTTAGATTCGCT	Negative
GAGTGTTCAATCCTTT	Negative
GAGTGTTTCAAAGGTA	Hashtag2
GAGTTACCAATAGTCC	Negative
GAGTTACCAGAACTTC	Hashtag2
GAGTTACGTGGCAGAT	Negative
GAGTTACGTTCGAACT	Negative
GAGTTGTAGAGCATCG	Negative
GAGTTGTAGGCCTTCG	Negative
GAGTTGTAGTCACGAG	Negative
GAGTTGTGTCTTACAG	Hashtag2
GAGTTTGAGGTACATA	Negative
GAGTTTGCACGGATCC	Hashtag2
GAGTTTGTCGAACCAT	Negative
GAGTTTGTCGTTACCC	Negative
GATAGAAAGCATCCCG	Hashtag2
GATAGAAAGCGTATAA	Hashtag4
GATAGAACAATGTGGG	Negative
GATAGAATCGCCGAAC	Hashtag2
GATAGCTTCTGAGAGG	Negative
GATAGCTTCTTGCAAG	Negative
GATCACAAGCACTTTG	Negative
GATCACAAGGACGGAG	Negative
GATCACAAGGAGATAG	Negative
GATCACAAGGGCAGTT	Negative
GATCACACACAGTATC	Hashtag2
GATCACAGTCGAACGA	Hashtag2
GATCACATCTATCGCC	Hashtag2
GATCACATCTCCTACG	Negative
GATCACATCTGAGTCA	Negative
GATCAGTAGAAACCAT	Negative
GATCAGTAGTTGCTCA	Hashtag2
GATCAGTCAAAGTATG	Negative
GATCAGTCAGTGGGTA	Hashtag2
GATCAGTGTACACGTT	Negative
GATCAGTTCAAAGAAC	Hashtag2
GATCAGTTCAACCTCC	Hashtag2
GATCATGAGACGGATC	Hashtag4
GATCATGAGAGGTATT	Hashtag2
GATCATGCACGAAAGC	Negative
GATCATGGTGAATGTA	Hashtag2
GATCATGTCATCACAG	Negative
GATCCCTAGTTGAATG	Hashtag2
GATCCCTGTCATAGTC	Negative
GATCCCTGTGCGTCGT	Negative
GATCCCTTCCTTCTGG	Negative
GATCGTAAGAGAATCT	Negative
GATCGTAAGCACCAGA	Negative
GATCGTAGTTACCCAA	Hashtag2
GATCGTATCATGCCCT	Negative
GATCGTATCTATCCAT	Negative
GATGACTAGTGGCCTC	Negative
GATGACTCACCCTCTA	Hashtag2
GATGACTCACCTTCGT	Negative
GATGACTCAGCCTACG	Negative
GATGAGGGTGCCTGCA	Negative
GATGATCGTAGGAGGG	Negative
GATGATCGTAGGCTGA	Hashtag2
GATGATCGTATCGTAC	Negative
GATGCTACAGGTCAGA	Negative
GATGCTAGTTCGTAAC	Negative
GATGGAGAGTCAGCGA	Hashtag2
GATGGAGTCTGCGGGT	Negative
GATTCGAAGACTGGGT	Negative
GATTCGAGTATCCTTT	Hashtag2
GATTCGAGTGTGTCGC	Hashtag2
GATTCTTAGACAACTA	Negative
GATTCTTAGAGCCTGA	Negative
GATTCTTAGCTTCTAG	Negative
GATTCTTCAGGCACTC	Hashtag2
GATTCTTGTACCTTCC	Negative
GATTGGTAGCGCCTTG	Negative
GATTGGTCAAATCAAG	Negative
GATTTCTAGGAAGTAG	Negative
GATTTCTCACTTCCTG	Negative
GATTTCTGTATCTCGA	Negative
GATTTCTGTCTGTAGT	Hashtag2
GATTTCTGTGAATTGA	Hashtag2
GATTTCTGTGCTTATG	Hashtag2
GCAACATAGACGCTCC	Negative
GCAACATCACACCAGC	Negative
GCAACATCAGAAGCGT	Negative
GCAACATTCGCAATGT	Negative
GCAACCGAGGCCGCTT	Negative
GCAACCGGTAGTTCCA	Negative
GCAACCGGTCATAAAG	Negative
GCAACCGGTCCACGCA	Negative
GCACGGTAGCTCTGTA	Negative
GCACGGTAGGCGTTAG	Negative
GCACGGTCAATACCTG	Negative
GCACGGTGTGTAAACA	Negative
GCACGGTGTTGCAACT	Negative
GCACGGTTCTAAACGC	Negative
GCACGTGAGATTAGAC	Negative
GCACGTGGTCTTGCGG	Hashtag2
GCACGTGGTGAGGAAA	Hashtag2
GCACGTGTCAATCAGC	Hashtag2
GCACTAAAGCTGTGCC	Hashtag2
GCACTAACACGCTGTG	Negative
GCACTAACATATACCG	Hashtag2
GCACTAACATGTAACC	Negative
GCAGCCAAGGAACATT	Hashtag2
GCAGCCAGTAAGGAGA	Negative
GCAGCCATCAAGAGTA	Negative
GCAGCTGAGCACAAAT	Negative
GCAGCTGAGCTCGAAG	Negative
GCAGCTGCAAGTATCC	Hashtag2
GCAGCTGCACACGCCA	Hashtag2
GCAGCTGCAGTCTACA	Negative
GCAGCTGGTAGGCAAC	Hashtag2
GCAGCTGTCTTGTGCC	Negative
GCAGGCTAGAGTCGAC	Negative
GCAGGCTCAGACCGCT	Negative
GCAGGCTTCCTGTAAG	Hashtag2
GCAGTTAAGAGAGAAC	Hashtag2
GCAGTTAGTAGACTGG	Negative
GCAGTTATCAACGCTA	Negative
GCAGTTATCAACGTGT	Negative
GCAGTTATCAGCCCAG	Hashtag2
GCAGTTATCCTCTAAT	Negative
GCAGTTATCTCCTACG	Negative
GCATCGGAGATACCAA	Negative
GCATCGGTCGTCGGGT	Negative
GCATCGGTCTCCCATG	Negative
GCATCTCCACTACACA	Hashtag2
GCATCTCGTATGGAAT	Negative
GCATCTCGTTGCAACT	Hashtag2
GCATCTCTCCACTGAA	Hashtag2
GCATCTCTCCCATACC	Negative
GCATGATAGACATACA	Negative
GCATGATCAGTCAGAG	Hashtag2
GCATGATGTGACTATC	Negative
GCATGATGTGCCCACA	Hashtag2
GCATGATTCTGAGATC	Negative
GCATTAGAGATCGCCC	Negative
GCATTAGCACACTTAG	Negative
GCATTAGCACCTATCC	Negative
GCATTAGCAGTAACGG	Hashtag2
GCATTAGCATCCCGTT	Hashtag2
GCATTAGGTCACGCTG	Hashtag2
GCATTAGTCACGAACT	Negative
GCATTAGTCATCGACA	Hashtag2
GCCAACGAGTGAACAT	Negative
GCCAACGCAGTGGGTA	Negative
GCCAACGCATGCAGCC	Negative
GCCAACGTCAACGAGG	Negative
GCCAACGTCTGTCAGA	Negative
GCCAGCAAGTAGTGCG	Negative
GCCAGCAAGTATAGGT	Negative
GCCAGCACAAGAAACT	Negative
GCCAGCACACTGCGAC	Negative
GCCAGCAGTGTCACAT	Hashtag4
GCCAGGTGTAACAGTA	Negative
GCCAGGTGTAGTGGCA	Hashtag2
GCCAGGTGTTGTGCCG	Negative
GCCAGTGAGCCAAGCA	Negative
GCCAGTGGTTCATCGA	Negative
GCCAGTGGTTGTAAAG	Hashtag2
GCCATGGAGAACAAGG	Negative
GCCATGGGTATAGGAT	Negative
GCCATGGGTTGTTGAC	Negative
GCCATTCAGACCGCCT	Negative
GCCATTCCAAGGTCGA	Negative
GCCATTCCAGACACCC	Negative
GCCATTCTCTTAGCAG	Negative
GCCCAGACAAACACCT	Negative
GCCCAGAGTCCTGTCT	Negative
GCCCAGATCCATCTCG	Hashtag2
GCCCAGATCGAACCAT	Hashtag2
GCCCGAAAGGTCCCGT	Hashtag2
GCCCGAACAATCACGT	Negative
GCCCGAATCCACAAGT	Hashtag2
GCCGATGAGAGCTTTC	Hashtag2
GCCGATGAGATCGACG	Negative
GCCGATGAGCAGGCTA	Negative
GCCGATGAGTTCCTGA	Negative
GCCGATGGTCATGCAT	Negative
GCCGATGGTCCAGCCA	Hashtag2
GCCGATGTCATACGAC	Hashtag2
GCCGATGTCCACAAGT	Negative
GCCGATGTCTTCCTAA	Hashtag2
GCCGTGACAACACACT	Negative
GCCTGTTGTCCAGCGT	Negative
GCCTGTTTCAGCTAGT	Hashtag4
GCCTGTTTCATTTCGT	Negative
GCCTGTTTCGACCATA	Negative
GCGAGAAAGGTATAGT	Negative
GCGAGAACACTCCTTG	Negative
GCGATCGAGCATGATA	Hashtag2
GCGATCGAGCTCGACC	Negative
GCGATCGAGGGCAGAG	Negative
GCGATCGAGTTGTCGT	Negative
GCGATCGCAGAACATA	Negative
GCGATCGGTTATAGAG	Negative
GCGGAAAAGATTGAGT	Negative
GCGGAAAAGCTGAAAT	Negative
GCGGAAAAGGTCCTGC	Hashtag2
GCGGAAAGTATGACAA	Hashtag2
GCGGAAATCAAGCTTG	Negative
GCGGAAATCTCTTAAC	Hashtag2
GCGGAAATCTGGTCAA	Negative
GCGGAAATCTGTGCTC	Hashtag2
GCGGATCCAAGAGGCT	Hashtag2
GCGGATCTCGTTAGAC	Negative
GCGGATCTCTCTGGTC	Hashtag2
GCGTGCAAGACGCCAA	Negative
GCGTGCAAGGGAGGTG	Negative
GCGTGCAAGTCACAGG	Negative
GCGTGCACAGTCTACA	Negative
GCGTGCATCATTCCTA	Negative
GCGTGCATCCAAACCA	Negative
GCGTGCATCCGACGGT	Hashtag2
GCGTTTCCATCCGTGG	Negative
GCGTTTCCATGTCTAG	Negative
GCGTTTCGTTATAGAG	Negative
GCTACAACAAGCTCTA	Negative
GCTACAATCGCGTAGC	Negative
GCTACCTAGACATATG	Negative
GCTCAAAAGCGAGGAG	Negative
GCTCAAAGTATCTTCT	Negative
GCTCAAATCAGCGGAA	Negative
GCTGAATAGAGCTTTC	Negative
GCTGAATCAAATGAGT	Negative
GCTGAATGTGGACCTC	Negative
GCTGAATTCCGGCAGT	Negative
GCTGCAGAGAAGCTGC	Hashtag2
GCTGCAGAGAAGTGTT	Negative
GCTGCAGAGCGACCCT	Negative
GCTGCAGAGGTAAGGA	Hashtag2
GCTGCAGCATCGCTGG	Negative
GCTGCAGTCGAAGCAG	Hashtag2
GCTGGGTCAACGCCCA	Negative
GCTGGGTGTGGGATTG	Negative
GCTGGGTTCAGAGTGG	Negative
GCTTCACAGAGGCGGA	Hashtag2
GCTTCACTCGCATTGA	Negative
GCTTGGGAGTAAATGC	Negative
GCTTGGGCAAGGTCGA	Hashtag2
GCTTGGGGTATCCCAA	Hashtag2
GCTTGGGGTGATACAA	Negative
GCTTGGGGTTTCACTT	Negative
GCTTTCGCAAGCGCTC	Hashtag2
GCTTTCGCACGTAACT	Hashtag2
GCTTTCGTCACCGACG	Negative
GGAACCCAGCCATATC	Hashtag2
GGAACCCAGGAGGTTC	Negative
GGAACCCCAAGCACAG	Negative
GGAACCCGTGTTACTG	Negative
GGAACCCTCGGACAAG	Hashtag2
GGAACCCTCTAATTCC	Hashtag2
GGAACCCTCTAGTACG	Negative
GGAAGTGGTCCATCTC	Hashtag2
GGAAGTGGTTGTGCCG	Hashtag2
GGAATCTAGTCAACAA	Hashtag2
GGAATCTCAAATGAAC	Negative
GGAATCTCAAGATGGC	Hashtag2
GGAATCTGTCGTGATT	Negative
GGAATCTGTGCAATGG	Negative
GGAATCTTCCGCGATG	Negative
GGAATCTTCTTTGCAT	Negative
GGAATGGAGATCCGAG	Negative
GGAATGGCAACAAAGT	Negative
GGAATGGCACATTGTG	Negative
GGAATGGGTCGCCACA	Negative
GGAATGGTCAGGGATG	Negative
GGACGTCAGATGTTAG	Negative
GGACGTCAGCACACAG	Negative
GGACGTCAGCTCCATA	Negative
GGACGTCAGCTTGTGT	Negative
GGACGTCTCACTGCTC	Hashtag2
GGAGAACAGTAGACCG	Negative
GGAGAACCACACTGGC	Negative
GGAGAACCAGCACCCA	Negative
GGAGAACGTGAGTTGG	Negative
GGAGAACTCACACCGG	Negative
GGAGATGGTACCCGCA	Negative
GGAGATGGTGAACTAA	Negative
GGAGCAAAGGAGTACC	Hashtag2
GGAGCAAGTTCCTAAG	Hashtag2
GGAGCAATCGAGCCTG	Negative
GGAGCAATCTATGCCC	Negative
GGAGGATCACCATATG	Hashtag2
GGAGGATCAGAGTAAT	Negative
GGAGGATCAGCATACT	Negative
GGAGGATCAGTCGGAA	Negative
GGAGGATCATAGGTAA	Negative
GGAGGATTCTTCTGGC	Negative
GGAGGTAAGGTTCTAC	Negative
GGAGGTAAGTGGCCTC	Hashtag2
GGAGGTACAATCCTAG	Hashtag2
GGAGGTACAGCGCTTG	Negative
GGAGGTACAGGGCTTC	Negative
GGAGGTATCCGAGGCT	Hashtag2
GGATCTAAGAATCGAT	Negative
GGATCTAGTTGGCCGT	Hashtag2
GGATCTATCTAGTACG	Hashtag2
GGATGTTAGTGCCAGA	Negative
GGATGTTAGTGCTAGG	Hashtag2
GGATGTTCAGCAGTGA	Negative
GGATGTTGTGAGAGGG	Negative
GGATGTTGTTCTCTAT	Negative
GGATGTTTCACTTTGT	Hashtag2
GGATGTTTCGCGTGCA	Negative
GGCACGTTCGGCAGTC	Negative
GGCAGTCAGAGAGCGG	Negative
GGCAGTCAGCTAAATG	Negative
GGCAGTCGTCAGGAGT	Negative
GGCAGTCTCCATCTCG	Hashtag2
GGCAGTCTCGGCCTTT	Hashtag2
GGCAGTCTCTAGCCTC	Hashtag2
GGCGTCATCGGAGCAA	Negative
GGCTGTGAGACTCAAA	Hashtag2
GGCTGTGCATGCGGTC	Negative
GGCTGTGTCCTGTTGC	Negative
GGCTTGGAGAAAGCGA	Negative
GGCTTGGCATGAGAAT	Hashtag2
GGCTTGGTCAGCGCGT	Hashtag2
GGCTTGGTCTTTCCGG	Negative
GGCTTTCAGCGGTAGT	Negative
GGCTTTCCAGGTCAGA	Hashtag2
GGCTTTCGTCATGACT	Negative
GGCTTTCGTGCCTACG	Negative
GGCTTTCTCTACCACC	Negative
GGGAAGTAGCATCAGG	Negative
GGGAAGTTCACCTCGT	Negative
GGGAAGTTCGGCTTGG	Negative
GGGACAAGTACTCGCG	Hashtag2
GGGACAATCGACATTG	Negative
GGGACCTAGCGACCCT	Negative
GGGACCTCAAGCAATA	Negative
GGGACCTCATAATGAG	Negative
GGGACTCAGCTCTGTA	Hashtag2
GGGACTCCATTGCTGA	Negative
GGGAGATCAACCAATC	Hashtag4
GGGAGATCAGCGGTTC	Negative
GGGAGATCATGAATAG	Hashtag2
GGGAGATGTCCAGGTC	Negative
GGGAGATGTGTTCATG	Negative
GGGAGTAAGACGTCCC	Hashtag2
GGGAGTACAAGGTTGG	Negative
GGGAGTACACGCCAGT	Negative
GGGAGTAGTGAGACGT	Negative
GGGAGTAGTTAGAAAC	Negative
GGGAGTATCCCGAGGT	Hashtag2
GGGATCCAGCGACAGT	Negative
GGGATCCAGGGTAATT	Negative
GGGATCCAGGTTCATC	Negative
GGGATCCAGTGGTTAA	Hashtag2
GGGATCCGTGATCGTT	Hashtag2
GGGATGAAGACACACG	Negative
GGGATGAAGGTTCATC	Hashtag2
GGGATGACAGATCCAT	Negative
GGGATGAGTAACATCC	Hashtag2
GGGATGAGTCCTCCTA	Negative
GGGCCATAGCGCGTTC	Hashtag2
GGGCCATAGTGGATAT	Hashtag2
GGGCCATTCCATAAGC	Negative
GGGCCATTCGCCATAA	Negative
GGGCGTTAGCCTGAAG	Negative
GGGCGTTAGGGATCGT	Negative
GGGCGTTCAGCAATTC	Negative
GGGCGTTTCCCTGTTG	Negative
GGGCTACAGACACACG	Negative
GGGCTACAGTCAGAGC	Negative
GGGCTACTCTCGTTTA	Negative
GGGCTCAAGACCTTTG	Negative
GGGCTCAAGTCATCCA	Hashtag2
GGGCTCAAGTTACGTC	Negative
GGGCTCACAGTCGGTC	Negative
GGGCTCATCGTTCCTG	Negative
GGGTAGAAGACCACGA	Hashtag2
GGGTAGAAGCCTCGTG	Hashtag2
GGGTAGACACTGGCGT	Hashtag2
GGGTAGATCATCGCTC	Negative
GGGTAGATCCTCTTTC	Negative
GGGTATTAGGCAGGTT	Negative
GGGTATTCAACTGCTA	Negative
GGGTATTCATCTCCCA	Hashtag2
GGGTATTTCAACGCTA	Negative
GGGTATTTCCAGCAAT	Hashtag2
GGGTCACAGGCTCAAG	Negative
GGGTCACAGTCGAAGC	Hashtag2
GGGTCACCACGAGGAT	Hashtag2
GGGTCACGTACGGATG	Negative
GGGTCACGTCGCTGCA	Negative
GGGTCTGAGTGCACTT	Hashtag2
GGGTCTGCAACCGATT	Negative
GGGTCTGTCCATCTAT	Negative
GGGTGAAAGCATTTCG	Negative
GGGTGAAGTACGTGAG	Negative
GGGTGAATCATGGATC	Negative
GGGTGTCAGGGAGAAT	Negative
GGGTGTCCACCCAATA	Negative
GGGTGTCGTCATCGCG	Negative
GGGTGTCGTCTATGAC	Negative
GGGTGTCGTGGAATGC	Negative
GGGTGTCGTTGTAGCT	Hashtag2
GGGTGTCTCCTACGAA	Negative
GGGTGTCTCGCTCATC	Negative
GGGTGTCTCGGCTTCT	Negative
GGGTTATAGGCGTTAG	Negative
GGGTTATCAGAGGCTA	Negative
GGGTTATGTGAGTAAT	Hashtag2
GGGTTATTCCTGTACC	Negative
GGGTTTAAGTCATACC	Hashtag2
GGGTTTACACGCTGCA	Negative
GGGTTTAGTAGTACGG	Negative
GGTAACTCATCCTATT	Negative
GGTAACTTCTCAGTCC	Negative
GGTAACTTCTCGGTCT	Negative
GGTAATCAGGATTACA	Negative
GGTAATCAGTCATTGC	Hashtag4
GGTAATCCATATAGCC	Negative
GGTAATCGTGATGGCA	Negative
GGTAGAGCACACCGCA	Negative
GGTAGAGCAGGTTCGC	Hashtag2
GGTAGAGGTTACGCCG	Negative
GGTCACGCAGAGATTA	Hashtag2
GGTCACGCAGGCGTTC	Negative
GGTCACGGTCATGACT	Negative
GGTCACGTCCGGGACT	Negative
GGTGAAGAGCCATCCG	Hashtag2
GGTGAAGGTAGTGCGA	Negative
GGTGAAGGTAGTTAGA	Negative
GGTGAAGGTCATAAAG	Negative
GGTGGCTAGGTAGTCG	Negative
GGTGGCTCAAATCCCA	Negative
GGTGGCTCAGGCCCTA	Negative
GGTGGCTGTCAAATCC	Negative
GGTGGCTTCGCACTCT	Negative
GGTGTCGAGGCACAAC	Negative
GGTGTCGGTGATAGTA	Negative
GGTGTCGTCTATCGCC	Negative
GGTGTCGTCTGGCCAG	Negative
GGTGTTAAGCACACCC	Hashtag2
GGTGTTAAGGACAGCT	Negative
GGTGTTAAGGGTCTTT	Negative
GGTGTTAAGTGGCAGT	Hashtag2
GGTGTTAGTGAGCTCC	Hashtag2
GGTGTTATCTCGGGAC	Negative
GGTTAACAGAAATGGG	Negative
GGTTAACAGCCTGGAA	Negative
GGTTAACAGGTATTGA	Negative
GGTTAACTCCGTATAG	Negative
GGTTAACTCTTCCCGA	Negative
GGTTCTCAGCCATATC	Negative
GGTTCTCAGCTATCCA	Negative
GGTTCTCCAGCTAACT	Negative
GGTTCTCGTGGGCTTC	Negative
GGTTGTAAGGGCGAGA	Hashtag2
GGTTGTAAGTACGAGC	Hashtag4
GGTTGTAAGTGATGGC	Negative
GGTTGTAAGTTCAACC	Negative
GGTTGTACAGCATTGT	Negative
GGTTGTACATTGACAC	Negative
GGTTGTAGTCGCGTCA	Hashtag2
GGTTGTAGTTGCTCCT	Negative
GGTTGTAGTTTACTGG	Hashtag2
GGTTGTATCCCAAGCG	Negative
GGTTGTATCCCTTTGG	Negative
GGTTGTATCTGGTGCG	Negative
GTAACACAGCCTCTCT	Negative
GTAACACCAATAACGA	Negative
GTAACACGTAGTACGG	Negative
GTAACACGTCTCACAA	Negative
GTAACACTCCCTTTGG	Negative
GTAACACTCCTACGGG	Negative
GTAACACTCCTAGCGG	Negative
GTAACACTCCTCTCGA	Negative
GTAACCAAGGTCGCCT	Negative
GTAACCAAGTCGGGAT	Negative
GTAACCAGTCTGTAGT	Negative
GTAACCATCCACCTCA	Negative
GTAAGTCAGTTGTAAG	Negative
GTAAGTCCAACTTCTT	Hashtag2
GTAAGTCCATAATGAG	Negative
GTAAGTCTCCATATGG	Hashtag2
GTAATCGAGAGTCCGA	Negative
GTAATCGTCCGTTGGG	Negative
GTAATCGTCTTGTGCC	Negative
GTAATGCAGAACAAGG	Negative
GTAATGCGTATCACGT	Hashtag4
GTAATGCGTTCAAACC	Hashtag2
GTAATGCTCAGCGTCG	Negative
GTAATGCTCCTCTGCA	Negative
GTACAACTCCGTAGTA	Negative
GTACAACTCGGTCAGC	Negative
GTACAGTAGGCTCACC	Negative
GTACAGTGTAATCAAG	Hashtag2
GTACAGTGTATGAAGT	Negative
GTACAGTGTCAGACGA	Negative
GTACAGTGTGTTCATG	Hashtag2
GTAGAAACAAGCACAG	Hashtag2
GTAGAAACACGTCGTG	Negative
GTAGAAAGTAGGTGCA	Negative
GTAGAGGAGGCAATGC	Negative
GTAGAGGAGGCCCAAA	Hashtag2
GTAGAGGAGTTCCTGA	Negative
GTAGAGGCAAAGGCTG	Negative
GTAGAGGGTCGTATTG	Negative
GTAGAGGTCATTTACC	Negative
GTAGATCAGCGCCTAC	Negative
GTAGATCCAGGTCTCG	Negative
GTAGATCTCACGGAGA	Negative
GTAGATCTCATGCATG	Hashtag2
GTAGATCTCCACTTCG	Hashtag2
GTAGATCTCGAGAGAC	Negative
GTAGATCTCGGTATGT	Negative
GTAGCTACAACAGAGC	Hashtag2
GTAGCTACATGTGGTT	Hashtag2
GTAGCTAGTGAATGAT	Hashtag2
GTAGCTAGTGACTATC	Hashtag2
GTAGCTATCACCTGGG	Negative
GTAGCTATCGGTGTAT	Negative
GTAGGAGCAGAGTGAC	Negative
GTAGGAGCATCATGAC	Negative
GTAGGAGGTCCCTCAT	Hashtag2
GTAGGAGTCATTGCGA	Negative
GTAGGTTAGACGAAGA	Negative
GTAGGTTCACAATGTC	Negative
GTAGGTTGTGCCCACA	Negative
GTAGGTTTCCGACGGT	Negative
GTAGGTTTCCTTCTGG	Negative
GTAGTACAGAATTTGG	Negative
GTAGTACCACTGGAAG	Negative
GTAGTACCACTGGATT	Negative
GTAGTACTCCATTGTT	Negative
GTAGTACTCGCAAGAG	Negative
GTATTGGGTCACAGTT	Negative
GTATTGGGTCATAAAG	Hashtag2
GTATTTCCAAAGGCTG	Negative
GTATTTCCAACGTAAA	Negative
GTATTTCGTGTTCCTC	Negative
GTATTTCGTGTTCGTA	Hashtag4
GTCAAACAGACTCAAA	Negative
GTCAAACAGATCCCGC	Hashtag2
GTCAAACAGTAGATCA	Hashtag2
GTCAAACAGTATCTGC	Negative
GTCAAACGTAACAAGT	Negative
GTCAAACTCATCGTAG	Negative
GTCAAGTAGCTCGAAG	Negative
GTCAAGTCATACAGAA	Negative
GTCAAGTGTCGGCACT	Negative
GTCAAGTTCAATCAGC	Negative
GTCAAGTTCATAGGCT	Hashtag2
GTCACGGGTAGATCCT	Negative
GTCACTCAGTTGCATC	Negative
GTCACTCCATCTTAGG	Negative
GTCACTCGTCCGGTGT	Negative
GTCACTCTCTTCTGGC	Negative
GTCAGCGAGTGCGTCC	Negative
GTCAGCGCAAATGATG	Negative
GTCAGCGGTTGCATTG	Hashtag2
GTCAGCGTCCCTTCCC	Negative
GTCAGCGTCGCAATGT	Negative
GTCATCCGTCAGGTAG	Negative
GTCATCCGTTAAGAAC	Negative
GTCATCCTCTAAACGC	Hashtag2
GTCATCCTCTGGCCTT	Hashtag2
GTCATCCTCTTAGCAG	Hashtag2
GTCATGAAGGTGCCTC	Negative
GTCATGAAGTCGCGAA	Negative
GTCATGACAGGTATGG	Negative
GTCATGAGTGGCATCC	Negative
GTCATTTAGACTAGAT	Negative
GTCATTTCACTCCTGT	Negative
GTCATTTTCGTGCACG	Negative
GTCCACTAGCTGCCTG	Negative
GTCCACTTCCATACTT	Negative
GTCCACTTCCCGAGAC	Negative
GTCCCATAGGAGTACC	Negative
GTCCCATCATCACGGC	Hashtag4
GTCCCATTCCGTATAG	Hashtag2
GTCCTCAAGACAGCGT	Hashtag2
GTCCTCAAGCAACTCT	Negative
GTCCTCAAGCGCTGCT	Negative
GTCCTCAGTCAGCGTC	Negative
GTCGAATCAGAAGTGC	Negative
GTCGAATTCAAACGAA	Negative
GTCGCGACAATAGTCC	Negative
GTCGCGACATGACTGT	Negative
GTCGCGATCCATCTGC	Negative
GTCGTAACATAGTCAC	Negative
GTCGTAAGTTCCGCAG	Negative
GTCGTAATCCACGGGT	Hashtag2
GTCGTTCAGGGCAGTT	Negative
GTCGTTCAGTCGCCCA	Negative
GTCGTTCCACATATGC	Negative
GTCGTTCCACGGTGCT	Negative
GTCGTTCTCATCCTAT	Hashtag2
GTCTACCAGCCGAATG	Negative
GTCTACCAGGAGACCT	Hashtag2
GTCTACCAGTAGAGTT	Negative
GTCTACCCAGCTTCCT	Negative
GTCTACCTCGTGCACG	Negative
GTCTAGACACAAGTGG	Negative
GTCTAGACACTTGTCC	Negative
GTCTAGACAGGGAGAG	Negative
GTCTAGATCAAGGTGG	Hashtag2
GTCTCACCAGCAGTTT	Negative
GTCTCACCATACTGAC	Hashtag2
GTCTCACCATTCGGGC	Negative
GTCTCACTCGTTGTAG	Negative
GTCTCACTCTAGGCAT	Negative
GTCTGTCAGCCAGTAG	Negative
GTCTGTCAGGAAAGGT	Hashtag2
GTCTGTCGTGCCTGCA	Negative
GTCTGTCTCCGCGATG	Negative
GTCTTTAAGCCTAGGA	Hashtag2
GTCTTTAGTCCACACG	Hashtag2
GTCTTTATCACTTTGT	Negative
GTGACGCCACATCATG	Negative
GTGACGCCAGTTCACA	Hashtag2
GTGACGCGTCGTTGGC	Negative
GTGACGCTCAACTGAC	Hashtag2
GTGAGCCCAACCTAAC	Negative
GTGAGCCGTTAGCGGA	Negative
GTGAGCCTCCCTGTTG	Negative
GTGAGCCTCGTCTAAG	Negative
GTGAGGAAGAGCTGAC	Negative
GTGAGGAAGCACACCC	Negative
GTGAGGACATCGGCCA	Negative
GTGAGTTGTAACCAGG	Negative
GTGAGTTGTATGCGTT	Hashtag2
GTGAGTTTCGTCTCAC	Negative
GTGATGTGTTCCGGTG	Negative
GTGATGTTCGGAATGG	Negative
GTGCACGAGCATATGA	Hashtag2
GTGCACGGTCGCTCGA	Negative
GTGCACGGTGTTACAC	Hashtag2
GTGCACGTCATGAGAA	Negative
GTGCACGTCGCATTGA	Negative
GTGCACGTCGTCAAAC	Hashtag2
GTGCAGCAGACCAACG	Negative
GTGCAGCCACAGAAGC	Hashtag2
GTGCAGCCACTACTTT	Negative
GTGCAGCTCCATAGAC	Negative
GTGCGTGAGAAGGGAT	Negative
GTGCGTGAGCTTGTGT	Negative
GTGCGTGAGTATGAGT	Negative
GTGCGTGCACCAAAGG	Negative
GTGCGTGGTAGGAAAG	Hashtag2
GTGCGTGTCTAGAACC	Negative
GTGCGTGTCTTACTGT	Negative
GTGCTGGCACGCTGCA	Negative
GTGCTGGCAGAATCGG	Negative
GTGCTGGGTCACAGTT	Hashtag2
GTGCTGGGTCATTGCA	Negative
GTGCTGGTCCCACAGG	Negative
GTGCTTCCAAGAAATC	Negative
GTGCTTCTCGACGCTG	Negative
GTGGAAGCAAAGTATG	Negative
GTGGAAGCAGTTGTCA	Negative
GTGGAAGGTACTAAGA	Hashtag2
GTGGAAGGTCGTGCCA	Negative
GTGGAAGGTGCGCTCA	Negative
GTGGAGACACGTCTCT	Negative
GTGGAGACATCTAACG	Negative
GTGGAGAGTGCCTGAC	Negative
GTGGAGAGTTGCTCCT	Hashtag2
GTGGCGTCAAGCCTGC	Negative
GTGGCGTGTCTACACA	Hashtag2
GTGGCGTTCTCCAATT	Negative
GTGGCGTTCTGGTGCG	Negative
GTGGGAAAGGAGACCT	Negative
GTGGGAACATTGGCAT	Hashtag2
GTGGGAATCGACCTAA	Negative
GTGGTTAAGAAGCGGG	Negative
GTGGTTAGTTGTGTTG	Negative
GTGGTTATCAATGCAC	Negative
GTGTAACCAAGCCATT	Negative
GTGTAACCACGTCATA	Negative
GTGTAACGTATCCTCC	Negative
GTGTAACGTGTCATCA	Negative
GTGTAACGTTGCCAAT	Hashtag2
GTGTAACTCAAGTGGG	Negative
GTGTAACTCAGCTAGT	Negative
GTGTAACTCTAGAACC	Hashtag2
GTGTCCTAGAGGTCGT	Negative
GTGTCCTAGCCATTTG	Negative
GTGTCCTAGCTGACTT	Negative
GTGTCCTAGTGTACCT	Negative
GTGTCCTCAGCCTTCT	Negative
GTGTCCTCAGTAGAGC	Hashtag2
GTGTCCTTCATCTGTT	Hashtag2
GTGTGATCAAGGTCAG	Negative
GTGTGATCATGAATAG	Negative
GTGTGATGTGGCTGCT	Negative
GTGTGATGTTGCATAC	Negative
GTGTGATGTTGGTACT	Negative
GTGTGATTCATTCGTT	Negative
GTGTGATTCCTTCTAA	Negative
GTGTGATTCTGTCGCT	Negative
GTGTGGCAGGTACAAT	Negative
GTGTGGCAGTACCATC	Hashtag2
GTGTGGCCAGTATACC	Negative
GTGTGGCGTTATTCTC	Negative
GTGTGGCGTTGGACCC	Hashtag2
GTGTGGCTCGACACCG	Negative
GTGTTAGCATGGAAGC	Hashtag2
GTGTTCCCAAGTGGTG	Negative
GTGTTCCCATGCCGAC	Negative
GTGTTCCTCGTCTCAC	Hashtag2
GTTACAGAGGTGCCAA	Negative
GTTACAGAGGTGGTTG	Negative
GTTACCCAGTTCCGTA	Negative
GTTACCCGTAGAATAC	Negative
GTTACCCGTTGTCTAG	Negative
GTTACGAAGACCTCCG	Hashtag2
GTTACGACAGCCATTA	Negative
GTTACGAGTGACTGTT	Negative
GTTACGATCGTACCTC	Negative
GTTACGATCGTTGCCT	Negative
GTTAGACAGTTTGTCG	Hashtag2
GTTAGACCACAGTACT	Negative
GTTAGACCACGACGAA	Negative
GTTAGACGTAAGCTCT	Hashtag2
GTTAGACGTCGAGCTC	Negative
GTTAGACGTGCGTGCT	Negative
GTTAGACTCCCTTTGG	Hashtag2
GTTAGACTCTGAGGCC	Hashtag2
GTTAGTGCAGCTGCCA	Negative
GTTATGGAGAAACACT	Negative
GTTATGGCAGATTCGT	Negative
GTTATGGTCCAAGCTA	Negative
GTTCATTCACCCGTAG	Hashtag2
GTTCATTCACGCAGTC	Negative
GTTCATTGTTATGACC	Negative
GTTCATTGTTCGAAGG	Negative
GTTCCGTAGAAATTGC	Hashtag2
GTTCCGTTCAGTGGGA	Negative
GTTCCGTTCATACGGT	Negative
GTTCGCTGTTACGTAC	Hashtag2
GTTCTATCACCTCTGT	Hashtag2
GTTCTATCATCTAACG	Negative
GTTCTATGTCTGTAAC	Negative
GTTGAACAGATAACGT	Negative
GTTGAACAGGTTCCAT	Negative
GTTGAACGTAGTCACT	Negative
GTTGAACGTGTTGAGG	Negative
GTTGAACGTTCAAGTC	Negative
GTTGAACTCCATCAGA	Negative
GTTGAACTCCATCTCG	Negative
GTTGCGGAGAAGCCTG	Hashtag2
GTTGCGGAGTCTTGGT	Negative
GTTGCGGGTACGTGTT	Negative
GTTGCGGGTCGCGGTT	Hashtag2
GTTGCGGTCGCCAATA	Negative
GTTGCGGTCGGTGAAG	Negative
GTTGCGGTCGGTGTTA	Hashtag2
GTTGCTCAGTATAGAC	Negative
GTTGCTCGTGACAACG	Negative
GTTGCTCTCCTTGAAG	Negative
GTTGTAGAGCTACAAA	Negative
GTTGTAGTCGACACCG	Negative
GTTGTCCAGGGACCAT	Negative
GTTGTCCAGTTTGGCT	Negative
GTTGTCCCACGTACAT	Negative
GTTGTGAAGTCCTGTA	Negative
GTTGTGACAATCCTAG	Negative
GTTGTGAGTGCATGTT	Negative
GTTGTGATCCAAGCTA	Negative
GTTGTGATCCTTTGAT	Hashtag2
GTTTACTAGAATAACC	Negative
GTTTACTAGGCGAAGG	Hashtag2
GTTTACTGTGCACAAG	Negative
GTTTGGATCAAACCCA	Negative
TAACACGAGCGTACAG	Negative
TAACACGCAATCTGCA	Negative
TAACACGTCCTTGAAG	Hashtag2
TAACCAGCAGTTTCAG	Hashtag2
TAACCAGCATGACTTG	Negative
TAACCAGGTATTGAGA	Negative
TAACCAGGTGCAATAA	Negative
TAACCAGGTGCGGTAA	Negative
TAACCAGTCCTGGTCT	Negative
TAACGACAGAGCCATG	Hashtag2
TAACGACAGCACTAAA	Hashtag2
TAACGACCACGTGTGC	Negative
TAACGACGTGAGAGGG	Negative
TAACGACGTTAGTTCG	Negative
TAACTTCAGCACCAGA	Negative
TAACTTCCACAACCGC	Negative
TAACTTCGTTCGAGCC	Negative
TAAGCACCAAGATGTA	Hashtag4
TAAGCACCATCTCATT	Negative
TAAGCACGTTGCTCGG	Negative
TAAGCCAAGCTGTTCA	Negative
TAAGCCACATTGGGAG	Negative
TAAGCCAGTTGAGAGC	Hashtag2
TAAGCCATCCTAAACG	Negative
TAAGCGTCAAATAAGC	Hashtag2
TAAGCGTGTAAGGCTG	Negative
TAAGCGTGTCTGTCAA	Hashtag2
TAAGCGTGTGTGTGTT	Negative
TAAGCGTGTTAGGAGC	Negative
TAAGCGTGTTGTCCCT	Hashtag2
TAAGCGTTCTGCATGA	Negative
TAAGTCGAGTATGTAG	Negative
TAAGTCGGTCGACTGC	Negative
TAAGTCGGTGAGTTGG	Negative
TAAGTCGGTTCTCTAT	Hashtag2
TAAGTCGGTTGGACCC	Negative
TAATCTCCAGAGATGC	Negative
TAATCTCGTCGAAACG	Negative
TAATCTCTCCCATAAG	Hashtag2
TAATTCCAGACGACTG	Negative
TAATTCCAGACGGTTG	Hashtag2
TAATTCCAGAGAGCAA	Negative
TAATTCCCAAGACCGA	Negative
TAATTCCCATTGTACG	Negative
TAATTCCGTCATAACC	Negative
TAATTCCGTCTACATG	Hashtag2
TACAACGAGGGTTAAT	Hashtag2
TACAACGCATGTGACT	Hashtag4
TACAACGGTAAGATAC	Hashtag2
TACAACGTCATCAGTG	Hashtag2
TACAACGTCCCAAGCG	Negative
TACACCCAGAGATCGC	Negative
TACACCCAGCATGTTC	Negative
TACACCCAGTGGCAGT	Hashtag2
TACACCCGTGACACGA	Negative
TACACCCTCACTGTCC	Negative
TACACCCTCCATGAGT	Negative
TACAGGTAGGGTCAAC	Negative
TACAGGTCAGACTCTA	Negative
TACAGGTGTCTTGAAC	Hashtag2
TACAGGTGTGCTATTG	Hashtag2
TACAGGTTCCTTATAC	Negative
TACATTCAGATTGGGC	Negative
TACATTCAGCAATAGT	Hashtag2
TACATTCGTACAAGTA	Hashtag2
TACATTCGTCGGAACA	Hashtag2
TACCCACCAACATCGT	Hashtag2
TACCCACGTAAGCGGT	Hashtag2
TACCCACTCATATGGC	Negative
TACCCGTAGAAATTGC	Negative
TACCCGTAGGCTATCT	Negative
TACCCGTCATGAGATA	Negative
TACCCGTGTCTACTGA	Hashtag2
TACCCGTTCCGTTGAA	Negative
TACCGAAAGCCACAAG	Negative
TACCGAAGTAAGCTCT	Negative
TACCGAAGTAGCGAGT	Hashtag2
TACCGAATCGCTGTTC	Negative
TACCGGGAGCCTCTTC	Negative
TACCGGGCATCATGAC	Negative
TACCGGGCATGACGTT	Negative
TACCGGGGTAGGACCA	Hashtag2
TACCGGGGTGGAGAAA	Negative
TACCGGGTCAGTCTTT	Hashtag2
TACCGGGTCGTTCGCT	Negative
TACCTCGAGAGCATCG	Negative
TACCTCGAGGGACTGT	Negative
TACCTCGGTAGCTGAG	Negative
TACCTCGGTATAATGG	Negative
TACCTCGTCATTCTTG	Negative
TACCTGCAGCCAACCC	Negative
TACCTGCAGTTTGAGA	Negative
TACCTGCCACCATAAC	Negative
TACCTGCCACTTACAG	Hashtag2
TACCTGCCAGACAAAT	Negative
TACCTGCGTAACTTCG	Negative
TACCTGCGTAGCTCGC	Negative
TACCTGCTCACGGACC	Negative
TACCTGCTCATGAGTC	Negative
TACCTGCTCTAGGAAA	Negative
TACGCTCAGCAATAAC	Negative
TACGCTCAGCTGGCTC	Negative
TACGCTCGTACCCGCA	Hashtag2
TACGCTCTCAGCCTTC	Hashtag2
TACGCTCTCCTGTACC	Hashtag2
TACGCTCTCGGTGTAT	Negative
TACGCTCTCTAGTGAC	Negative
TACGCTCTCTTACGTT	Negative
TACGGGCCAGGCGAAT	Hashtag2
TACGGGCGTGAATGAT	Hashtag2
TACGGTAAGTATTAGG	Negative
TACGGTACAGTATACC	Negative
TACGGTAGTCCCGGTA	Hashtag2
TACGGTAGTGCATCTA	Negative
TACGGTAGTGCTGCAC	Negative
TACGTCCAGTTGGCGA	Negative
TACGTCCCAGACTGCC	Hashtag2
TACGTCCCAGCTTTGA	Negative
TACGTCCCAGTTGTCA	Hashtag2
TACGTCCCATCCAATG	Hashtag2
TACGTCCCATGACTTG	Negative
TACGTCCCATGAGAAT	Hashtag2
TACGTCCGTGTTGCCG	Negative
TACTGCCAGGGATCGT	Hashtag2
TACTGCCAGTCGAAGC	Hashtag2
TACTGCCGTACAAACA	Hashtag4
TACTGCCTCCACGAAT	Negative
TACTGCCTCGGAGTGA	Negative
TACTTACAGCTAAGTA	Hashtag2
TACTTACCAATGTGGG	Negative
TACTTACCAGCGTATT	Negative
TACTTACTCAAGTAAG	Negative
TACTTACTCACCATGA	Negative
TACTTACTCCCGAATA	Hashtag2
TACTTACTCTGGGCAC	Negative
TACTTCACAACCGTGC	Negative
TACTTCAGTCTGTGGC	Negative
TACTTCAGTGCGACAA	Hashtag2
TACTTCAGTTAAGCAA	Hashtag2
TACTTCATCCAGTTCC	Negative
TACTTCATCCCAGCGA	Negative
TACTTCATCTGTTCAT	Negative
TACTTCATCTTAGTTC	Negative
TACTTGTAGCTAAACA	Negative
TACTTGTAGGGTATAT	Hashtag2
TACTTGTCACAGTGAG	Negative
TACTTGTCACCAGTAT	Negative
TACTTGTGTGGACAGT	Hashtag2
TACTTGTGTTGTGGCC	Hashtag2
TACTTGTTCCTCGATC	Negative
TACTTGTTCTAACGGT	Negative
TAGACCAAGAAAGTCT	Negative
TAGACCAAGTTGGAGC	Negative
TAGACCACATAAGCGG	Negative
TAGACCAGTTCCGCGA	Negative
TAGACTGAGACAAGCC	Hashtag2
TAGACTGCAGGACGAT	Hashtag2
TAGACTGTCACCACAA	Negative
TAGAGTCAGCAGCCCT	Negative
TAGAGTCCAATGCTCA	Negative
TAGAGTCCACCACTGG	Negative
TAGAGTCTCAGCAGAG	Hashtag2
TAGAGTCTCCGTGCGA	Negative
TAGAGTCTCGCTGTTC	Negative
TAGATCGAGACAACAT	Hashtag2
TAGATCGAGTCATCCA	Hashtag2
TAGATCGCACTAGGCC	Negative
TAGATCGGTAAGATTG	Negative
TAGATCGGTCATGGCC	Negative
TAGATCGTCCTTGAAG	Hashtag2
TAGATCGTCGTCAAAC	Hashtag4
TAGCACACAGCGACAA	Negative
TAGCACACATGGATCT	Negative
TAGCACAGTACGGTTT	Hashtag2
TAGCACAGTATCCCAA	Hashtag2
TAGGAGGAGGCCCGTT	Negative
TAGGAGGCAACCGGAA	Negative
TAGGAGGCACGTCGTG	Hashtag2
TAGGGTTGTAGCTCGC	Negative
TAGGGTTTCCATTCGC	Hashtag2
TAGGTACAGAGTTGCG	Negative
TAGGTACCACCCAATA	Hashtag2
TAGGTACGTCCTACAA	Negative
TAGGTACTCGCAACAT	Hashtag2
TAGGTACTCGGCTTCT	Negative
TAGGTTGAGCTCCGAC	Negative
TAGGTTGGTAGTTAGA	Hashtag2
TAGGTTGGTGTATTCG	Negative
TAGGTTGTCGTTCGCT	Negative
TAGGTTGTCTCAACCC	Negative
TAGGTTGTCTGATGGT	Negative
TAGTGCACACGACAAG	Hashtag2
TAGTGCAGTCAACACT	Hashtag2
TAGTGCAGTGACATCT	Hashtag2
TAGTGCAGTGATACCT	Negative
TATACCTGTAGATCGG	Negative
TATACCTGTCTAGGCC	Negative
TATACCTGTGGATACG	Hashtag2
TATATCCAGAATAGTC	Hashtag2
TATATCCAGGTTCCGC	Hashtag2
TATATCCAGTCTAGCT	Negative
TATATCCCATAGAAAC	Negative
TATATCCGTGTCATCA	Negative
TATATCCTCTTGGTCC	Negative
TATCAGGGTGACGCCT	Negative
TATCAGGGTTCGGCTG	Negative
TATCCTAAGTCCTGTA	Negative
TATCCTAGTGGAATGC	Hashtag4
TATCCTATCCTGGGTG	Negative
TATCGCCCAAATCGTC	Hashtag2
TATCGCCTCTGTACAG	Hashtag2
TATCTGTAGAGTCAAT	Hashtag2
TATCTGTCACAAACGG	Negative
TATCTGTCACTGCACG	Negative
TATCTGTGTCATAGTC	Negative
TATCTGTGTGAGCGAT	Hashtag2
TATCTGTTCAAGTGGG	Negative
TATCTGTTCATGCCCT	Hashtag2
TATCTGTTCCGCATAA	Negative
TATCTGTTCTGGCCAG	Negative
TATCTGTTCTGTACAG	Hashtag2
TATGTTCAGGCTGGAT	Negative
TATGTTCCAATTGGTC	Hashtag2
TATGTTCGTACGGCAA	Hashtag2
TATTCCAAGACCTCCG	Negative
TATTCCATCTCCTGAC	Negative
TATTGCTAGTGTACCT	Hashtag2
TATTGCTCAAAGCAAT	Hashtag2
TATTGCTCACTCTCGT	Negative
TATTGCTTCCTTGACC	Negative
TATTGCTTCGTCAGAT	Hashtag2
TATTGGGAGGGCAACT	Hashtag2
TATTGGGAGTGTTCCA	Hashtag2
TATTGGGGTCGTCAGC	Negative
TATTGGGGTTGTTGAC	Hashtag2
TATTTCGAGATGGCGT	Negative
TATTTCGAGTTCCGTA	Negative
TATTTCGTCACGGGAA	Negative
TCAAGACAGATACGAT	Negative
TCAAGACAGCACACCC	Negative
TCAAGACAGGTTACCT	Negative
TCAAGACGTGTCTTCC	Negative
TCAAGACTCGAGAACG	Hashtag4
TCAAGACTCTCGCTCA	Negative
TCAAGACTCTTCCGTG	Negative
TCAAGCAAGGTAAGTT	Negative
TCAAGCAGTTGCCGAC	Negative
TCAAGCATCGCATGAT	Negative
TCAAGTGAGCTAGATA	Negative
TCAAGTGCAAAGGAGA	Negative
TCAAGTGGTAGTAAGT	Negative
TCAATCTAGACAAGCC	Negative
TCAATCTAGAGGTCAC	Hashtag2
TCAATCTAGTCACGCC	Negative
TCAATCTCACAACGTT	Negative
TCAATCTCATCTTAGG	Negative
TCAATCTTCAGAACCT	Negative
TCAATCTTCATTCACT	Negative
TCAATCTTCTTAGCTT	Hashtag2
TCAATTCAGATGCTAA	Negative
TCAATTCCATTGGCAT	Negative
TCAATTCTCGGAGTAG	Negative
TCACAAGCAATGCTCA	Negative
TCACAAGCACCGAATT	Negative
TCACAAGGTCGTCGGT	Negative
TCACACCCAGTATACC	Hashtag2
TCACACCGTCAACATC	Hashtag2_Hashtag4
TCACACCTCCAGTACA	Negative
TCACACCTCGCTTACC	Negative
TCACACCTCGGACAAG	Hashtag4
TCACATTAGTAGAGTT	Hashtag2
TCACATTCAAAGAGTT	Negative
TCACATTCAAATCAGA	Hashtag2
TCACATTCAGACAATA	Hashtag2
TCACATTTCCGAGAAG	Hashtag2
TCACATTTCTGGCCAG	Negative
TCACGCTAGATGAATC	Negative
TCACGCTAGCTATCCA	Hashtag4
TCACGCTAGGCCTTGC	Hashtag2
TCACGCTGTTAAGGAT	Negative
TCACGCTTCGGCTTCT	Negative
TCACTATAGAGAGAAC	Hashtag2
TCACTATAGTCAATCC	Negative
TCACTATCAGCTCTGG	Negative
TCACTATGTCGCGTCA	Negative
TCACTATGTTCCTAAG	Negative
TCACTATTCTGGTGCG	Negative
TCACTCGCAAACGGCA	Negative
TCACTCGCAGCTTTGA	Negative
TCACTCGGTAGACACG	Hashtag2
TCACTCGTCGTCTACC	Hashtag2
TCAGCAAAGAACAGGA	Negative
TCAGCAAAGCTCGCAC	Hashtag2
TCAGCAAAGTCCGCGT	Negative
TCAGCAAGTGCTTCAA	Negative
TCAGCAATCAGAGCAG	Hashtag2
TCAGCAATCCATGAGT	Hashtag2
TCAGCCTAGTAGGTTA	Negative
TCAGCCTGTGACTATC	Negative
TCAGCCTTCACTCGAA	Hashtag2
TCAGCCTTCCAGCTCT	Negative
TCAGCCTTCCGCAAAT	Negative
TCAGGGCAGCTCTATG	Negative
TCAGGGCAGGACAGTC	Negative
TCAGGGCCAATTGAAG	Negative
TCAGGGCCATACAGCT	Hashtag2
TCAGGGCTCTACGCGG	Hashtag4
TCAGTCCAGACCAACG	Negative
TCAGTCCCAGACCTAT	Negative
TCAGTCCGTTAAAGTG	Negative
TCAGTCCGTTCCGCAG	Negative
TCAGTCCGTTCTGACA	Negative
TCAGTGACAACTCCCT	Hashtag2
TCAGTGACAGAACTAA	Negative
TCAGTGAGTATAGCTC	Negative
TCAGTGATCGACGTCG	Negative
TCAGTTTAGACAGCGT	Negative
TCAGTTTAGGCACTCC	Negative
TCAGTTTAGGTGAGAA	Negative
TCAGTTTCAAGTGGAC	Negative
TCAGTTTCATATCTGG	Negative
TCAGTTTGTACCTGTA	Hashtag2
TCAGTTTGTACGTGAG	Negative
TCAGTTTGTCGAATGG	Negative
TCAGTTTGTCGCCACA	Hashtag2
TCATACTCACCTTCGT	Hashtag2
TCATACTCAGCTGTGC	Negative
TCATACTGTCAGTCCG	Negative
TCATACTGTCCTTAAG	Hashtag2
TCATACTTCCTATTGT	Negative
TCATATCAGGCACTAG	Negative
TCATATCAGTGGGAAA	Hashtag2
TCATCATCAATGGCAG	Negative
TCATCATCAGGATCTT	Hashtag4
TCATCATTCGTGCATA	Negative
TCATCATTCTGTCGCT	Negative
TCATCCGAGAATTGTG	Negative
TCATCCGAGGTCACCC	Negative
TCATCCGCAAGCGAAC	Hashtag2
TCATCCGTCAGGAACG	Negative
TCATGAGAGGAACATT	Hashtag2
TCATGAGGTATCCTTT	Hashtag2
TCATGAGTCCAACTGA	Negative
TCATGCCAGAGGCCAT	Negative
TCATGCCTCACGATCA	Negative
TCATGCCTCGCAGTTA	Negative
TCATGGAAGACATACA	Hashtag2
TCATGGAAGCCTCTGG	Negative
TCATGTTAGTGAGCCA	Negative
TCATGTTCATTGAAAG	Negative
TCATGTTGTATCAGCT	Negative
TCATGTTGTCACGACC	Negative
TCATGTTGTGCGAGTA	Negative
TCATTACGTAGCGCTC	Negative
TCATTACGTTCAAGTC	Negative
TCATTACTCAAGGACG	Hashtag2
TCATTCAAGCACCAGA	Hashtag2
TCATTCAAGGGTTGCA	Hashtag2
TCATTCAGTATGGTAA	Negative
TCATTGTAGAGGTTTA	Hashtag2
TCATTTGAGCAACCAG	Hashtag2
TCATTTGGTCGAAACG	Negative
TCATTTGGTTCGGCCA	Negative
TCATTTGTCAAGAGGC	Negative
TCATTTGTCTACTCAT	Negative
TCATTTGTCTATCGTT	Negative
TCCACCAAGCAGGCAT	Negative
TCCACCAAGGCACTAG	Negative
TCCACCAAGTCTAGAA	Negative
TCCACCACATGACAGG	Hashtag2
TCCACCATCAGTCACA	Hashtag2
TCCACGTAGCCTATCA	Negative
TCCACGTAGTAATTGG	Negative
TCCACGTAGTGGCCTC	Negative
TCCACGTCACAGTACT	Hashtag2
TCCACGTCACTTTAGG	Negative
TCCACGTGTACCACGC	Negative
TCCACGTGTCTACAGT	Hashtag2
TCCACGTTCGTGTGAT	Hashtag2
TCCACGTTCTAGGCAT	Negative
TCCACGTTCTCCGTGT	Negative
TCCAGAAGTATACAGA	Negative
TCCAGAAGTCTCAAGT	Negative
TCCAGAATCATACAGC	Hashtag2
TCCATCGCACGCGTGT	Negative
TCCATCGCATAATGCC	Negative
TCCATCGGTAGCGTTT	Negative
TCCATCGGTCAACCTA	Negative
TCCATCGGTGTTAGCT	Negative
TCCATCGTCTACCCAC	Hashtag2
TCCATCGTCTTCTGGC	Negative
TCCATGCAGAACGTGC	Negative
TCCATGCAGTTCCGGC	Hashtag2
TCCATGCGTACCCGAC	Negative
TCCATGCTCCAACACA	Hashtag4
TCCCACAGTTAACAGA	Negative
TCCCACATCGGTAAGG	Negative
TCCCAGTCACAGTCAT	Negative
TCCCAGTGTACCTGTA	Negative
TCCCAGTGTATGTCCA	Hashtag2
TCCCAGTGTCGCTGCA	Negative
TCCCAGTTCACCTGTC	Negative
TCCCAGTTCAGCAATC	Negative
TCCCAGTTCGTGGCGT	Hashtag2
TCCCATGAGCTGGCTC	Negative
TCCCATGAGGTGCATG	Negative
TCCCATGCACACACTA	Hashtag2
TCCCATGCAGCTGTCG	Negative
TCCCATGGTCGAATGG	Negative
TCCCATGGTCGAGCTC	Negative
TCCCATGGTCGATTAC	Negative
TCCCATGTCGGTCACG	Negative
TCCGAAAAGCAAGTGC	Negative
TCCGAAAAGTCCGTCG	Negative
TCCGAAACAGTATGAA	Negative
TCCGAAAGTGCATGAG	Negative
TCCGGGAAGGGCAAGG	Negative
TCCGGGAAGGGCTTCC	Negative
TCCGGGACACGAGGTA	Hashtag2
TCCGGGATCTGCTAGA	Negative
TCCGTGTCACGTCGGT	Negative
TCCGTGTCAGGACAGT	Negative
TCCGTGTTCTTGATTC	Negative
TCCTAATAGTTGAAAC	Negative
TCCTAATCACTATCCC	Negative
TCCTCCCGTGAACTAA	Hashtag2
TCCTCCCGTTATGACC	Negative
TCCTCCCGTTGTGGCC	Negative
TCCTCCCTCCCTTGGT	Hashtag2
TCCTCGAAGAGGACTC	Negative
TCCTCGAAGATGAAGG	Negative
TCCTCGAAGCAAGGAA	Negative
TCCTCGAAGGCGAACT	Negative
TCCTCGACACAAGTTC	Negative
TCCTCGATCCGCGATG	Negative
TCCTCGATCGCTATTT	Hashtag2
TCCTCTTAGAATCCCT	Negative
TCCTCTTCAATTGGTC	Hashtag2
TCCTCTTGTGACCGAA	Negative
TCCTCTTGTGGACCTC	Negative
TCCTCTTTCGTCGATA	Negative
TCCTCTTTCTCGTGGG	Negative
TCCTGCAGTCCGGACT	Hashtag2
TCCTTCTAGAGTCGAC	Negative
TCCTTCTCAGGGCTTC	Negative
TCCTTCTGTGCGAGTA	Negative
TCCTTCTTCCTAAACG	Hashtag2
TCCTTCTTCTGCGGAC	Negative
TCCTTTCCAATGAACA	Negative
TCCTTTCCATTGGGAG	Negative
TCCTTTCGTCGATTAC	Hashtag2
TCCTTTCGTTACCTTT	Negative
TCCTTTCTCACTGGTA	Hashtag2
TCCTTTCTCCGTGTGG	Negative
TCGAACAAGAGTGAAG	Negative
TCGAACAGTACGAAAT	Hashtag2
TCGAACAGTAGCTTGT	Negative
TCGAACAGTATGGTTC	Negative
TCGAACAGTCGTGCCA	Negative
TCGAACATCACAGAGG	Negative
TCGAACATCGTGGACC	Negative
TCGAAGTAGAGCTGCA	Negative
TCGAAGTCACTGTGAT	Hashtag2
TCGAAGTCAGTCTTCC	Hashtag2
TCGAAGTGTTGTTTGG	Negative
TCGACCTCACTTCAAG	Negative
TCGACCTGTACCCGCA	Hashtag2
TCGACGGCACCCAAGC	Negative
TCGACGGCATGAGGGT	Negative
TCGACGGTCAACGCTA	Negative
TCGATTTAGGAGGGTG	Negative
TCGATTTGTATTGGCT	Hashtag2
TCGATTTGTCAGACGA	Negative
TCGATTTTCGGCTGGT	Negative
TCGATTTTCTGGAAGG	Negative
TCGCACTGTTCCACAA	Negative
TCGCAGGAGAACGCGT	Hashtag2
TCGCAGGGTATGAAAC	Negative
TCGCAGGTCAGCTCTC	Negative
TCGCTCAAGACGGAAA	Negative
TCGCTCAAGAGAACCC	Negative
TCGCTCATCATGCCGG	Negative
TCGCTTGAGCGAGTCA	Negative
TCGCTTGCAGGGAATC	Hashtag2
TCGCTTGGTAGAGGAA	Negative
TCGCTTGTCGCGGTAC	Negative
TCGGATAGTTCCATTT	Hashtag2
TCGGGACAGTACCCTA	Negative
TCGGGACCAAGTGGGT	Hashtag2
TCGGGACCAGCGTTGC	Hashtag2
TCGGGACGTAACAAGT	Hashtag2
TCGGGTGGTATCTCTT	Negative
TCGGGTGTCAATGCAC	Negative
TCGGGTGTCGGTAAGG	Negative
TCGGGTGTCTCTCGAC	Negative
TCGGGTGTCTGTCCGT	Negative
TCGGTCTAGCTCGAAG	Hashtag2
TCGGTCTGTGTCTCCT	Negative
TCGGTCTTCAAGTGTC	Negative
TCGGTCTTCCGATCTC	Negative
TCGGTCTTCGAGCACC	Negative
TCGGTCTTCGGACGTC	Negative
TCGGTCTTCTGTAAGC	Negative
TCGTAGACAATAGTGA	Negative
TCGTAGATCCTAAACG	Negative
TCGTCCAAGACCAGCA	Hashtag2
TCGTCCACATCAGCAT	Negative
TCGTCCAGTACCGTGC	Negative
TCGTCCAGTGGGATTG	Negative
TCGTCCAGTTCCACAA	Negative
TCGTCCATCAAGTCGT	Hashtag2
TCGTCCATCTCTCAAT	Negative
TCGTGCTAGCAACCAG	Negative
TCGTGCTGTCGTACTA	Negative
TCGTGGGAGGATACGC	Negative
TCGTGGGCAACCTAAC	Negative
TCGTGGGCAATAGGAT	Negative
TCGTGGGGTCGTGCCA	Negative
TCGTGGGTCCTTGAAG	Negative
TCTAACTAGGTCCTGC	Hashtag2_Hashtag4
TCTAACTCACAACATC	Hashtag2
TCTAACTGTGTAAATG	Negative
TCTAACTGTGTCTAAC	Negative
TCTAACTGTTAGGACG	Negative
TCTAACTTCTTCCTAA	Negative
TCTACATCAAGGGTCA	Negative
TCTACATGTATCACGT	Negative
TCTACATTCCATCGTC	Negative
TCTACATTCCGCGAGT	Negative
TCTACATTCGAGTGAG	Negative
TCTACCGCAGCTTTCC	Negative
TCTACCGTCCTCTGCA	Hashtag2
TCTATACCATGGCCAC	Negative
TCTATACTCGATACTG	Hashtag2
TCTATACTCGCATTGA	Hashtag2
TCTATCAAGCACACAG	Negative
TCTATCACACCGGTCA	Negative
TCTATCAGTGTCCTAA	Negative
TCTATCAGTTGGCCGT	Negative
TCTATCATCCAATCTT	Negative
TCTATCATCTGAGAAA	Hashtag2
TCTCACGTCATCCTGC	Hashtag2
TCTCAGCAGAGCATAT	Hashtag2
TCTCAGCAGCTAGTTC	Hashtag2
TCTCAGCCAAAGGAGA	Negative
TCTCAGCGTCCTTTGC	Negative
TCTCCGACAAGTTCGT	Hashtag2
TCTCCGAGTCTTCAAG	Negative
TCTCCGATCTCTGAGA	Hashtag2
TCTCTGGCAGCGAACA	Negative
TCTCTGGGTAGGTACG	Hashtag2
TCTCTGGGTGTATTGC	Negative
TCTCTGGTCGAGATGG	Negative
TCTGCCAAGGGAGGAC	Hashtag2
TCTGCCACAAGTCCCG	Negative
TCTGCCATCATGCCAA	Hashtag2
TCTGCCATCCCGGTAG	Negative
TCTGGCTCAATCTAGC	Negative
TCTGGCTCACGGTGTC	Negative
TCTGGCTGTGAAGCTG	Negative
TCTGGCTGTTAGAAAC	Negative
TCTGTCGCATCAGTCA	Negative
TCTGTCGTCACCCTCA	Negative
TCTTAGTCAATGAGCG	Negative
TCTTAGTCACCATAAC	Negative
TCTTAGTGTCATCGGC	Negative
TCTTAGTGTCGCGTCA	Hashtag2
TCTTCCTGTGGCGCTT	Negative
TCTTCCTTCCATAGAC	Negative
TCTTCCTTCTAGACAC	Hashtag2
TCTTCCTTCTCTGCTG	Negative
TCTTGCGAGGTCATTC	Hashtag2
TCTTGCGCAGCTGAGA	Negative
TCTTGCGGTAACTAAG	Negative
TCTTGCGGTAGACGTG	Negative
TCTTGCGTCCCACAGG	Negative
TCTTTGACATGAATAG	Negative
TCTTTGATCCTCTCTT	Hashtag2
TGAACGTAGCCTTCTC	Negative
TGAACGTGTACTTCCC	Negative
TGAACGTGTAGCTTGT	Negative
TGAACGTGTCCTCCAT	Negative
TGAACGTGTGGCCCAT	Negative
TGAACGTTCTCTAGGA	Negative
TGAATCGAGAGATGCC	Negative
TGAATCGTCGGAGTGA	Negative
TGAATGCAGAGCAGCT	Hashtag2
TGAATGCCAACTACGT	Negative
TGAATGCCACGGTCTG	Negative
TGACAGTAGCACAAAT	Hashtag2
TGACAGTAGGATGAGA	Hashtag2
TGACAGTTCCCATACC	Negative
TGACCCTAGGGAGGGT	Negative
TGACCCTCAATGAACA	Negative
TGACCCTGTGACACGA	Negative
TGACCCTTCCCGTTGT	Hashtag2
TGACCCTTCTACGCGG	Hashtag2
TGACGCGAGCATGATA	Hashtag2_Hashtag4
TGACGCGCACATCATG	Negative
TGACGCGCAGTGTATC	Negative
TGACGCGGTAGTGTGG	Hashtag2
TGACGCGGTCTGTCAA	Negative
TGACGCGGTTCAGGTT	Hashtag2
TGACTCCTCCTGTTAT	Negative
TGAGACTCACCAACAT	Negative
TGAGCATAGAATCGCG	Hashtag2
TGAGCATGTGACCTGC	Hashtag2
TGAGCGCGTCACGTGC	Negative
TGAGGAGAGGAAAGTG	Hashtag2
TGAGGAGAGGTACCTT	Negative
TGAGGAGCAACACAGG	Negative
TGAGGAGTCATGGAGG	Hashtag2
TGAGGGAAGGACAAGA	Negative
TGAGGGAGTATGCAAA	Hashtag2
TGAGGTTCACTGCTTC	Hashtag2
TGAGGTTCAGCAAGAC	Hashtag4
TGAGGTTTCCGTGGCA	Hashtag2
TGAGGTTTCGATCCAA	Negative
TGAGTCAAGTCCCTAA	Negative
TGAGTCAGTTCAAGGG	Negative
TGAGTCATCATTGGTG	Negative
TGATCAGAGATGAAGG	Hashtag2
TGATCAGAGGCCTTCG	Hashtag2
TGATCAGGTTATGACC	Negative
TGATCAGGTTGGAGGT	Negative
TGATCTTAGCGATGCA	Negative
TGATCTTGTAATGCGG	Hashtag2
TGATGCAAGCATCGAG	Negative
TGATGCAAGGTACAAT	Hashtag2
TGATGCAAGTCTTCGA	Hashtag2
TGATGCACAAATTGCC	Negative
TGATGCACATTAGGCT	Negative
TGATGCAGTATGCTTG	Negative
TGATGCATCTGCTTTA	Negative
TGATGGTGTCAAAGTA	Negative
TGATGGTTCAGCTTGA	Hashtag2
TGATTCTCAATTGCTG	Hashtag2
TGATTCTGTGATACCT	Hashtag2
TGATTTCAGCGCTGCT	Negative
TGATTTCGTAACGCGA	Hashtag2
TGCACGGAGAATAGTC	Hashtag2
TGCACGGAGTGCACTT	Negative
TGCACGGCATTACTCT	Negative
TGCACGGGTCTGCAAT	Negative
TGCACGGGTGCCTTTC	Negative
TGCACGGTCGCTCCTA	Hashtag2
TGCAGATAGAACAGGA	Hashtag2
TGCAGATAGACGAAGA	Negative
TGCAGATAGATTCGAA	Hashtag2
TGCAGATAGTTGGACG	Negative
TGCAGATCAAGAAATC	Negative
TGCAGATCAGCTCATA	Negative
TGCAGATGTTTCACTT	Hashtag2
TGCAGATTCGGCATAT	Hashtag2
TGCAGATTCTTTGATC	Hashtag2
TGCAGGCCACATCATG	Negative
TGCAGGCCACCTGCTT	Negative
TGCAGTACAGGGATAC	Negative
TGCAGTACATGACTAC	Negative
TGCAGTATCACAACCA	Hashtag4
TGCAGTATCAGCGCAC	Negative
TGCATCCAGTTATGGA	Negative
TGCATCCCATCAGCTA	Hashtag2
TGCATCCGTAGCGTCC	Hashtag2
TGCATCCGTATCGTTG	Hashtag2
TGCATCCTCGTCTACC	Negative
TGCATCCTCTGGCCAG	Negative
TGCATGAAGTTTCTTC	Hashtag2
TGCATGACAGCCCACA	Negative
TGCATGACAGCGTAGA	Hashtag2
TGCATGAGTGCCTTCT	Negative
TGCATGATCCCTCTTT	Hashtag2
TGCATGATCGAGCTGC	Hashtag2
TGCATGATCTGAGATC	Hashtag2
TGCCGAGAGTATTCCG	Hashtag2
TGCCGAGTCAGACATC	Hashtag2
TGCGACGGTTACCGTA	Negative
TGCGATAAGACGGAAA	Negative
TGCGATAAGTAGATCA	Hashtag2
TGCGATACAACCCTAA	Negative
TGCGATAGTAATCAGA	Negative
TGCGATAGTCAGGTAG	Negative
TGCGATAGTGTGACCC	Hashtag2
TGCGATATCATGAGAA	Negative
TGCGGCAGTCAGTCCG	Negative
TGCGGCAGTGCCCGTA	Hashtag2
TGCGGCAGTTTGGGAG	Hashtag4
TGCGGCATCATCCTAT	Hashtag2
TGCGGCATCCATAAGC	Hashtag2
TGCGGGTCAGGTCAAG	Negative
TGCGGGTTCTCAGAAC	Negative
TGCTCCAAGCAACTCT	Hashtag2
TGCTCCAAGGTGCCAA	Negative
TGCTCCACAAGAAATC	Negative
TGCTCCACATGGTGGA	Hashtag2
TGCTCCATCGGTCGAC	Negative
TGCTCCATCTCTTAAC	Negative
TGCTCGTAGGCAGGTT	Hashtag4
TGCTCGTAGTAGGATT	Negative
TGCTCGTAGTGGTTCT	Hashtag2
TGCTCGTCACAGTATC	Negative
TGCTCGTGTACTAACC	Negative
TGCTCGTGTACTCGAT	Negative
TGCTCGTTCATAGAGA	Hashtag2
TGCTGAAAGATAGTCA	Hashtag2
TGCTGAAAGTAACCTC	Hashtag2
TGCTGAAGTAGCGAGT	Negative
TGCTGAATCGTACCTC	Negative
TGCTTCGCACCTCGTT	Hashtag2
TGCTTCGCAGCGAACA	Negative
TGCTTCGGTAACATCC	Hashtag2
TGCTTCGTCCATTCGC	Hashtag4
TGCTTCGTCTTCCCAG	Hashtag2
TGCTTGCAGTGCAACG	Negative
TGCTTGCGTCTCAGGC	Hashtag2
TGGAACTAGAGTATAC	Negative
TGGAACTAGGTGCAGT	Negative
TGGAACTAGTAGCTCT	Negative
TGGAACTCAGCAGTTT	Hashtag2
TGGAACTGTTGTGCAT	Negative
TGGAGAGAGTTCCGGC	Negative
TGGAGAGAGTTGGAAT	Negative
TGGAGAGGTGAAGCTG	Hashtag2
TGGAGGAAGCGACTTT	Negative
TGGAGGACAGACGCTC	Hashtag2
TGGAGGAGTCCCTGAG	Negative
TGGAGGAGTGAGATAT	Negative
TGGAGGATCGGATACT	Negative
TGGATCATCCAATGCA	Hashtag2
TGGATGTCAAATCCCA	Negative
TGGATGTCAAATCGTC	Negative
TGGATGTCATCGATCA	Negative
TGGATGTGTTGCATAC	Hashtag2
TGGATGTTCGCATAGT	Hashtag2
TGGCGTGAGATTAGCA	Negative
TGGCGTGCAAGGAGTC	Hashtag2
TGGCGTGCAGACCCGT	Negative
TGGCGTGCAGCTTTCC	Negative
TGGCGTGCAGGTCCGT	Negative
TGGCGTGTCTTTGCGC	Negative
TGGGAAGCACTTACAG	Hashtag2
TGGGAAGTCACTGAAC	Negative
TGGGAAGTCATGTCTT	Hashtag2
TGGGAGACAACCTAAC	Negative
TGGGAGACAATCACGT	Hashtag2
TGGGATTAGGGATGTC	Negative
TGGGATTGTGTCCTAA	Negative
TGGGATTTCCAGGACC	Hashtag2
TGGGATTTCTGGGTCG	Hashtag2
TGGGCGTAGTAACAGT	Hashtag2
TGGGCGTTCTTCTAAC	Negative
TGGGCTGCACGCGTCA	Negative
TGGGCTGCAGATCACT	Negative
TGGGCTGGTGTGCTTA	Negative
TGGGCTGTCCTTCTTC	Negative
TGGGTTAAGTCAGCGA	Negative
TGGGTTAGTTATCTGG	Negative
TGGGTTATCCCATTCG	Negative
TGGTACAAGGTGCGAT	Hashtag2
TGGTACACAGCTCATA	Hashtag2
TGGTACAGTAGCTGAG	Hashtag2
TGGTACATCCAAGCTA	Hashtag2
TGGTACATCTACCTTA	Negative
TGGTACATCTCCCTAG	Negative
TGGTAGTAGAAACTCA	Hashtag2
TGGTAGTCACCGTCGA	Negative
TGGTAGTCAGAGTCTT	Negative
TGGTAGTGTCCGGTGT	Negative
TGGTAGTTCAGTGGGA	Negative
TGGTGATCAAGTTGGG	Hashtag2
TGGTGATCACGGTGAA	Negative
TGGTGATGTCCCACGA	Hashtag2
TGGTGATTCTACACTT	Negative
TGGTTAGAGCATACTC	Negative
TGGTTAGCACGGTGCT	Negative
TGGTTAGGTACCGTGC	Negative
TGGTTAGGTGCGACAA	Negative
TGGTTAGGTTAGGCTT	Negative
TGGTTAGTCACAGAGG	Negative
TGTAACGAGCACCGTC	Negative
TGTAACGAGTCACAGG	Hashtag2
TGTAACGAGTTGCCTA	Hashtag2
TGTAACGGTCAGCGTC	Negative
TGTAAGCAGATGCCGA	Hashtag4
TGTAAGCCATGCGTGC	Negative
TGTACAGCAAGTGGTG	Hashtag2
TGTAGACCACCGGAAA	Negative
TGTAGACCAGTGTATC	Negative
TGTAGACCATGCGTGC	Negative
TGTAGACTCAAACTGC	Hashtag2
TGTAGACTCATCACTT	Hashtag2
TGTAGACTCATCGCCT	Hashtag2
TGTCAGAAGCACCGAA	Hashtag2
TGTCAGAAGGATAATC	Hashtag2
TGTCAGAAGGATATGT	Hashtag2
TGTCAGACATATGGCT	Negative
TGTCAGAGTGATACAA	Negative
TGTCAGATCGTCTACC	Negative
TGTCAGATCTAGACCA	Hashtag2
TGTCCACAGCATCTTG	Negative
TGTCCACTCGAGTACT	Negative
TGTCCACTCTCTATGT	Negative
TGTCCCAAGGATACGC	Hashtag2
TGTCCCACACAAGCTT	Negative
TGTCCCAGTAGCCCTG	Negative
TGTCCCATCTGGGCAC	Negative
TGTCCTGAGAGCCATG	Negative
TGTCCTGAGCAACAAT	Negative
TGTCCTGAGCAAGCCA	Hashtag2
TGTCCTGCACGCACCA	Negative
TGTCCTGCAGCAGAAC	Hashtag2
TGTCCTGGTTACAGCT	Hashtag2
TGTCCTGTCACGGGAA	Negative
TGTCCTGTCGGCATCG	Negative
TGTCCTGTCGGCTGTG	Negative
TGTGAGTCACATAACC	Negative
TGTGAGTCAGAGGCAT	Negative
TGTGAGTCATACGCAT	Negative
TGTGAGTGTATTTCCT	Hashtag2
TGTGAGTTCCATAAGC	Hashtag2
TGTGAGTTCTTGCAAG	Negative
TGTGATGCACAGAGAC	Negative
TGTGATGGTGTAGCAG	Negative
TGTGATGTCCGCCTAT	Negative
TGTGCGGAGTCTGCAT	Negative
TGTGCGGCAACTTGGT	Negative
TGTGGCGGTATGTCAC	Negative
TGTGGCGGTGCATGAG	Negative
TGTGGCGTCATCCTAT	Negative
TGTGGCGTCATGCCAA	Negative
TGTGGCGTCTCTCTAA	Hashtag2
TGTGGCGTCTTTGCTA	Negative
TGTGTGAAGTTACGGG	Negative
TGTGTGACAGACCTAT	Hashtag2
TGTGTGACAGTTTCAG	Negative
TGTGTGATCGACGTCG	Negative
TGTTACTCAACAAAGT	Negative
TGTTACTCAACCGACC	Hashtag2
TGTTACTGTCCGGCAT	Negative
TGTTCATAGCTCTATG	Hashtag2
TGTTCATAGTCAGAGC	Negative
TGTTCATAGTGAGGCT	Negative
TGTTCATCATCGTTCC	Hashtag2
TGTTCATGTCGGCCTA	Negative
TGTTCATGTTTACCTT	Negative
TGTTCATTCACGGTCG	Negative
TGTTCCGAGGTATCTC	Hashtag2
TGTTCCGGTCGACGCT	Hashtag2
TGTTCCGTCACCCTCA	Negative
TGTTCCGTCGAACGCC	Negative
TGTTCCGTCTCGACCT	Negative
TGTTCTAAGCGACAGT	Negative
TGTTCTAAGTAAACTG	Negative
TGTTCTACACTCCGGA	Negative
TGTTCTACATAGCTGT	Hashtag2
TGTTCTAGTGAGGCTA	Negative
TGTTGAGCACTCCACT	Negative
TGTTGAGTCCTTGACC	Hashtag2
TGTTGGACAGCGCTTG	Hashtag2
TGTTGGATCCAATGCA	Negative
TGTTGGATCTACCCAC	Negative
TGTTGGATCTTCGTAT	Negative
TGTTTGTAGATTAGTG	Negative
TGTTTGTAGCAACTCT	Negative
TGTTTGTCACACGGTC	Negative
TGTTTGTGTCTAGTGT	Negative
TGTTTGTTCCCGAGGT	Hashtag2
TGTTTGTTCTAGAGCT	Negative
TTAATCCAGACCAGCA	Hashtag2
TTAATCCCAAGGGCAT	Negative
TTAATCCGTATGCTAC	Hashtag2
TTAATCCTCCATCGTC	Negative
TTAATCCTCTTGGTCC	Negative
TTACAGGAGTAAACGT	Hashtag2
TTACAGGCAAATGGCG	Negative
TTACAGGGTACATTGC	Negative
TTACAGGGTGTTCGAT	Negative
TTACCATAGAAACTCA	Negative
TTACCATAGAAGGCTC	Negative
TTACCATCAAACTAAG	Negative
TTACCATGTAGCGTAG	Hashtag2
TTACCATTCCGGGACT	Negative
TTACCGCCACAATGTC	Hashtag2
TTACCGCCAGTCTCTC	Hashtag2
TTACCGCCATGAAGGC	Negative
TTACCGCTCCGTTTCG	Negative
TTACGCCAGCCTCTCT	Negative
TTACGCCAGCGTCTGC	Hashtag2
TTACGCCAGGACGCAT	Negative
TTACGCCCAGTAGTGG	Negative
TTACGTTAGCGACAGT	Negative
TTACGTTAGCTCAGAG	Negative
TTACGTTAGTAGAATC	Negative
TTACGTTCAGGGACTA	Negative
TTACGTTCATAGAGGC	Hashtag2
TTACGTTCATCCTTGC	Hashtag2
TTACGTTTCCTTATAC	Hashtag2
TTACGTTTCGACATCA	Negative
TTACGTTTCTGTCCCA	Negative
TTACTGTAGACTACCT	Hashtag2
TTACTGTGTCGGTACC	Negative
TTAGGCAAGAGCTGAC	Negative
TTAGGCACACTCATAG	Negative
TTAGGCAGTAGCGTTT	Negative
TTAGGCAGTTGGAGAC	Negative
TTAGGGTAGAATAGTC	Negative
TTAGGGTTCTTCGATT	Negative
TTAGTCTAGCGGATCA	Hashtag2
TTATTGCAGCCACCGT	Negative
TTATTGCGTATCCTCC	Negative
TTATTGCGTGTTCGAT	Negative
TTATTGCTCCTATTGT	Hashtag2
TTATTGCTCTCTCTAA	Negative
TTATTGCTCTGAGGTT	Hashtag2
TTCAATCAGACCAGAC	Hashtag2
TTCAATCAGACTCATC	Hashtag2
TTCAATCAGTCTGTAC	Negative
TTCAATCGTGTCCACG	Hashtag2
TTCAATCTCCCTGTTG	Negative
TTCAATCTCCGAGCTG	Negative
TTCACGCAGATTGTGA	Hashtag2
TTCACGCAGGTTAAAC	Hashtag2
TTCACGCGTCTGTGTA	Negative
TTCACGCGTGATAGTA	Negative
TTCACGCTCCTCACCA	Hashtag2
TTCACGCTCTGGTGCG	Negative
TTCAGGAAGGAACTCG	Negative
TTCAGGACACGGTCTG	Hashtag4
TTCAGGAGTGAGCCAA	Hashtag2
TTCAGGAGTGTCCATA	Hashtag2
TTCATGTAGGTCGAGT	Negative
TTCATGTAGTTGCATC	Negative
TTCATGTCACTCGATA	Hashtag2
TTCATGTCAGCTTTGA	Hashtag2
TTCATGTGTAAGTTAG	Hashtag2
TTCATGTGTCTCAGAT	Hashtag2
TTCATGTGTGGCCTCA	Negative
TTCATGTGTGTTGATC	Negative
TTCATGTTCGTGGCTG	Hashtag2
TTCATTGCAAGCGCAA	Negative
TTCATTGCACCTGCGA	Hashtag2
TTCATTGGTACCCGCA	Negative
TTCATTGTCAGCGGAA	Hashtag2
TTCCAATAGGTAAACT	Hashtag2
TTCCAATCAGCTGAAG	Negative
TTCCAATCATTAAGCC	Hashtag2
TTCCAATGTACTGCGC	Negative
TTCCAATTCATCTATC	Hashtag2
TTCCAATTCGCTTACC	Negative
TTCCAATTCTCCAAGA	Hashtag2
TTCCAATTCTTCCCAG	Negative
TTCCACGAGTGCCTCG	Negative
TTCCACGCATACCACA	Negative
TTCCACGGTAATCAGA	Hashtag2
TTCCACGTCATGAAAG	Negative
TTCCACGTCTTGGATG	Negative
TTCCGGTAGAGCAACC	Negative
TTCCGGTAGGAACGTC	Hashtag2
TTCCGGTGTGCGGATA	Negative
TTCCGGTTCTCGTTTA	Negative
TTCCGTGAGTTGCCTA	Negative
TTCCGTGCACTAGGTT	Negative
TTCCGTGGTAATCAAG	Negative
TTCCGTGGTTGCATTG	Hashtag2
TTCCTAAAGCTGGCTC	Negative
TTCCTAAGTCAGTCCG	Hashtag2
TTCCTAAGTGTGATGG	Negative
TTCCTCTAGTTGGACG	Hashtag2
TTCCTCTCATTCTCTA	Negative
TTCCTCTGTCGTTATG	Negative
TTCCTTCAGCCGAACA	Negative
TTCCTTCAGGTGTGAC	Negative
TTCCTTCGTTACCTTT	Negative
TTCGATTAGGTCTACT	Negative
TTCGATTAGTAGTCAA	Hashtag2
TTCGATTGTGTGCCTG	Hashtag2
TTCGATTTCTTGAGCA	Negative
TTCGCTGAGTGCAGGT	Hashtag2
TTCGCTGCAATTGCAC	Negative
TTCGCTGGTAGAATGT	Negative
TTCGCTGTCACCTCAC	Hashtag2
TTCGGTCAGGCGAAGG	Negative
TTCGGTCCAAGTGCAG	Hashtag2
TTCGGTCCATGCCGGT	Hashtag2
TTCGGTCGTACAGTTC	Hashtag4
TTCGGTCGTCCGAAAG	Negative
TTCGGTCGTTAACAGA	Hashtag2
TTCGGTCGTTAAGACA	Negative
TTCGGTCTCCCGTGAG	Negative
TTCTAACCACGGGTAA	Negative
TTCTAACTCAGACTGT	Negative
TTCTAACTCGGCCAAC	Hashtag2
TTCTAGTAGGCTCACC	Negative
TTCTAGTCAACAGCTT	Negative
TTCTAGTCAAGCGAAC	Negative
TTCTCTCAGAACAAGG	Negative
TTCTCTCCATTGAGGG	Negative
TTCTCTCGTCTAACGT	Negative
TTCTGTAAGCCTCAAT	Hashtag2
TTCTGTACACCATAAC	Hashtag2
TTCTGTAGTCAGGAGT	Negative
TTCTGTAGTGGATGAC	Negative
TTCTGTATCGCCGTGA	Hashtag2
TTCTTCCCAGCAGTCC	Hashtag2
TTCTTCCGTACGCGTC	Hashtag2
TTCTTCCTCGACTCCT	Hashtag2
TTCTTGAAGCATGGGT	Negative
TTCTTGATCCCTAGGG	Negative
TTGAACGAGCCTCTTC	Negative
TTGAACGAGGATGCGT	Negative
TTGAACGCACAGTCGC	Negative
TTGAACGGTAACACCT	Hashtag2
TTGAACGGTAGTGATA	Negative
TTGAACGTCACCACAA	Negative
TTGAACGTCAGCATTG	Hashtag2
TTGACCCAGCCTCCAG	Negative
TTGACCCAGCTAGAAT	Negative
TTGACCCAGTGCAGCA	Negative
TTGACCCGTGCTGCAC	Negative
TTGACCCTCGATCCAA	Negative
TTGACCCTCTCCGAGG	Negative
TTGAGTGAGATGTTAG	Negative
TTGAGTGAGGCAGGGA	Negative
TTGAGTGCAAATTGGA	Negative
TTGAGTGGTGAATGAT	Negative
TTGAGTGTCCTACACC	Hashtag2
TTGATGGCAGAGCGTA	Negative
TTGATGGGTATTCTCT	Negative
TTGCATTAGCCAGTAG	Negative
TTGCATTCAGGCGATA	Negative
TTGCATTGTCGAATGG	Hashtag2
TTGCATTGTGTATTGC	Negative
TTGCCTGAGGTACTGG	Hashtag4
TTGCCTGGTAGTGGCA	Hashtag2
TTGCCTGGTCGTGATT	Negative
TTGCCTGTCGTCGACG	Negative
TTGCCTGTCTTGGTGA	Hashtag2
TTGCGTCCACACGTGC	Negative
TTGCGTCCACCGGAAA	Negative
TTGCGTCCACTGGATT	Negative
TTGCTGCAGACTCTTG	Negative
TTGCTGCAGTTGGGAC	Negative
TTGCTGCCAACTCCCT	Negative
TTGCTGCGTTCGAAGG	Hashtag2
TTGCTGCTCGGAGCAA	Hashtag2
TTGGATGGTACGATCT	Negative
TTGGATGGTCCTGTCT	Negative
TTGGGATAGCCTGACC	Hashtag2
TTGGGCGAGCGTGAAC	Negative
TTGGGCGCATTAGGAA	Hashtag2
TTGGGCGGTCCAGCCA	Negative
TTGGGCGTCCATCTCG	Negative
TTGGGCGTCGTTACCC	Negative
TTGGGCGTCTGAGAAA	Negative
TTGGGTAAGTAGTCTC	Negative
TTGGGTACATGACGAG	Negative
TTGGGTATCACCACAA	Negative
TTGGTTTAGGCCCGTT	Negative
TTGGTTTGTGGAAGTC	Negative
TTGTGGAAGACAGCTG	Negative
TTGTGGACATACTGAC	Negative
TTGTGGAGTCCTGGTG	Hashtag2
TTGTGGAGTGTCATGT	Negative
TTGTGGAGTTGCATCA	Negative
TTGTGGAGTTGTATGC	Negative
TTGTGTTCACCAGCGT	Negative
TTGTGTTGTCATATGC	Negative
TTGTGTTGTGCGAACA	Negative
TTGTGTTTCACTTCTA	Negative
TTGTTCAAGAAGCGGG	Negative
TTGTTGTCAACGTATC	Negative
TTGTTTGCATGGCACC	Negative
TTGTTTGGTACCTAAC	Negative
TTGTTTGGTCATTCCC	Negative
TTGTTTGTCCCTTCCC	Hashtag2
TTGTTTGTCGACGTCG	Hashtag2
TTTACCACAGACCCGT	Negative
TTTACCACATGGAAGC	Negative
TTTACCAGTACGATCT	Negative
TTTACCATCCCTAGGG	Negative
TTTACGTAGCGCTTCG	Negative
TTTACGTCAGTAACGG	Hashtag2
TTTACGTGTAGACTGG	Negative
TTTACGTGTCACTCGG	Negative
TTTACGTGTCCACTCT	Negative
TTTACGTGTGTCATGT	Negative
TTTACGTTCGAAGTGG	Negative
TTTACGTTCTTGGATG	Negative
TTTACTGCACCAAAGG	Negative
TTTACTGGTTCGGCCA	Negative
TTTAGTCCATCCGATA	Negative
TTTAGTCGTACCCAGC	Hashtag2
TTTAGTCTCTAGAGCT	Negative
TTTAGTCTCTCCATAT	Negative
TTTATGCAGCCGATTT	Negative
TTTATGCCAGCCGTTG	Negative
TTTATGCGTCACGTGC	Negative
TTTCACAAGTTGCATC	Hashtag2
TTTCACACACGAGAAC	Negative
TTTCACAGTGCTTATG	Hashtag2
TTTCAGTCAGGTGACA	Negative
TTTCAGTCATCCGAAT	Hashtag2
TTTCAGTGTTGTGCAT	Negative
TTTCATGAGCAGGGAG	Hashtag4
TTTCATGCAATAGTCC	Negative
TTTCATGGTTGGGAAC	Hashtag2
TTTCATGTCCTAGCTC	Negative
TTTCCTCAGTTACGGG	Hashtag4
TTTCCTCCACTTCATT	Hashtag2
TTTCCTCGTCATATGC	Hashtag2
TTTCCTCGTGCAACGA	Negative
TTTCCTCGTTAGGGTG	Hashtag2
TTTCCTCGTTGAGTCT	Negative
TTTCCTCTCAGCTGAT	Negative
TTTCCTCTCATTACCT	Negative
TTTCCTCTCCTAGCGG	Negative
TTTCGATAGAGACAAG	Hashtag2
TTTCGATCAAAGGCGT	Negative
TTTCGATCAACCACGC	Negative
TTTCGATTCAGGCGAA	Hashtag2
TTTCGATTCGACACCG	Hashtag2
TTTCGATTCGGTAGGA	Hashtag2
TTTGACTAGCCGGAAT	Negative
TTTGACTGTGTCCACG	Hashtag2
TTTGACTGTTTGGGTT	Hashtag2
TTTGACTTCTAGCCAA	Hashtag2
TTTGATCGTGTCGATT	Negative
TTTGGAGAGATCCAAA	Negative
TTTGGAGAGGTCATCT	Hashtag2
TTTGGAGCAACAGAGC	Hashtag2
TTTGGAGGTGCCTGCA	Hashtag2
TTTGGAGTCTACGGTA	Hashtag2
TTTGGTTGTTCAAAGA	Hashtag4
TTTGTTGCACGCGCAT	Negative
TTTGTTGCACTACCCT	Negative
TTTGTTGCAGTTTCAG	Negative
