cells	sample
AAACCCAAGGTAACTA	Hashtag3
AAACCCACACGTTGGC	Negative
AAACCCACAGGTAGTG	Hashtag3
AAACCCAGTCTTACTT	Hashtag3
AAACCCATCAGGACAG	Negative
AAACGAACATAGATGA	Negative
AAACGAACATATAGCC	Negative
AAACGCTAGAACCCGA	Negative
AAACGCTAGTACTGTC	Negative
AAACGCTTCGGTGCAC	Negative
AAAGAACCACACCGAC	Hashtag3
AAAGAACGTCGGATTT	Negative
AAAGAACGTGGTCCGT	Negative
AAAGAACTCATCAGTG	Negative
AAAGAACTCGTTAGTG	Hashtag3
AAAGGATAGGTTATAG	Negative
AAAGGATGTAACCCTA	Negative
AAAGGATTCGGCACTG	Hashtag1
AAAGGGCAGACTGAGC	Negative
AAAGGGCCACATAACC	Hashtag1
AAAGGGCCACTGGATT	Negative
AAAGGGCGTAACAGTA	Hashtag1
AAAGGGCGTCTAACGT	Hashtag3
AAAGGGCGTGCCTTTC	Hashtag3
AAAGGGCTCCAACCGG	Negative
AAAGGGCTCTGTCGTC	Negative
AAAGGTACACGATAGG	Negative
AAAGGTATCTTCCCGA	Hashtag3
AAAGTCCAGATGCCGA	Negative
AAAGTCCAGTGAGTGC	Hashtag3
AAAGTCCCACCCATAA	Hashtag1
AAAGTCCGTAAGCAAT	Negative
AAAGTCCTCCCAGTGG	Negative
AAAGTCCTCGCATGAT	Negative
AAAGTGAAGTTTGGCT	Negative
AAAGTGAGTGATCATC	Hashtag3
AAAGTGATCAGGAAAT	Negative
AAATGGATCGGCCCAA	Hashtag3
AACAAAGCACACTGGC	Negative
AACAAAGCAGAAATCA	Negative
AACAAAGCAGATCCAT	Hashtag1
AACAAAGGTAGGCAAC	Hashtag3
AACAACCAGACCAAGC	Negative
AACAACCAGCTGAAGC	Hashtag3
AACAACCAGCTTACGT	Hashtag1
AACAACCGTACCCAGC	Negative
AACAACCGTCTGCAAT	Negative
AACAACCTCTGCTTAT	Negative
AACAAGAAGGTAGACC	Hashtag3
AACAAGACATCTATCT	Negative
AACAAGATCACTCTTA	Hashtag3
AACACACAGCCGCACT	Negative
AACACACAGTCAGAGC	Negative
AACACACCACGTCGGT	Negative
AACACACGTATCGATC	Hashtag3
AACACACGTGTATTGC	Negative
AACAGGGAGACAGCGT	Negative
AACAGGGCAACAGATA	Negative
AACAGGGCACCCAAGC	Hashtag3
AACAGGGGTTGGGTTT	Negative
AACCAACCAACAGATA	Hashtag1
AACCAACGTGGTTCTA	Hashtag1
AACCACAAGAGGGTCT	Negative
AACCACACAGAATTCC	Hashtag3
AACCACATCCATTCAT	Hashtag1
AACCATGAGCTGAGCA	Negative
AACCATGCAGTAGTTC	Negative
AACCATGCATCATGAC	Negative
AACCATGGTTTGATCG	Negative
AACCATGTCAGGGTAG	Negative
AACCCAAAGACAACAT	Negative
AACCCAACAAGGTTGG	Negative
AACCCAAGTTCTCCCA	Negative
AACCCAATCCTACAAG	Hashtag3
AACCTGACACGGTGAA	Negative
AACCTGACAGTCAACT	Hashtag1
AACCTGAGTCTGTAGT	Hashtag1
AACCTGATCAGCGCGT	Negative
AACCTTTAGACTACGG	Negative
AACCTTTGTAGTTACC	Negative
AACCTTTTCATCCCGT	Negative
AACCTTTTCTATCACT	Negative
AACGAAAAGTAGACAT	Hashtag1
AACGAAACAGAGGTAC	Negative
AACGAAAGTGCACATT	Negative
AACGGGAAGCACGTCC	Hashtag1
AACGGGAAGCACTCCG	Hashtag3
AACGGGACAATCCTTT	Negative
AACGGGACAGCCCACA	Negative
AACGGGACAGGGTTGA	Hashtag1
AACGGGAGTTGTTGCA	Hashtag1
AACGTCACAAAGAGTT	Hashtag3
AACGTCACACAAGGTG	Hashtag3
AACGTCACACACCGCA	Negative
AACGTCACAGTAACAA	Hashtag3
AACGTCACATGTGCCG	Negative
AACGTCAGTAGGAGGG	Hashtag3
AACGTCAGTGCACAAG	Negative
AACGTCAGTTCCACAA	Negative
AACTTCTAGAATTCAG	Negative
AACTTCTCAGTGTACT	Negative
AACTTCTGTACGCTTA	Negative
AACTTCTGTCCTTTGC	Negative
AACTTCTTCACATCAG	Negative
AAGAACAAGCATGTTC	Negative
AAGAACAGTTTCAGAC	Negative
AAGACAAAGAACTTCC	Negative
AAGACAAAGACATCAA	Negative
AAGACAAAGCGAGAAA	Hashtag1
AAGACAAAGCTAATCC	Hashtag3
AAGACAAAGTTCCGTA	Hashtag3
AAGACAACAGAAGCTG	Negative
AAGACAACAGCAGTCC	Negative
AAGACAACAGCTGCCA	Negative
AAGACAAGTATTTCCT	Hashtag1
AAGACAATCGGACTTA	Negative
AAGACTCAGTATGTAG	Negative
AAGACTCCACCAAAGG	Hashtag1
AAGACTCGTGCAACAG	Negative
AAGATAGAGGCCTAAG	Negative
AAGATAGTCCTCGCAT	Hashtag3
AAGCATCAGTTATGGA	Negative
AAGCATCCACGTTCGG	Hashtag3
AAGCATCCATCCTATT	Negative
AAGCATCGTAGGTTTC	Hashtag1
AAGCATCTCAAACTGC	Hashtag1
AAGCATCTCCGTAATG	Negative
AAGCATCTCCTCTTTC	Negative
AAGCATCTCTTCTAAC	Negative
AAGCCATCAAGCTACT	Negative
AAGCCATCAATGCAAA	Negative
AAGCCATCATTGCTTT	Negative
AAGCCATGTATGGTTC	Negative
AAGCCATTCTGGACTA	Negative
AAGCGAGAGATTCGAA	Hashtag3
AAGCGAGAGCGGGTTA	Negative
AAGCGAGTCACCATAG	Negative
AAGCGAGTCCTATGGA	Negative
AAGCGAGTCTTAGCTT	Hashtag1
AAGCGTTAGGTTCATC	Hashtag1
AAGCGTTTCATGAGGG	Hashtag1_Hashtag3
AAGCGTTTCATGCGGC	Hashtag3
AAGGAATAGCTAAATG	Hashtag3
AAGGAATCACTACCCT	Negative
AAGGAATCAGTAACAA	Negative
AAGGAATGTCTTTCAT	Hashtag3
AAGGAATTCCCGGTAG	Negative
AAGGAATTCCGGCAAC	Negative
AAGGAATTCTAACGGT	Negative
AAGGTAACAATGAACA	Negative
AAGGTAACACTAACGT	Hashtag1
AAGGTAATCCTTGACC	Hashtag1
AAGTACCCACAAATAG	Negative
AAGTACCTCAGCGCGT	Hashtag1
AAGTCGTAGGACAGCT	Hashtag1
AAGTGAAAGAGTTGCG	Negative
AAGTGAAAGATCCCGC	Negative
AAGTGAAAGGCACTAG	Negative
AAGTGAACACTACGGC	Negative
AAGTGAAGTAACAAGT	Negative
AAGTGAAGTGTTAAAG	Negative
AAGTGAAGTTGCGTAT	Hashtag1
AAGTTCGCACTTGACA	Negative
AAGTTCGCATCCGATA	Negative
AATAGAGAGCGTATAA	Negative
AATAGAGCAACCGATT	Negative
AATAGAGCACTGTCGG	Negative
AATAGAGCATGGATCT	Negative
AATCACGAGTGGTTCT	Negative
AATCACGGTAACAGGC	Negative
AATCACGGTCCTGTCT	Negative
AATCACGTCGCTTAAG	Hashtag1
AATCGACCAACAAGTA	Hashtag1
AATCGACCAGGTGACA	Negative
AATCGACGTCGAGCTC	Hashtag3
AATCGACGTGCAAGAC	Negative
AATCGTGAGGTGCTAG	Negative
AATCGTGCAACTTGGT	Negative
AATCGTGCAGGTTCGC	Negative
AATCGTGTCCTAGCGG	Hashtag3
AATGAAGAGCTCGGCT	Negative
AATGAAGCAGCAGAAC	Negative
AATGAAGGTCCGTACG	Hashtag3
AATGAAGGTGTTCGTA	Negative
AATGAAGGTTAGAGAT	Negative
AATGAAGTCCGTTGAA	Hashtag3
AATGACCCAATGGCAG	Negative
AATGACCCATGCGTGC	Negative
AATGACCGTATAATGG	Negative
AATGACCGTATCGAAA	Hashtag3
AATGACCGTTCATCGA	Negative
AATGACCTCGCACGAC	Hashtag3
AATGCCAAGACGGAAA	Negative
AATGCCAAGGCCTAAG	Negative
AATGCCACATATCTCT	Negative
AATGCCAGTGCCCTTT	Negative
AATGCCATCAAGGAGC	Negative
AATGGAAAGACGTCCC	Hashtag1
AATGGAACACTCATAG	Hashtag1_Hashtag3
AATGGAATCAACGAGG	Negative
AATGGAATCCAAGCCG	Negative
AATGGCTAGCCTCTGG	Hashtag3
AATGGCTCATAGGTTC	Hashtag1
AATGGCTTCTTACTGT	Negative
AATTCCTAGCCGTTGC	Negative
AATTCCTAGGACTATA	Hashtag1
AATTCCTCAAGAATGT	Negative
AATTCCTCATAACCCA	Hashtag3
AATTCCTGTGGTTTGT	Negative
AATTCCTTCCACAAGT	Negative
AATTTCCAGAACTGAT	Hashtag1_Hashtag3
AATTTCCAGCACCGTC	Negative
AATTTCCAGCTGCCAC	Hashtag1_Hashtag3
AATTTCCCAAGAGTAT	Negative
AATTTCCCATGTACGT	Negative
AATTTCCTCAAGGCTT	Negative
ACAAAGAAGAATTTGG	Negative
ACAAAGAAGGCGAACT	Negative
ACAAAGACACCTAAAC	Negative
ACAAAGACATCCGGTG	Hashtag1_Hashtag3
ACAAAGATCCCGAACG	Hashtag3
ACAAAGATCGTGTCAA	Hashtag3
ACAACCAAGCCTCACG	Hashtag3
ACAACCATCGCGTGCA	Negative
ACAAGCTAGATGTTAG	Hashtag1
ACAAGCTGTCGGTACC	Negative
ACAAGCTGTGCCCTTT	Negative
ACAAGCTTCAAACGAA	Negative
ACAAGCTTCCAGCCTT	Negative
ACACAGTAGCACCAGA	Hashtag1
ACACAGTGTGTGATGG	Hashtag1
ACACAGTTCCTAAGTG	Negative
ACACCAAAGCAGCGAT	Negative
ACACCAAAGCGACATG	Hashtag1
ACACCAAAGGCGTCCT	Negative
ACACCAACAGTCTGGC	Negative
ACACCAAGTTGTTGCA	Negative
ACACGCGCAGCGGTCT	Negative
ACACTGAAGCATAGGC	Hashtag3
ACACTGAAGGTGGTTG	Negative
ACACTGAGTGCAACAG	Negative
ACACTGATCCACCTGT	Hashtag3
ACAGAAAAGTCCCTAA	Hashtag1
ACAGAAATCGCTATTT	Negative
ACAGAAATCTTCGACC	Negative
ACAGCCGAGGGTCAAC	Hashtag1
ACAGCCGGTATAATGG	Negative
ACAGCCGGTGAGACGT	Hashtag3
ACAGGGAAGTAAGAGG	Hashtag1
ACAGGGACAAGAGTGC	Negative
ACAGGGAGTAACACCT	Negative
ACAGGGAGTAGACGGT	Hashtag1
ACAGGGATCGATACAC	Hashtag1
ACATCCCCAACGCCCA	Hashtag3
ACATCCCTCGGTAAGG	Hashtag1
ACATCGAAGAACTGAT	Negative
ACATCGAAGCACACAG	Hashtag3
ACATCGAGTCCCTAAA	Hashtag3
ACATCGAGTGCCTACG	Hashtag1
ACATCGAGTGCTGTCG	Hashtag3
ACATCGAGTGGCACTC	Negative
ACATCGATCGTTAGAC	Hashtag3
ACATGCAAGAAAGTCT	Negative
ACATGCACATAACTCG	Negative
ACATGCATCAAATAGG	Negative
ACATGCATCTACCTTA	Hashtag3
ACATGCATCTCATTAC	Hashtag1
ACATTTCAGCATGAAT	Negative
ACATTTCAGTACAGCG	Hashtag3
ACATTTCGTTATTCCT	Negative
ACATTTCTCCACACCT	Negative
ACATTTCTCTCGGGAC	Negative
ACCAAACAGCAGAAAG	Negative
ACCAAACCAACCGGAA	Negative
ACCAAACCACTGCGTG	Hashtag1
ACCAAACTCCGAAATC	Negative
ACCAACAAGTGGCGAT	Negative
ACCAACACAACACAAA	Hashtag3
ACCAACACAAGGAGTC	Negative
ACCAACATCTAGTACG	Negative
ACCAACATCTATGCCC	Negative
ACCACAAAGAGAGTGA	Hashtag3
ACCACAACACACGGTC	Negative
ACCACAACAGAATCGG	Negative
ACCACAACAGAGTCAG	Hashtag3
ACCACAAGTAATCAGA	Hashtag1
ACCACAAGTACACGCC	Negative
ACCACAAGTGGCAGAT	Negative
ACCACAAGTTTACGAC	Hashtag1
ACCACAATCCAAACCA	Hashtag3
ACCACAATCCGCGATG	Hashtag3
ACCATTTAGAGCATCG	Negative
ACCATTTGTTTGAACC	Hashtag1
ACCATTTTCACCTTGC	Negative
ACCCAAAAGACGGAAA	Hashtag3
ACCCAAAAGCACTCGC	Negative
ACCCAAACATACCAGT	Negative
ACCCAAAGTACAAGCG	Negative
ACCCAAAGTGACTAAA	Negative
ACCCAAAGTTCGAGCC	Negative
ACCCAAATCCTTGAAG	Hashtag3
ACCCTCACACTCTGCT	Hashtag3
ACCCTCAGTATGAGCG	Negative
ACCCTTGAGCCATATC	Negative
ACCCTTGAGCTGACCC	Negative
ACCCTTGAGTGATCGG	Negative
ACCCTTGAGTGCCCGT	Negative
ACCCTTGCAATGGCAG	Negative
ACCCTTGGTACCGGAA	Hashtag3
ACCCTTGGTAGACACG	Hashtag1
ACCCTTGGTCACCACG	Hashtag3
ACCCTTGTCCTCATAT	Hashtag3
ACCCTTGTCTTTCCAA	Negative
ACCGTTCAGTTACGTC	Negative
ACCGTTCCAGAGGCAT	Negative
ACCGTTCCAGTGCCTG	Negative
ACCGTTCTCGAGCCAC	Negative
ACCTACCAGTCCTGCG	Negative
ACCTACCAGTGGTGAC	Hashtag1
ACCTGAAAGGAGCAAA	Hashtag3
ACCTGAAAGTAACGAT	Negative
ACCTGAATCTTCCCGA	Negative
ACCTGTCAGCATGCGA	Hashtag3
ACCTGTCAGCGAATGC	Hashtag1_Hashtag3
ACCTGTCCATAGAATG	Negative
ACCTGTCTCTCCGAAA	Negative
ACCTGTCTCTTCTGTA	Negative
ACGATCACACACGGTC	Hashtag3
ACGATCAGTACTTCCC	Negative
ACGATCAGTCGTGCCA	Negative
ACGATCAGTTCAAAGA	Negative
ACGATCATCACTTTGT	Negative
ACGATGTAGTGTTCCA	Hashtag1_Hashtag3
ACGATGTGTCGGAACA	Negative
ACGATGTGTGTACAGG	Hashtag1
ACGCACGGTAGGAGGG	Negative
ACGCACGTCAATGTCG	Hashtag1
ACGCACGTCATTTGGG	Hashtag1
ACGCACGTCTCATTAC	Hashtag3
ACGGAAGGTGAAGCGT	Negative
ACGGAAGTCAGCTCTC	Negative
ACGGAAGTCCATTGGA	Negative
ACGGAAGTCTACCCAC	Hashtag1
ACGGGTCAGGATCACG	Negative
ACGGGTCCACAGGATG	Hashtag3
ACGGGTCCAGGAGGAG	Negative
ACGGTCGAGTCACGAG	Hashtag1
ACGGTCGGTCATCCCT	Negative
ACGGTCGGTCCAGAAG	Negative
ACGGTCGGTGATTAGA	Hashtag3
ACGGTCGTCCGTACGG	Hashtag1
ACGGTTAAGACATAAC	Hashtag3
ACGGTTAGTCTCGGAC	Negative
ACGGTTAGTGCCCGTA	Negative
ACGGTTATCGACGATT	Negative
ACGGTTATCGATTGAC	Hashtag3
ACGGTTATCTGGCCTT	Hashtag3
ACGTAACAGAGTCCGA	Negative
ACGTAACAGTATTCCG	Hashtag1
ACGTAACCAAATGCGG	Negative
ACGTAACCAACGGCTC	Negative
ACGTACAGTTGCTAGT	Negative
ACGTAGTCATTGGGAG	Hashtag3
ACGTAGTGTGGCTTAT	Negative
ACGTAGTGTGTCCGGT	Negative
ACGTAGTTCATAAGGA	Negative
ACGTCCTAGATGTTCC	Negative
ACGTCCTAGTCTTGGT	Negative
ACGTCCTTCTCTGACC	Hashtag3
ACGTTCCGTCCAGCGT	Hashtag1
ACGTTCCGTTCTTGTT	Negative
ACGTTCCTCCGAAATC	Negative
ACTACGAAGAGATTCA	Negative
ACTACGAAGGACAGTC	Hashtag1
ACTACGACAACAAGTA	Hashtag1
ACTACGACAGACCAGA	Negative
ACTACGACATCCGGTG	Hashtag1
ACTACGATCACGGGCT	Negative
ACTATCTAGGCTCACC	Negative
ACTATCTTCCTCATAT	Hashtag1
ACTATGGAGAATTGTG	Negative
ACTATGGAGGACAACC	Hashtag1
ACTATGGAGGAGGGTG	Negative
ACTATGGCACATCATG	Hashtag1
ACTATGGCACCGAATT	Negative
ACTATGGTCCTCATAT	Negative
ACTATGGTCTCGGGAC	Negative
ACTATTCAGACCATTC	Hashtag3
ACTATTCAGACTTCAC	Negative
ACTATTCAGTAGCATA	Negative
ACTATTCAGTCATGCT	Negative
ACTATTCCACATGTTG	Hashtag3
ACTATTCCACTGGCCA	Negative
ACTATTCCAGACGCTC	Negative
ACTATTCGTAGCGTCC	Negative
ACTATTCGTGCATTTG	Negative
ACTATTCTCCCTATTA	Negative
ACTCCCAAGTATGTAG	Negative
ACTCCCAAGTCCCGGT	Negative
ACTCCCACACACCGCA	Negative
ACTCCCAGTCATGCAT	Negative
ACTCCCATCACCATGA	Negative
ACTCTCGAGTATCCTG	Hashtag3
ACTCTCGGTAGACTGG	Negative
ACTCTCGGTTGACTAC	Negative
ACTCTCGTCTCGTGAA	Hashtag3
ACTGATGGTTTAGAGA	Negative
ACTGATGTCACCCTTG	Hashtag1_Hashtag3
ACTGATGTCGTGGTAT	Negative
ACTGATGTCGTTGCCT	Negative
ACTGCAAAGCACTCTA	Hashtag3
ACTGCAAAGCGCCCAT	Negative
ACTGCAACAGTAGTGG	Negative
ACTGCAAGTTGCTCCT	Negative
ACTGCAATCATCGACA	Negative
ACTGCAATCTGGGATT	Negative
ACTGTCCAGTAGGCCA	Negative
ACTGTCCTCATGCGGC	Negative
ACTGTCCTCGATACAC	Hashtag1
ACTGTCCTCGTTGTAG	Negative
ACTGTGACACAAATGA	Negative
ACTGTGAGTATCATGC	Negative
ACTGTGAGTTTATGCG	Negative
ACTGTGATCCGCCTAT	Negative
ACTGTGATCTCACTCG	Hashtag1
ACTTAGGAGAACAGGA	Hashtag1
ACTTAGGCACGACGAA	Negative
ACTTAGGCATAGAATG	Negative
ACTTAGGGTTCTTGTT	Hashtag1
ACTTATCAGAGAGCAA	Negative
ACTTATCCAATCGTCA	Negative
ACTTATCTCAACCTCC	Negative
ACTTATCTCACCTTGC	Negative
ACTTATCTCGGTTGTA	Negative
ACTTCCGCAAGTACCT	Hashtag3
ACTTCCGCACTTGACA	Hashtag3
ACTTCCGTCGTAGTCA	Negative
ACTTCCGTCGTTAGAC	Negative
ACTTCGCAGAGTGTGC	Negative
ACTTCGCAGCATTGAA	Negative
ACTTCGCTCACCGACG	Hashtag3
ACTTTCAAGAGTGTGC	Negative
ACTTTCACACAGAGCA	Negative
ACTTTCACATAAGCGG	Negative
ACTTTCAGTTGCATGT	Negative
ACTTTCATCCAGCTCT	Negative
ACTTTGTGTATCGCTA	Negative
ACTTTGTTCCCGAAAT	Negative
ACTTTGTTCGAGTCCG	Negative
AGAAATGAGGTTATAG	Negative
AGAAATGAGTTGGCTT	Negative
AGAAATGCACCCTTGT	Negative
AGAAATGCACGTCGTG	Negative
AGAAATGCACTTCCTG	Negative
AGAAATGTCACTGATG	Hashtag3
AGAAATGTCCTAGAGT	Hashtag1
AGAACAAAGTGCCGAA	Hashtag3
AGAACAAAGTTGGCTT	Hashtag1
AGAACAACACTGGCCA	Hashtag1
AGAACAAGTACAGCGA	Negative
AGAACAATCGATTGGT	Negative
AGAACCTAGTTGTAAG	Hashtag3
AGAACCTCATACGCAT	Negative
AGAACCTTCAAACCCA	Negative
AGAACCTTCGCAATGT	Hashtag1
AGAAGCGCAAGCCTGC	Negative
AGAAGCGCACCTAAAC	Negative
AGAAGCGGTCTATGAC	Negative
AGAAGCGTCAGGACGA	Hashtag3
AGAAGTAAGGCTAACG	Negative
AGAAGTAAGTACTGGG	Negative
AGAAGTACAAGAGTTA	Negative
AGAAGTAGTAGCTTAC	Hashtag1
AGAAGTAGTTGGTGTT	Negative
AGAAGTATCTGTTGGA	Negative
AGACAAACACCAGGTC	Negative
AGACAAACAGGGTCTC	Negative
AGACAAAGTCGAACAG	Hashtag1
AGACAAATCCGGTTCT	Hashtag3
AGACAAATCGCTACAA	Negative
AGACACTAGGAGATAG	Negative
AGACACTCAATGGCAG	Negative
AGACACTCAATTGCCA	Hashtag1
AGACACTCAGACTCTA	Negative
AGACACTCAGGACAGT	Negative
AGACACTCAGGTTACT	Negative
AGACACTGTCGAGTTT	Negative
AGACACTGTCTGTGGC	Hashtag3
AGACAGGAGGACTTCT	Hashtag3
AGACAGGCAATAAGGT	Negative
AGACAGGGTGTTGATC	Hashtag1
AGACAGGTCCCTGGTT	Hashtag1
AGACAGGTCGGAAACG	Negative
AGACCATCAATTTCTC	Negative
AGACCATTCATTTCCA	Negative
AGACCATTCCATTGTT	Negative
AGACCATTCCTACACC	Negative
AGACCCGCAGCGTGAA	Negative
AGACCCGTCGGCACTG	Negative
AGACTCAAGTCTTGGT	Negative
AGACTCAGTAGGCTGA	Hashtag3
AGAGAATAGGCATCGA	Negative
AGAGAATAGTGCACTT	Hashtag1
AGAGAATCAACCGATT	Hashtag3
AGAGAATGTAGGTACG	Negative
AGAGAGCAGGGCAACT	Hashtag3
AGAGAGCAGGGTACGT	Negative
AGAGAGCCAGCAGTAG	Hashtag3
AGAGCAGCAAATACGA	Negative
AGAGCAGTCTCGCTCA	Hashtag3
AGAGCAGTCTGGACTA	Negative
AGAGCAGTCTTAAGGC	Hashtag3
AGAGCCCAGCGACTGA	Negative
AGAGCCCCACCCAATA	Negative
AGAGCCCTCTCGTCAC	Negative
AGATAGACATCCGAAT	Negative
AGATAGAGTATACCTG	Hashtag3
AGATAGATCCTGGTCT	Hashtag1
AGATAGATCTCGTGAA	Hashtag3
AGATCCAAGAAGGTAG	Negative
AGATCCAAGCCGGATA	Hashtag3
AGATCCACAAACCACT	Hashtag1
AGATCCACAATGGGTG	Negative
AGATCCAGTCTCCCTA	Negative
AGATCCAGTTCGGTAT	Negative
AGATCCAGTTGTGTTG	Negative
AGATCCATCAACGCTA	Negative
AGATCGTGTACAGAAT	Negative
AGATCGTTCCATTTGT	Negative
AGATGAACAACGGCTC	Negative
AGATGAACAAGGTTGG	Hashtag1
AGATGAAGTACGGTTT	Negative
AGATGAAGTATGCTTG	Negative
AGATGAAGTGTGTGTT	Hashtag1
AGATGAAGTTGCGAAG	Hashtag1
AGATGAATCAGCCCAG	Negative
AGATGAATCTCCAATT	Hashtag3
AGATGCTGTTCACCGG	Hashtag3
AGCATCAAGCTCCCTT	Hashtag3
AGCATCAGTCCACAGC	Negative
AGCATCATCATGCCCT	Hashtag1
AGCATCATCCGACAGC	Hashtag1
AGCCAATAGAGTCAGC	Negative
AGCCAATAGATACTGA	Negative
AGCCAATCAATGCTCA	Negative
AGCCAATCAGCTGAAG	Hashtag1
AGCCAATGTCGCATGC	Hashtag1
AGCCAATTCCAAGCAT	Hashtag1
AGCCACGAGAAGGGAT	Hashtag1
AGCCACGCAAGAGTTA	Negative
AGCCACGGTGCAATGG	Negative
AGCCACGTCCAACTAG	Negative
AGCCACGTCCTTGAAG	Negative
AGCCACGTCTTCTTCC	Negative
AGCCAGCCACATTCTT	Negative
AGCCAGCCAGCGTTGC	Negative
AGCCAGCTCCTAGAGT	Hashtag3
AGCCAGCTCTTACGGA	Negative
AGCGATTAGAAATTCG	Hashtag1
AGCGATTAGTGAACAT	Negative
AGCGATTAGTGGATTA	Negative
AGCGATTGTAAGATTG	Negative
AGCGATTGTAGTCCTA	Negative
AGCGATTGTGCGAACA	Negative
AGCGATTTCGCCATAA	Negative
AGCGCCAAGCATTGAA	Negative
AGCGCCACACCAAAGG	Negative
AGCGCCAGTCATAAAG	Hashtag3
AGCGCCAGTCTCTCCA	Negative
AGCGCCATCTACGGGC	Negative
AGCGCTGAGCTCCGAC	Hashtag3
AGCGCTGCAAATCGTC	Hashtag1
AGCGCTGCAATGAACA	Hashtag3
AGCGCTGGTAATGATG	Negative
AGCGCTGGTTCTCCTG	Negative
AGCGTATAGTGCCTCG	Hashtag3
AGCGTATCACATCCCT	Negative
AGCGTATCAGTCGGAA	Hashtag3
AGCGTATCATCTGCGG	Hashtag1
AGCGTATGTGTTTGCA	Hashtag1
AGCGTATTCGGCTCTT	Negative
AGCGTCGCACGTAACT	Hashtag1
AGCTACAAGGAACGAA	Hashtag1_Hashtag3
AGCTACACAGTTAAAG	Negative
AGCTACAGTGGCGTAA	Hashtag1
AGCTACATCGGTTGTA	Negative
AGCTACATCGTGTCAA	Negative
AGCTACATCTGTAACG	Negative
AGCTCAAAGAGGGTCT	Negative
AGCTCAAAGAGGTGCT	Negative
AGCTCAACAAACTAAG	Negative
AGCTCAACATGGCTGC	Hashtag3
AGCTCAAGTACCCGCA	Negative
AGCTCAAGTCGCATTA	Negative
AGCTCAATCTTTCGAT	Hashtag3
AGCTTCCAGATCGCTT	Hashtag3
AGCTTCCAGCTTCGTA	Negative
AGCTTCCAGGCCATAG	Hashtag3
AGCTTCCCAATTGTGC	Hashtag3
AGCTTCCCACACCTAA	Hashtag3
AGCTTCCCACACTTAG	Negative
AGCTTCCCATGGAGAC	Hashtag1
AGCTTCCGTAACAAGT	Hashtag3
AGCTTCCGTCGGTGTC	Negative
AGCTTCCGTTGACGGA	Negative
AGCTTCCGTTGTCTAG	Negative
AGCTTCCTCCTACCAC	Negative
AGCTTCCTCTTTCCGG	Negative
AGGAAATGTATGAGGC	Hashtag3
AGGAAATGTCATGGCC	Negative
AGGAAATGTCGAGCTC	Hashtag1
AGGAAATGTTCCGCAG	Negative
AGGAATAAGGTACAAT	Hashtag3
AGGAATACACTGATTG	Negative
AGGAATACAGACGATG	Hashtag1
AGGAATACATACCAGT	Negative
AGGAATAGTTGTAGCT	Hashtag3
AGGAATATCCTACAAG	Negative
AGGACGAAGACCAGAC	Hashtag3
AGGACGAAGGACGCTA	Hashtag3
AGGACGAAGTAACCTC	Hashtag1
AGGACGAAGTGGACGT	Hashtag3
AGGACGAGTTTGGGTT	Negative
AGGACGATCAGTCAGT	Negative
AGGACTTAGACCAGCA	Hashtag3
AGGACTTAGACTTCAC	Hashtag1
AGGACTTCACATAACC	Negative
AGGACTTCATGAAAGT	Hashtag1
AGGACTTGTCCTTGTC	Hashtag1
AGGACTTGTCGCGTTG	Negative
AGGACTTTCGTCGATA	Hashtag1
AGGAGGTAGCGACATG	Hashtag3
AGGAGGTCACCTGATA	Negative
AGGATAAAGAGCAAGA	Negative
AGGATAATCTAGTACG	Negative
AGGATCTAGAAGGATG	Hashtag3
AGGATCTCATGGAGAC	Negative
AGGCATTCAATGCAGG	Hashtag1
AGGCATTCAGGCGAAT	Negative
AGGCATTGTTGCTTGA	Hashtag3
AGGCATTTCATCTATC	Hashtag3
AGGCATTTCATTTGTC	Negative
AGGCATTTCCTAGCCT	Hashtag3
AGGCATTTCGACATCA	Negative
AGGCCACAGCCATCCG	Hashtag3
AGGCCACAGCTGACAG	Hashtag3
AGGCCACCAATTGAGA	Negative
AGGCCACCATAAGCGG	Hashtag3
AGGCCACGTGAGCAGT	Negative
AGGCTGCAGCCTCGTG	Negative
AGGCTGCAGGACGCAT	Negative
AGGCTGCCAAGAGTAT	Hashtag3
AGGCTGCCACGGTGAA	Negative
AGGCTGCGTAAGCTCT	Negative
AGGCTGCGTACCCGCA	Hashtag3
AGGCTGCGTACGATCT	Hashtag1
AGGCTGCGTTCCACAA	Negative
AGGCTGCTCTCCCAAC	Negative
AGGGAGTAGAGTCTGG	Negative
AGGGAGTGTAAGATCA	Hashtag3
AGGGAGTGTCAAACGG	Negative
AGGGCCTAGCCGAACA	Hashtag3
AGGGCCTCACGAGGTA	Negative
AGGGCCTGTCGTGGTC	Negative
AGGGCCTTCGTACACA	Hashtag3
AGGGCCTTCGTTATCT	Negative
AGGGCCTTCTACTATC	Negative
AGGGCTCAGACTTCGT	Negative
AGGGCTCAGTCAGCCC	Hashtag1
AGGGCTCGTCTTGCGG	Negative
AGGGCTCTCGCGGACT	Negative
AGGGTCCAGGTTAAAC	Negative
AGGGTCCCAGCTACCG	Hashtag3
AGGGTCCGTGCGTCGT	Negative
AGGGTGAGTAAGGTCG	Hashtag3
AGGGTGATCAGTGTGT	Hashtag3
AGGGTGATCTAGAGCT	Hashtag3
AGGGTGATCTTTGCTA	Hashtag3
AGGGTTTAGAGCCATG	Negative
AGGGTTTAGCAAGTGC	Hashtag1
AGGGTTTAGCCTCAGC	Negative
AGGGTTTCAAGACCGA	Negative
AGGGTTTGTGAGATAT	Negative
AGGGTTTTCAAAGAAC	Negative
AGGGTTTTCCATTTCA	Negative
AGGGTTTTCCCTAGGG	Hashtag3
AGGTCATAGCTAAGTA	Negative
AGGTCATCACACGTGC	Hashtag1
AGGTCATCACCCTGTT	Negative
AGGTCATTCCTTCTAA	Negative
AGGTCTAGTTGTATGC	Negative
AGGTGTTCATAAGCGG	Hashtag3
AGGTGTTGTCCTCAGG	Negative
AGGTGTTGTGAACCGA	Negative
AGGTTACAGAAACTAC	Negative
AGGTTACAGGAGATAG	Hashtag1
AGGTTACGTACTAGCT	Negative
AGGTTGTAGGATCATA	Hashtag3
AGGTTGTCAGACACCC	Hashtag3
AGGTTGTCATCTCGTC	Negative
AGGTTGTGTGTACGCC	Negative
AGTACCAAGCAGGTCA	Hashtag3
AGTACCAAGGAACTAT	Negative
AGTACCACAACGTATC	Negative
AGTACCACAACTGCTA	Hashtag3
AGTACCACATTGACCA	Negative
AGTACCAGTTGTCAGT	Hashtag3
AGTACCATCCGGACTG	Hashtag1
AGTACCATCCTAAGTG	Negative
AGTACTGAGTAACGAT	Negative
AGTACTGCACTAGGCC	Hashtag1
AGTACTGGTGCACGCT	Negative
AGTAGCTAGATGACAT	Hashtag3
AGTAGCTCAAGTAGTA	Negative
AGTAGTCCACATGAAA	Hashtag3
AGTAGTCCATTGCCTC	Negative
AGTAGTCGTAGGACTG	Negative
AGTAGTCTCAACTGAC	Negative
AGTAGTCTCAGCACCG	Hashtag3
AGTAGTCTCGTCGGGT	Negative
AGTAGTCTCTTCACGC	Negative
AGTCAACCACTGGCCA	Hashtag1
AGTCAACCAGCTTTCC	Negative
AGTCAACGTAGGGTAC	Negative
AGTCAACGTGCAGGAT	Negative
AGTCAACGTTCTAAGC	Negative
AGTCAACTCGGTTGTA	Negative
AGTCAACTCTAGAGCT	Negative
AGTCACAAGTGGCGAT	Negative
AGTCACACAAGTATCC	Negative
AGTCACACAATTGAGA	Negative
AGTCACACACGAAGAC	Negative
AGTCACACATCAGCAT	Negative
AGTCACAGTCTTACTT	Negative
AGTCACAGTGTCCCTT	Negative
AGTCACATCCTTATAC	Hashtag1
AGTCATGGTGACGTCC	Negative
AGTCATGGTTGCTTGA	Hashtag3
AGTCTCCCAATCTAGC	Negative
AGTCTCCCAGCAGAAC	Negative
AGTCTCCTCAGTCCGG	Negative
AGTGACTCAACACACT	Negative
AGTGACTCAATACCTG	Negative
AGTGACTTCAGATGCT	Hashtag1
AGTGATCAGCTCCGAC	Negative
AGTGATCAGGACCCAA	Negative
AGTGATCAGGCAGTCA	Hashtag3
AGTGATCCACGCGTCA	Hashtag1
AGTGATCGTGTATTGC	Negative
AGTGATCTCTGAGAGG	Negative
AGTGCCGCAAATCAGA	Hashtag3
AGTGCCGCATGTCAGT	Negative
AGTGCCGCATTGGGAG	Negative
AGTGCCGTCGTCAAAC	Negative
AGTGTTGGTCCACGCA	Negative
AGTGTTGGTCTTTATC	Hashtag1
AGTGTTGGTTTGGAGG	Negative
AGTGTTGTCAGTGTGT	Hashtag3
AGTTAGCAGAATTCAG	Negative
AGTTAGCCAACCGCTG	Hashtag3
AGTTAGCCACTACTTT	Negative
AGTTAGCGTCAGGTGA	Negative
AGTTCCCAGCAAGGAA	Negative
AGTTCCCGTCCATACA	Negative
AGTTCCCTCAACGTGT	Hashtag1
AGTTCCCTCCTTGAAG	Negative
AGTTCCCTCTTGGAAC	Negative
AGTTCGAGTAGCACGA	Negative
AGTTCGAGTAGTCCTA	Negative
AGTTCGAGTATACCCA	Negative
AGTTCGAGTATCGTTG	Negative
AGTTCGAGTATGACAA	Negative
AGTTCGATCGCGTCGA	Hashtag3
ATACCGACAGAGGCTA	Negative
ATACCGACATCGAGCC	Hashtag3
ATACCTTAGCGCGTTC	Negative
ATACCTTAGTAGCCAG	Negative
ATACCTTCACATATGC	Negative
ATACCTTCAGACACAG	Negative
ATACCTTGTTATTCCT	Negative
ATACCTTTCCGGCAAC	Negative
ATACCTTTCTAACGCA	Hashtag3
ATACTTCAGCCGATTT	Hashtag3
ATACTTCCATCCTCAC	Negative
ATACTTCGTCGTACTA	Negative
ATACTTCTCAAGTTGC	Negative
ATACTTCTCTAGACCA	Hashtag3
ATAGACCAGTCAGGGT	Hashtag3
ATAGACCCATCAGTGT	Hashtag1
ATAGACCGTAGTATAG	Negative
ATAGACCGTATTTCCT	Negative
ATAGAGAAGCGTGTCC	Hashtag1
ATAGAGACAACGACTT	Negative
ATAGAGACACTGATTG	Negative
ATAGAGAGTCTATGAC	Hashtag1
ATAGAGAGTGTGTGTT	Hashtag1
ATAGAGATCATTACGG	Negative
ATAGAGATCCTCCACA	Negative
ATAGAGATCGATAACC	Hashtag1
ATAGAGATCTAGACAC	Hashtag3
ATAGGCTAGTCTGCGC	Negative
ATAGGCTCAGCAGAAC	Negative
ATAGGCTCATGAAAGT	Negative
ATAGGCTGTAGAGGAA	Negative
ATAGGCTGTCATGGCC	Hashtag1
ATATCCTAGCGTGAGT	Hashtag3
ATATCCTAGCGTTGTT	Negative
ATATCCTTCAATCCGA	Hashtag1
ATCACAGAGAACAGGA	Negative
ATCACAGCACCTCTGT	Negative
ATCACAGGTGAGTAGC	Negative
ATCACAGTCGAATGCT	Hashtag1
ATCACGATCGGTTCAA	Negative
ATCACGATCTCAATCT	Negative
ATCACGATCTGAGATC	Negative
ATCACTTCACCACTGG	Negative
ATCACTTCATGATAGA	Hashtag3
ATCACTTGTACCATAC	Hashtag3
ATCACTTGTCATTCCC	Negative
ATCACTTTCGGCTGGT	Hashtag1
ATCAGGTAGAACTCCT	Negative
ATCAGGTCACGTATAC	Hashtag3
ATCAGGTCAGCAGTCC	Negative
ATCAGGTTCAAGTTGC	Hashtag1
ATCAGGTTCCACTGAA	Hashtag1
ATCAGGTTCCATCTAT	Hashtag1
ATCAGGTTCGCTGTTC	Negative
ATCATTCGTCTCCTGT	Negative
ATCATTCTCGACCATA	Hashtag3
ATCATTCTCTCTCCGA	Hashtag3
ATCCACCCAATTGCCA	Hashtag3
ATCCACCGTCTTCCGT	Negative
ATCCACCGTGCCTAAT	Hashtag3
ATCCACCGTGCCTGCA	Hashtag3
ATCCACCTCAGTAGGG	Negative
ATCCATTCATCATTTC	Negative
ATCCATTGTCGCGTCA	Negative
ATCCATTGTTGACTAC	Negative
ATCCATTTCGACATAC	Negative
ATCCATTTCGACGTCG	Hashtag3
ATCCCTGAGATTTGCC	Negative
ATCCCTGAGCCGGAAT	Negative
ATCCCTGAGGGTTAGC	Hashtag3
ATCCCTGCAGGCGATA	Negative
ATCCCTGCAGTAGTGG	Hashtag3
ATCCCTGTCAAGTCGT	Hashtag1
ATCCGTCAGTGACCTT	Negative
ATCCGTCCAGGTGAGT	Hashtag1
ATCCGTCCATAGAGGC	Hashtag1
ATCCGTCGTCCACACG	Negative
ATCCGTCGTCCCAAAT	Hashtag1
ATCCGTCTCCAAGCCG	Negative
ATCCGTCTCGGTCACG	Negative
ATCCTATAGAGCAGCT	Negative
ATCCTATCAAGCAATA	Hashtag1
ATCCTATCAAGGTCGA	Hashtag1
ATCCTATGTATCGATC	Hashtag1
ATCCTATGTATGCAAA	Negative
ATCCTATGTCACTACA	Negative
ATCCTATGTGGCAGAT	Negative
ATCCTATGTGGTAACG	Hashtag3
ATCGATGGTGCATTTG	Hashtag3
ATCGATGTCCACTAGA	Hashtag1
ATCGCCTAGCACTGGA	Hashtag1
ATCGCCTCAGGTCCCA	Negative
ATCGCCTGTGTGTACT	Hashtag3
ATCGCCTGTTCAGCTA	Negative
ATCGCCTTCCGGTAGC	Negative
ATCGCCTTCCTTATGT	Hashtag3
ATCGGATCATCAGTCA	Hashtag1
ATCGGATTCAATCCAG	Negative
ATCGGATTCCAAGCAT	Negative
ATCGGATTCCGATCTC	Hashtag1
ATCGGCGAGACAACTA	Negative
ATCGGCGCACGTCGGT	Hashtag3
ATCGGCGGTTGGGTAG	Hashtag1
ATCGGCGTCTGCCTCA	Negative
ATCGTAGCACATATGC	Negative
ATCGTAGGTCCAAATC	Negative
ATCGTAGGTCTGTCAA	Negative
ATCGTAGGTGAAGCGT	Negative
ATCGTAGGTTCTGAGT	Negative
ATCGTAGTCAAGGAGC	Hashtag1
ATCGTCCTCGGATAAA	Hashtag3
ATCGTCCTCTGCGATA	Hashtag1
ATCGTGAAGAGCCGTA	Negative
ATCGTGAAGCAGCACA	Hashtag3
ATCGTGAAGTCATAGA	Negative
ATCGTGACACATGTTG	Hashtag3
ATCGTGACACCGCTGA	Negative
ATCGTGATCCTGTTGC	Negative
ATCTCTAAGACATAGT	Negative
ATCTCTAAGCTACTGT	Negative
ATCTCTACAGATCATC	Negative
ATCTCTATCACCGACG	Hashtag3
ATCTCTATCCATATGG	Hashtag3
ATCTCTATCGACCTAA	Negative
ATCTCTATCGGCACTG	Negative
ATCTTCAAGCTGACTT	Negative
ATCTTCAAGGGCAGTT	Negative
ATCTTCAGTAGAGACC	Negative
ATCTTCAGTATAGCTC	Hashtag3
ATCTTCAGTTGCCATA	Hashtag1
ATCTTCATCAATCAGC	Negative
ATCTTCATCACACCCT	Negative
ATCTTCATCCCAGGAC	Negative
ATCTTCATCGAAGCAG	Negative
ATCTTCATCTATACGG	Negative
ATGAAAGAGCCGAACA	Negative
ATGAAAGAGCGGTATG	Hashtag1
ATGAAAGTCAAACCTG	Hashtag1
ATGACCAAGTAAGGGA	Negative
ATGACCAAGTGATTCC	Hashtag1
ATGACCACACACGGTC	Hashtag1
ATGACCAGTACGATTC	Negative
ATGACCAGTCACAGAG	Negative
ATGACCAGTGAGATAT	Negative
ATGACCATCTAGTTCT	Hashtag3
ATGAGGGAGGCGAAGG	Hashtag3
ATGAGGGCAACGGCCT	Negative
ATGAGGGGTACCTAGT	Negative
ATGAGGGGTGATTAGA	Negative
ATGAGGGGTGGATCAG	Negative
ATGAGTCCAGAGTCTT	Negative
ATGAGTCGTAGTACGG	Negative
ATGAGTCGTATACAGA	Negative
ATGAGTCGTCGCCTAG	Negative
ATGAGTCTCGTAGCCG	Negative
ATGATCGAGGCACGAT	Negative
ATGATCGAGTAGAGTT	Negative
ATGATCGAGTCTAGAA	Hashtag1
ATGATCGCACGGCTAC	Hashtag1
ATGATCGCATGACGGA	Hashtag3
ATGATCGGTTTACTGG	Negative
ATGATCGTCCGAGAAG	Negative
ATGATCGTCGTCCATC	Negative
ATGATCGTCTAGCCAA	Negative
ATGCATGCACACAGCC	Hashtag1
ATGCATGGTAGTCTTG	Negative
ATGCATGGTCTAACTG	Negative
ATGCATGTCTACTATC	Negative
ATGCCTCAGAATCGAT	Negative
ATGCCTCAGCAGATAT	Negative
ATGCCTCAGCTGACCC	Hashtag3
ATGCCTCCAAATCGTC	Hashtag3
ATGCCTCCACTGAGGA	Negative
ATGCCTCGTAACATCC	Negative
ATGCCTCGTTGCCGCA	Hashtag1
ATGCCTCGTTTCACTT	Negative
ATGCGATTCCACCTCA	Negative
ATGCGATTCGTGGGTC	Negative
ATGGAGGCACCTGATA	Negative
ATGGAGGCACCTGCAG	Negative
ATGGAGGCACTTCCTG	Hashtag3
ATGGAGGTCGTCGGGT	Negative
ATGGAGGTCTGACGCG	Negative
ATGGATCCAGCCTTCT	Hashtag1
ATGGATCGTCACCGAC	Negative
ATGGATCGTCCTCAGG	Negative
ATGGATCTCAGACCCG	Negative
ATGGGAGCAATTGCGT	Hashtag3
ATGGGAGCACATTCTT	Negative
ATGGGAGGTCGTCTCT	Hashtag3
ATGGGAGTCTCCGATC	Negative
ATGGGTTAGACAGCGT	Hashtag3
ATGGGTTAGGTTCAGG	Negative
ATGGGTTAGTGGTGGT	Negative
ATGGGTTCAGCTTCGG	Negative
ATGGGTTTCAGAGCGA	Hashtag1
ATGGGTTTCCTCACGT	Negative
ATGGTTGAGGATCACG	Negative
ATGGTTGAGTACGTCT	Negative
ATGGTTGCACCCAATA	Hashtag1
ATGGTTGCAGAGCGTA	Hashtag1
ATGGTTGCAGCACACC	Hashtag3
ATGGTTGTCACGAGGA	Negative
ATGGTTGTCCCTTCCC	Hashtag1
ATGGTTGTCGGACTTA	Negative
ATGTCCCAGGGCAATC	Hashtag3
ATGTCCCGTGTACATC	Negative
ATGTCTTCATTCCTCG	Hashtag1_Hashtag3
ATGTCTTGTCAGATTC	Negative
ATGTCTTGTCAGTCCG	Negative
ATGTCTTGTTCCTAAG	Negative
ATGTCTTTCAATGCAC	Hashtag3
ATTACCTAGCACGGAT	Negative
ATTACCTAGTAAACGT	Negative
ATTACCTCACGCTGAC	Hashtag3
ATTACCTGTAACATCC	Negative
ATTACCTGTCGTTTCC	Hashtag3
ATTACCTGTGGAGAAA	Negative
ATTACCTTCCATCCGT	Negative
ATTACTCAGCTTACGT	Hashtag1
ATTACTCGTCTACACA	Hashtag3
ATTATCCAGCTAATCC	Negative
ATTATCCTCCCTCTTT	Hashtag3
ATTCACTCAAGCGCAA	Hashtag3
ATTCACTCACCAGCCA	Negative
ATTCACTCATCATCCC	Hashtag3
ATTCACTTCACGATCA	Hashtag3
ATTCACTTCCATTGTT	Negative
ATTCAGGAGATGTTGA	Negative
ATTCAGGAGTGCTCAT	Negative
ATTCAGGCAAGAGCTG	Negative
ATTCAGGCAGGTTCCG	Negative
ATTCAGGCATTGAAGA	Hashtag1
ATTCAGGGTGCGTTTA	Negative
ATTCAGGGTGTAAACA	Hashtag1
ATTCAGGTCTGGAGAG	Negative
ATTCATCAGAGATTCA	Negative
ATTCATCCACTTACAG	Hashtag1
ATTCATCGTAGCTTAC	Hashtag1
ATTCCATCAGAGTTCT	Negative
ATTCCATTCCACCCTA	Negative
ATTCCCGAGGCTCCCA	Negative
ATTCCCGAGGTTCAGG	Negative
ATTCCCGAGTAGGTTA	Negative
ATTCCCGCACCAGCGT	Negative
ATTCCCGCATGATGCT	Hashtag1
ATTCCCGGTTTCGTAG	Negative
ATTCCCGTCGTTCAGA	Negative
ATTCCTAAGACTTCCA	Negative
ATTCCTAAGGTAAAGG	Hashtag1
ATTCCTACAATTGTGC	Negative
ATTCCTATCCTCTCTT	Negative
ATTCCTATCGAAGAAT	Hashtag3
ATTCCTATCGACATTG	Negative
ATTCGTTCAAACCATC	Negative
ATTCGTTCAAGTATCC	Negative
ATTCGTTCATTCGGGC	Negative
ATTCGTTGTGATTAGA	Negative
ATTCGTTGTTGTAAAG	Hashtag1
ATTCTACCAATTGCGT	Negative
ATTCTACTCTCTAGGA	Hashtag3
ATTCTTGCAACAACAA	Negative
ATTCTTGGTGCATTAC	Negative
ATTCTTGGTGTCCGGT	Hashtag3
ATTCTTGGTTCCTAAG	Hashtag1
ATTGGGTGTATTGACC	Negative
ATTGGGTGTTATCTGG	Hashtag1
ATTGGGTTCGCACTCT	Negative
ATTGGGTTCTCCAATT	Negative
ATTGTTCAGCAGCGAT	Hashtag3
ATTGTTCAGTTGAATG	Negative
ATTGTTCCATACTTTC	Negative
ATTGTTCCATAGTCAC	Negative
ATTGTTCGTCCTTTGC	Negative
ATTGTTCGTCGTACAT	Negative
ATTGTTCGTTCGGCCA	Hashtag3
ATTTACCCACCATTCC	Negative
ATTTACCCATGAGATA	Negative
ATTTCACCAGATGCGA	Hashtag3
ATTTCACCAGCGACAA	Negative
ATTTCACCAGTCTTCC	Negative
ATTTCACCATGAAGCG	Hashtag1
ATTTCACGTGGCTACC	Hashtag3
ATTTCTGCAATTTCCT	Negative
ATTTCTGGTGGCTGCT	Hashtag3
ATTTCTGTCAATCCAG	Hashtag1
ATTTCTGTCCAAAGGG	Negative
ATTTCTGTCCCTGTTG	Negative
CAAAGAACAACCGCTG	Negative
CAAAGAACAAGCACCC	Hashtag3
CAAAGAAGTCGACTGC	Hashtag1
CAAAGAAGTCGCCACA	Negative
CAAAGAAGTCTCAGAT	Hashtag3
CAAAGAAGTTGGACTT	Negative
CAACAACAGAGTCAGC	Negative
CAACAACTCTCGACGG	Negative
CAACAGTAGCTGACCC	Hashtag3
CAACAGTCACGTCTCT	Negative
CAACAGTCAGGGTTGA	Negative
CAACAGTGTGTCCGGT	Hashtag1
CAACAGTTCTCATTAC	Negative
CAACCAACACGAGGTA	Hashtag1
CAACCAAGTAAGCGGT	Negative
CAACCAAGTGCCGAAA	Negative
CAACCAATCTCAATCT	Negative
CAACCAATCTTAATCC	Negative
CAACCTCCACAGCCAC	Negative
CAACCTCGTCAGTCCG	Negative
CAACCTCGTCTTCCGT	Hashtag3
CAACCTCTCGATCCCT	Negative
CAACGATCATATTCGG	Negative
CAACGATGTCAAAGCG	Negative
CAACGATGTTCCTTGC	Negative
CAACGGCTCTCACTCG	Hashtag3
CAAGACTCACGGCTAC	Negative
CAAGACTTCTGATTCT	Hashtag1
CAAGACTTCTTGGATG	Negative
CAAGAGGGTCTTCATT	Negative
CAAGAGGGTGAATATG	Hashtag3
CAAGAGGGTTGGGTAG	Negative
CAAGAGGTCACTCACC	Negative
CAAGCTACAACCAACT	Negative
CAAGCTACACGACGCT	Negative
CAAGCTATCCATCTCG	Negative
CAAGCTATCTGGCTGG	Hashtag1
CAAGGGAGTACGCTTA	Hashtag3
CAAGGGAGTGACCGAA	Negative
CAAGGGAGTGCTCGTG	Negative
CAAGGGATCTCATTTG	Negative
CAATACGAGAATGTTG	Hashtag1
CAATACGCAACTCCCT	Negative
CAATACGTCTACCCAC	Negative
CAATACGTCTCTGACC	Negative
CAATCGACACAACCGC	Negative
CAATCGACAGCACAGA	Hashtag3
CAATCGACAGCTTTCC	Hashtag3
CAATCGAGTAACGTTC	Hashtag1
CAATCGATCAAGAGTA	Hashtag3
CAATGACGTATGAGGC	Negative
CAATTTCAGCGTCAGA	Negative
CAATTTCCAAAGGCAC	Negative
CAATTTCCATGTGCTA	Negative
CAATTTCGTTATAGAG	Negative
CAATTTCTCACGTCCT	Negative
CAATTTCTCGCCTTGT	Negative
CACAACAAGAGACAAG	Hashtag1
CACAACAAGGCGTCCT	Negative
CACAACAAGGGACCAT	Negative
CACAACACACGGCTAC	Hashtag3
CACAACACAGGCTATT	Negative
CACAACAGTAGGATAT	Negative
CACACAAAGCGTATAA	Negative
CACACAAAGGACAACC	Negative
CACACAACAATTTCGG	Negative
CACACAACACATGAAA	Hashtag1
CACACAACACCTCAGG	Hashtag3
CACACAATCCGTGTCT	Hashtag3
CACACAATCGCCTTGT	Negative
CACAGATAGTGGAAAG	Hashtag1_Hashtag3
CACAGATGTCTAGGCC	Negative
CACAGATGTGTAGGAC	Hashtag1
CACAGATGTTCCAGGC	Negative
CACAGGCAGCACAAAT	Negative
CACAGGCAGGCATGGT	Negative
CACAGGCGTTCATCTT	Hashtag3
CACAGGCGTTTCGTTT	Negative
CACAGGCTCCGGACTG	Hashtag3
CACCAAAAGCCTCAAT	Negative
CACCAAAGTATCGATC	Negative
CACCAAAGTCCGGTCA	Negative
CACCAAAGTTTCAGAC	Negative
CACCGTTAGAGCAAGA	Hashtag3
CACCGTTAGTCTGCGC	Negative
CACCGTTCAACCTATG	Negative
CACCGTTCACGCCACA	Negative
CACCGTTCACTACTTT	Negative
CACCGTTTCACCGGTG	Hashtag1_Hashtag3
CACCGTTTCCGTCCTA	Negative
CACCGTTTCGTGGCGT	Hashtag1
CACGAATAGACCTGGA	Negative
CACGAATAGTCGCCAC	Hashtag3
CACGAATCACCTCGTT	Negative
CACGAATCATCTTCGC	Negative
CACGAATCATGGCCAC	Negative
CACGAATTCGTAGCCG	Negative
CACGGGTAGAGAGCGG	Negative
CACGGGTAGCACTAAA	Hashtag1
CACGGGTAGGTTCCGC	Hashtag3
CACGGGTCAAGGATGC	Negative
CACGGGTGTCACGACC	Hashtag3
CACGGGTTCGTGGTAT	Negative
CACGGGTTCTAGACAC	Negative
CACGGGTTCTCCCAAC	Hashtag3
CACGTGGAGCGAGTAC	Negative
CACGTGGCAAGCAATA	Hashtag3
CACGTGGGTTGTACGT	Negative
CACGTTCCAATGCTCA	Hashtag1
CACGTTCCACAGAGCA	Hashtag3
CACGTTCCACGTAGAG	Hashtag3
CACGTTCTCAAGCCTA	Hashtag1
CACGTTCTCATGCATG	Hashtag3
CACGTTCTCGTAGTCA	Negative
CACGTTCTCTCTCTAA	Hashtag1
CACGTTCTCTGAGCAT	Negative
CACTAAGAGCGGGTTA	Negative
CACTAAGCACGCAAAG	Hashtag3
CACTAAGTCCATCTAT	Negative
CACTAAGTCCTACTGC	Negative
CACTGAACATAATCCG	Negative
CACTGAACATTAAGCC	Hashtag3
CACTGGGAGCGGTATG	Hashtag3
CACTGGGAGCTGACTT	Hashtag1
CACTGGGAGTAGCAAT	Hashtag1
CACTGGGCACCTTCCA	Hashtag1
CACTGGGTCAACCTCC	Negative
CACTGGGTCATGCCGG	Hashtag3
CACTGTCGTGGACAGT	Negative
CACTTCGAGGCCTGCT	Negative
CACTTCGCAATAACGA	Negative
CACTTCGCACGCGCTA	Hashtag3
CACTTCGCAGGACAGT	Negative
CACTTCGGTATGCTTG	Negative
CACTTCGTCCTCATAT	Negative
CAGAGCCAGTTTGTCG	Negative
CAGAGCCGTGCACAAG	Hashtag3
CAGAGCCTCCAGTGCG	Negative
CAGATACAGGTTCCGC	Hashtag1
CAGATACGTGGACTGA	Negative
CAGATACGTGTTGACT	Negative
CAGATACGTTTGGAAA	Negative
CAGATACTCAGTGGGA	Negative
CAGATACTCCCGTAAA	Negative
CAGATACTCCGGACTG	Negative
CAGATCACATACTGAC	Hashtag1
CAGATCATCGCTACGG	Negative
CAGATCATCTTAGTTC	Hashtag1
CAGATCATCTTCGTAT	Negative
CAGATTGAGAATCGAT	Negative
CAGATTGCAACCGTAT	Negative
CAGATTGCAAGAAACT	Hashtag3
CAGATTGGTAGGCTCC	Negative
CAGCAATAGGAACATT	Negative
CAGCAATCAAGCAATA	Negative
CAGCAATCACTATGTG	Negative
CAGCAATGTTAGGGTG	Negative
CAGCAATTCAGTCATG	Hashtag3
CAGCAATTCATTGTTC	Negative
CAGCACGAGACTACGG	Negative
CAGCACGAGCATTGAA	Hashtag1
CAGCACGCACGCAAAG	Negative
CAGCACGCAGGTTCGC	Negative
CAGCACGGTCCTCAGG	Negative
CAGCACGTCATCACCC	Negative
CAGCACGTCGACATCA	Hashtag3
CAGCACGTCGTGCTCT	Negative
CAGCAGCAGGGTCACA	Negative
CAGCAGCAGTGCTCGC	Negative
CAGCAGCCACTTGACA	Hashtag3
CAGCAGCCAGCTCTGG	Negative
CAGCAGCGTGAGTCAG	Hashtag1
CAGCCAGAGAAGCGCT	Negative
CAGCCAGAGAGCACTG	Hashtag1
CAGCCAGCAGCTCGGT	Hashtag3
CAGCCAGCAGTTCACA	Negative
CAGCCAGCATACTGAC	Hashtag3
CAGCCAGCATGCACTA	Negative
CAGCCAGGTACTAAGA	Negative
CAGCCAGGTTTCCCAC	Negative
CAGCGTGCATTCATCT	Hashtag1
CAGCGTGGTGATTGGG	Negative
CAGCGTGGTGGCTGAA	Hashtag3
CAGCGTGGTGGTCTGC	Negative
CAGCGTGTCCAGTGCG	Negative
CAGCGTGTCCATTTCA	Negative
CAGCGTGTCCCAAGTA	Negative
CAGGCCAAGTACAGAT	Hashtag1
CAGGCCACACAGAAGC	Negative
CAGGCCAGTCTTCCGT	Negative
CAGGGCTCAGCGTATT	Negative
CAGGGCTCAGGCTCTG	Negative
CAGGGCTGTTTGGAGG	Hashtag3
CAGGGCTTCATGACAC	Negative
CAGGTATCAGATCACT	Negative
CAGGTATGTGGTCTAT	Hashtag3
CAGGTATTCAAACGTC	Negative
CAGGTATTCTAAACGC	Negative
CAGGTATTCTCTCTTC	Negative
CAGTGCGAGGAAAGTG	Hashtag1
CAGTGCGGTAGGTAGC	Negative
CAGTGCGTCCGAGATT	Negative
CAGTGCGTCGACGCGT	Hashtag3
CAGTTAGCAGGTTACT	Negative
CAGTTAGTCCAGCAAT	Negative
CAGTTCCAGACCAGAC	Negative
CAGTTCCAGAGATTCA	Hashtag3
CAGTTCCAGTGTAGAT	Hashtag1
CAGTTCCGTTCCAAAC	Hashtag3
CAGTTCCTCCGTTGGG	Hashtag3
CAGTTCCTCCTTATAC	Negative
CATAAGCGTATCACCA	Hashtag3
CATAAGCGTTACGATC	Hashtag1
CATAAGCTCATGTCTT	Hashtag3
CATAAGCTCTACACAG	Negative
CATACAGAGGGTCTTT	Negative
CATACAGCAGTCAGTT	Hashtag1
CATACAGCATTACTCT	Negative
CATACAGGTCAAGTTC	Hashtag3
CATACAGGTGCAGATG	Hashtag1
CATACCCAGGGATCTG	Negative
CATACCCAGGTCACCC	Negative
CATACCCAGTGACCTT	Negative
CATACCCGTAGACGGT	Hashtag1
CATACCCGTGGTAATA	Negative
CATACTTAGACGCTCC	Hashtag3
CATACTTCATTGGGAG	Negative
CATACTTGTATTAAGG	Hashtag3
CATACTTGTTATAGAG	Negative
CATAGACGTACGAAAT	Negative
CATAGACGTTCGCGTG	Hashtag3
CATAGACTCAATCGGT	Negative
CATCAAGAGAGTTGCG	Negative
CATCAAGCAAAGGCAC	Hashtag3
CATCAAGCACTATCCC	Hashtag3
CATCAAGCAGTTCCAA	Negative
CATCCACCAGCTAACT	Hashtag1
CATCCACGTCTGATCA	Hashtag1
CATCCCACAGTATGAA	Negative
CATCCCAGTTTGATCG	Negative
CATCCCATCCACTAGA	Negative
CATCCCATCCATTGCC	Negative
CATCCCATCCTAGAGT	Hashtag3
CATCCCATCGAAGTGG	Hashtag1
CATCCCATCTTACCGC	Negative
CATCCGTAGGCTCCCA	Negative
CATCCGTGTTAAGGGC	Negative
CATCCGTTCATGGGAG	Negative
CATCGCTAGAGGTGCT	Hashtag1
CATCGCTCAACCAACT	Negative
CATCGCTCAATTTCTC	Hashtag1
CATCGCTCAGCTACCG	Hashtag1
CATCGCTGTACAAGCG	Negative
CATCGCTGTCGTTTCC	Hashtag3
CATCGCTGTGCGTCGT	Negative
CATCGGGCACTAGGCC	Negative
CATCGGGGTAGGAAAG	Hashtag1
CATCGGGGTCATCACA	Hashtag1
CATCGGGGTTACCGTA	Hashtag1
CATCGTCAGATGAAGG	Negative
CATCGTCAGCTTGTTG	Hashtag3
CATCGTCCAGTCGAGA	Hashtag3
CATCGTCTCCAACTGA	Negative
CATCGTCTCGAGCCTG	Hashtag1
CATCGTCTCTGCGTCT	Negative
CATGAGTAGCGCCGTT	Hashtag3
CATGAGTAGCTCCGAC	Negative
CATGAGTAGTCGAAGC	Negative
CATGAGTAGTGTTCAC	Hashtag3
CATGAGTCACTGCGTG	Negative
CATGCAAAGGTTGGTG	Hashtag3
CATGCAAAGTTCACTG	Negative
CATGCAACAGCATTGT	Negative
CATGCAATCACGTCCT	Negative
CATGCAATCTCATTTG	Negative
CATGCAATCTTGCAAG	Hashtag3
CATGCCTCAGAATTCC	Negative
CATGCCTGTCAGGAGT	Negative
CATGCCTGTGTGCCTG	Negative
CATGCCTTCACGGTCG	Negative
CATGCGGAGCACCAGA	Negative
CATGCGGAGGTAAAGG	Negative
CATGCGGCATGACAAA	Negative
CATGCGGCATTAGGCT	Hashtag1
CATGCTCAGACTACCT	Negative
CATGCTCAGAGGTTTA	Hashtag3
CATGCTCCACGCTATA	Hashtag3
CATGCTCGTCTAATCG	Hashtag1
CATGCTCTCAATGCAC	Negative
CATGCTCTCATAAGGA	Negative
CATGGATCAACAAGTA	Hashtag3
CATGGATCACCCAATA	Negative
CATGGATCAGAGATGC	Negative
CATGGATTCCCATTCG	Negative
CATGGTACAGAACCGA	Hashtag3
CATGGTACAGAGGACT	Negative
CATGGTAGTACCGCGT	Negative
CATGGTAGTACGAGCA	Negative
CATGGTATCACCCTCA	Hashtag1
CATGGTATCGGATACT	Negative
CATGGTATCTTGGAAC	Hashtag1
CATTCATAGATACCAA	Negative
CATTCATGTACTGCGC	Negative
CATTCATTCGCCCAGA	Negative
CATTCCGAGCCATTGT	Negative
CATTCCGAGCTGTTCA	Negative
CATTCCGCAAGCGCAA	Hashtag3
CATTCCGGTAGGGTAC	Hashtag1
CATTCTAAGATTACCC	Hashtag1
CATTCTACACACCGCA	Negative
CATTCTACAGCGGTCT	Negative
CATTCTAGTAACAAGT	Negative
CATTCTAGTATGAGCG	Negative
CATTCTAGTGCCCAGT	Negative
CATTCTAGTGTACGCC	Negative
CATTGAGAGCGTCAAG	Negative
CATTGAGAGTTAGTAG	Hashtag3
CATTGAGCACGGCTAC	Hashtag3
CATTGAGCAGACAAAT	Hashtag1
CATTGAGGTGGACTGA	Negative
CATTGAGTCGTTCAGA	Negative
CATTGCCAGTAGTCTC	Negative
CATTGCCCACAGTCAT	Negative
CATTGCCCACCGCTAG	Negative
CATTGCCCATGAGAAT	Negative
CATTGCCTCAGAGCAG	Hashtag1_Hashtag3
CATTGTTAGTCAGGGT	Negative
CATTGTTGTGTTGACT	Negative
CATTTCAAGTTGGAGC	Negative
CATTTCAGTGACCGTC	Negative
CCAATGAAGTAAACTG	Negative
CCAATGACAAACTCTG	Negative
CCAATGACATGTGCCG	Hashtag3
CCAATGACATTATGCG	Negative
CCAATGAGTTGCAACT	Negative
CCAATGATCGGTAACT	Negative
CCAATTTAGAGGATCC	Negative
CCAATTTAGGGTTTCT	Hashtag3
CCAATTTAGGTTCTAC	Hashtag1
CCAATTTCAAATTAGG	Negative
CCAATTTCACACTGGC	Hashtag3
CCAATTTCAGTAGTGG	Hashtag1
CCAATTTCATCGCTCT	Negative
CCACAAAAGTTCCAGT	Negative
CCACAAATCCAACCGG	Hashtag3
CCACACTAGCGAGAAA	Negative
CCACACTAGCTGTCCG	Negative
CCACACTCAAGTACCT	Negative
CCACACTGTGTTCCTC	Negative
CCACCATCACAGCCTG	Negative
CCACCATTCCTTCGAC	Negative
CCACGAGGTGAACCGA	Negative
CCACGAGTCCTTGACC	Negative
CCACGTTCAGAGTTGG	Negative
CCACGTTCATCATGAC	Negative
CCACGTTTCCGTCCTA	Hashtag1
CCACTTGAGAACGTGC	Hashtag3
CCACTTGCATGGCTAT	Negative
CCACTTGGTCACTACA	Hashtag1
CCACTTGGTTGCTCGG	Hashtag1
CCATAAGAGTTTCAGC	Negative
CCATAAGCATTGGGAG	Negative
CCATAAGGTCGATGCC	Negative
CCATAAGGTCTGTAGT	Hashtag3
CCATAAGGTTCCGCGA	Negative
CCATAAGGTTGGGTTT	Hashtag3
CCATCACAGCTGCCAC	Negative
CCATCACAGTCCGCCA	Hashtag3
CCCAACTGTAATTAGG	Negative
CCCAACTGTGCACAAG	Negative
CCCAACTTCGGAAGGT	Hashtag3
CCCAACTTCTCAGTCC	Hashtag3
CCCATTGAGCAAATCA	Negative
CCCATTGCACGCCACA	Negative
CCCATTGCATTGACCA	Negative
CCCATTGGTACGACAG	Hashtag3
CCCATTGTCTGTAACG	Hashtag1
CCCGAAGCACTCCGAG	Negative
CCCGAAGGTCACTGAT	Negative
CCCGAAGGTTAGCGGA	Hashtag3
CCCGAAGTCTCCGTGT	Negative
CCCGGAAAGCACGGAT	Hashtag1
CCCGGAACACCTCTGT	Negative
CCCTAACAGCTAGAAT	Negative
CCCTCAAAGTCCTGCG	Negative
CCCTCAACAATGGCCC	Negative
CCCTCAACACTGCGAC	Negative
CCCTCTCAGAATTGCA	Negative
CCCTCTCCAGCATACT	Negative
CCCTCTCGTCCCTCAT	Hashtag1
CCCTGATCATTCCTAT	Negative
CCCTGATTCTACGGGC	Hashtag3
CCCTTAGAGCCTCCAG	Hashtag1
CCCTTAGGTGGTACAG	Negative
CCCTTAGTCGTGCTCT	Negative
CCCTTAGTCTTCTGGC	Hashtag1
CCGAACGAGAGACAAG	Negative
CCGAACGAGTCAGAGC	Negative
CCGAACGCAAACTAGA	Hashtag3
CCGAACGGTCCACATA	Negative
CCGAACGGTGGTCCGT	Hashtag1
CCGATCTAGACCTCCG	Negative
CCGATCTAGCCGTTGC	Negative
CCGATCTAGTGGAAAG	Negative
CCGATCTGTCCTCAGG	Negative
CCGATCTTCACCACAA	Hashtag3
CCGATGGAGACGACGT	Negative
CCGATGGCAGTTGTTG	Negative
CCGATGGGTCACTCAA	Negative
CCGATGGGTGGACCAA	Negative
CCGATGGGTTCCTAAG	Negative
CCGCAAGAGACTCTTG	Negative
CCGCAAGCACATCCCT	Negative
CCGCAAGCACGGCACT	Negative
CCGCAAGCAGATCCTA	Hashtag3
CCGCAAGCATGCGTGC	Hashtag1
CCGCAAGGTTCAATCG	Hashtag1
CCGCAAGTCCATTCGC	Negative
CCGGACAAGCATCGAG	Negative
CCGGACAAGCTTTCTT	Negative
CCGGACAGTCCTGGGT	Negative
CCGGACAGTGCCCACA	Negative
CCGGACATCTATTCGT	Negative
CCGGTAGGTCCAGTTA	Negative
CCGGTAGGTTCGAAGG	Hashtag1
CCGGTAGTCAACTCTT	Negative
CCGGTAGTCTGGTTGA	Hashtag1
CCGGTGAAGATGATTG	Hashtag3
CCGGTGAAGGAACGTC	Hashtag3
CCGGTGACACCCAAGC	Negative
CCGGTGATCCTGTTGC	Negative
CCGGTGATCGAAATCC	Negative
CCGGTGATCGAACTCA	Negative
CCGGTGATCGTAGGAG	Negative
CCGTAGGCACTTGAGT	Negative
CCGTAGGGTACGGGAT	Hashtag1
CCGTAGGGTCCGTTTC	Hashtag1_Hashtag3
CCGTAGGTCTCGCGTT	Negative
CCGTGAGAGACTAGAT	Negative
CCGTGAGAGTCGAAGC	Hashtag3
CCGTGAGCAGAAGCTG	Hashtag1
CCGTGAGGTGTAAACA	Negative
CCGTGAGTCCTAGCCT	Negative
CCGTTCAAGACCGCCT	Negative
CCGTTCAAGCGCGTTC	Negative
CCGTTCACAAACACCT	Negative
CCGTTCACACCGTCGA	Negative
CCTAACCCAACTGAAA	Negative
CCTAACCCAAGGACAC	Negative
CCTAACCCACAGTGAG	Negative
CCTAACCGTATCTCTT	Negative
CCTAACCGTCATCCCT	Negative
CCTAACCGTGTAAACA	Hashtag3
CCTAACCTCATTTCGT	Negative
CCTAAGAAGACCAAGC	Negative
CCTAAGAAGGTGCCTC	Hashtag3
CCTAAGAGTCGTAATC	Hashtag1
CCTACGTAGAAGGCTC	Negative
CCTACGTAGTTTGCTG	Hashtag1
CCTACGTCAACTGCTA	Negative
CCTACGTCAGAGTTGG	Negative
CCTACGTCAGATGCGA	Negative
CCTACGTCAGCAGTTT	Hashtag1
CCTACGTCATCACGGC	Negative
CCTACGTTCGCTAGCG	Hashtag3
CCTATCGAGCACAAAT	Hashtag3
CCTATCGCACAATGAA	Hashtag1
CCTCAACAGGACTATA	Hashtag3
CCTCAACTCAACGCTA	Negative
CCTCAACTCATCTACT	Negative
CCTCACAAGGGTGAGG	Negative
CCTCACAAGGTGCAGT	Hashtag3
CCTCACAAGGTGGGTT	Negative
CCTCACAAGTCGCGAA	Hashtag3
CCTCACACACATGACT	Negative
CCTCACACAGCGTGCT	Negative
CCTCACATCTCTCAAT	Negative
CCTCAGTAGTCATCGT	Hashtag3
CCTCAGTCAGGGTTGA	Hashtag1
CCTCAGTGTCGTCATA	Hashtag3
CCTCAGTGTTATGGTC	Hashtag1
CCTCAGTTCCACAAGT	Negative
CCTCAGTTCCAGTGTA	Negative
CCTCATGAGTTCTCTT	Hashtag1
CCTCATGCAAATGCTC	Hashtag3
CCTCATGGTGTCCCTT	Hashtag1
CCTCATGTCGGCATCG	Hashtag3
CCTCCAAAGTACAACA	Negative
CCTCCAACAGGACGAT	Negative
CCTCCTCAGATCCTAC	Negative
CCTCCTCGTCCAGCGT	Negative
CCTCCTCTCGATAACC	Negative
CCTCTAGAGCCTCATA	Negative
CCTCTAGCAGCTGTTA	Hashtag3
CCTCTAGGTGGTGATG	Negative
CCTCTAGGTTACCTGA	Negative
CCTCTAGTCAGCCTCT	Hashtag3
CCTCTCCAGTCGAAAT	Hashtag1
CCTCTCCCAAGTATAG	Hashtag1
CCTCTCCGTATGGAGC	Negative
CCTCTCCGTCGGTGAA	Hashtag1
CCTCTCCGTTATCTTC	Hashtag1
CCTCTCCTCACCGACG	Hashtag3
CCTCTCCTCCGATAGT	Hashtag1
CCTGCATCACATTGTG	Hashtag3
CCTGCATTCAACCCGG	Hashtag3
CCTGTTGCATTAGGCT	Negative
CCTGTTGGTGCGACAA	Negative
CCTGTTGTCGGTTGTA	Negative
CCTTCAGAGACTACGG	Negative
CCTTCAGCACACCGCA	Negative
CCTTCAGGTCTCGGGT	Negative
CCTTCAGTCAACCCGG	Negative
CCTTGTGCAATCCTTT	Hashtag3
CCTTGTGCAGAGGGTT	Hashtag3
CCTTGTGCAGCAGGAT	Hashtag3
CCTTGTGCATCCAACA	Negative
CCTTGTGTCCATGCAA	Negative
CCTTTGGGTATTTCCT	Negative
CCTTTGGGTTGGAGAC	Negative
CCTTTGGTCGGACAAG	Negative
CGAAGGACACGTCGGT	Negative
CGAAGGAGTACCGGCT	Negative
CGAAGGATCAACGTGT	Negative
CGAAGGATCTAGTCAG	Hashtag1
CGAAGTTAGTAGCATA	Hashtag1
CGAAGTTCAACGGCTC	Negative
CGAAGTTCATCATGAC	Hashtag1
CGAAGTTGTATTCCTT	Hashtag1
CGAAGTTTCATGGTAC	Negative
CGAAGTTTCGCAGTTA	Negative
CGAATTGAGGCACCAA	Negative
CGAATTGAGGTCGTAG	Negative
CGAATTGCACAAGTTC	Hashtag3
CGAATTGGTTCGATTG	Negative
CGACAGCAGATGAAGG	Negative
CGACAGCGTTGTTGTG	Negative
CGACAGCTCAACACCA	Negative
CGACAGCTCTATTTCG	Negative
CGAGAAGAGTAGGCCA	Hashtag1
CGAGAAGCATAACAGA	Hashtag3
CGAGAAGGTGGTCTAT	Negative
CGAGAAGGTGTAACGG	Negative
CGAGAAGGTGTTAACC	Negative
CGAGAAGTCGATTTCT	Hashtag3
CGAGGAAAGCTCGACC	Negative
CGAGGAAAGTAGTCCT	Hashtag1
CGAGGAACAAATAAGC	Negative
CGAGGAACACATTCTT	Negative
CGAGGAAGTCCGTTTC	Negative
CGAGGAAGTCGAATTC	Hashtag1
CGAGGAATCAGCTTGA	Negative
CGAGGCTAGGTCGAGT	Negative
CGAGGCTCAGCTGTGC	Negative
CGAGGCTCATGGACAG	Hashtag3
CGAGGCTGTAGGGTAC	Negative
CGAGGCTTCAACTACG	Negative
CGAGGCTTCCCTCTCC	Negative
CGAGGCTTCTCTCTAA	Hashtag1
CGAGTGCAGACTGTTC	Negative
CGAGTGCAGCAACAGC	Negative
CGAGTGCAGCACGGAT	Hashtag3
CGAGTGCAGCAGGTCA	Negative
CGAGTGCAGTGTTGTC	Negative
CGAGTGCCAGTAGTGG	Hashtag1
CGAGTGCCATTCGGGC	Negative
CGAGTGCGTACTGCGC	Hashtag3
CGAGTGCGTAGCGAGT	Hashtag1
CGAGTGCGTATCGTTG	Negative
CGAGTGCTCAAAGAAC	Negative
CGAGTGCTCACAAGAA	Negative
CGAGTGCTCCATAGAC	Hashtag1
CGAGTGCTCGACCAAT	Negative
CGAGTTAAGCCGATCC	Hashtag3
CGAGTTACACAACCGC	Negative
CGAGTTAGTGAGATAT	Negative
CGAGTTATCCCTTTGG	Negative
CGATCGGGTAGGTAGC	Hashtag3
CGATCGGGTATGAGCG	Negative
CGATGCGCAGCTCGGT	Negative
CGATGCGGTACGACTT	Negative
CGATGCGTCGCCAGTG	Negative
CGATGGCAGCGATGAC	Negative
CGATGGCAGCTAGAAT	Hashtag3
CGATGGCCAAATACAG	Negative
CGATGGCGTCTTGCTC	Hashtag3
CGATGGCGTGAACTAA	Hashtag3
CGCAGGTAGGTTACAA	Hashtag1
CGCAGGTCAGCTACTA	Negative
CGCAGGTGTAGAGATT	Hashtag3
CGCATAACAGCCTTCT	Hashtag1
CGCATAAGTCGAGCTC	Negative
CGCATAAGTCTGTCCT	Negative
CGCATAATCATGAAAG	Negative
CGCATAATCCCAGCGA	Negative
CGCATAATCGACATTG	Negative
CGCATGGAGTTCATGC	Hashtag3
CGCATGGCAGGAGACT	Negative
CGCATGGCATGCCGGT	Hashtag3
CGCATGGTCCATGATG	Negative
CGCCAGAAGTGCACAG	Negative
CGCCAGATCCTCTCGA	Negative
CGCCAGATCGGTCATA	Negative
CGCCATTAGGATGAGA	Hashtag1
CGCCATTGTACCGGAA	Negative
CGCCATTGTGAATTGA	Hashtag1
CGCCATTTCTGACAGT	Negative
CGCGTGAAGACCATTC	Hashtag1
CGCGTGAAGGTAGACC	Negative
CGCGTGAAGTAAATGC	Negative
CGCGTGACACTGTCCT	Negative
CGCGTGAGTGACACGA	Negative
CGGAACCCAGGTCCCA	Negative
CGGAACCCATTGAGCT	Negative
CGGAACCGTCGCGTCA	Negative
CGGAACCTCACCATAG	Negative
CGGAACCTCTCCCATG	Hashtag1
CGGAATTAGTATCCTG	Hashtag3
CGGAATTCAAGCACCC	Hashtag1
CGGAATTCAATGGCAG	Hashtag3
CGGAATTGTCCGGTGT	Negative
CGGAATTGTGCGGCTT	Negative
CGGAATTTCGTTCGCT	Negative
CGGACACAGATACATG	Negative
CGGACACAGCACACAG	Negative
CGGACACCAAAGGGCT	Negative
CGGACACCAAAGTGTA	Negative
CGGACACCAGTGGGTA	Negative
CGGACACGTGCGAGTA	Negative
CGGACACGTTTCCAAG	Negative
CGGAGAAAGCGATCGA	Negative
CGGAGAACACTGCATA	Negative
CGGAGAAGTAAGGAGA	Negative
CGGAGAAGTTAATCGC	Hashtag3
CGGAGAATCGTCGCTT	Negative
CGGCAGTAGTGTCATC	Negative
CGGCAGTCATAACGGG	Negative
CGGCAGTGTTCCGCTT	Negative
CGGCAGTTCGCCAGAC	Negative
CGGGACTAGATGAATC	Negative
CGGGACTCACCCTATC	Negative
CGGGACTTCCTTCAGC	Negative
CGGGCATAGGAGAGTA	Negative
CGGGCATAGTCAGCGA	Hashtag3
CGGGCATCAGCGGATA	Negative
CGGGTCAAGCAACAAT	Hashtag3
CGGGTCAAGTACCCTA	Hashtag1
CGGGTCACAACCGCTG	Negative
CGGGTCACATAAGCGG	Negative
CGGGTCAGTGGCTTGC	Hashtag1
CGGGTCAGTTATTCCT	Negative
CGGGTCAGTTCCCACT	Hashtag3
CGGGTCATCAAGTGGG	Negative
CGGGTCATCACCGCTT	Negative
CGGGTCATCAGCGTCG	Hashtag3
CGGGTGTCAAGCAGGT	Negative
CGGGTGTTCACTGTCC	Negative
CGGGTGTTCGTTCATT	Negative
CGGTCAGAGGCTCAAG	Negative
CGGTCAGGTACTGGGA	Negative
CGGTCAGTCAACTTTC	Negative
CGGTCAGTCCAGCAAT	Hashtag3
CGTAAGTAGGACGGAG	Hashtag3
CGTAAGTCAAGCCTGC	Negative
CGTAAGTGTGTGAATA	Hashtag1
CGTAAGTTCAATCGGT	Negative
CGTAAGTTCCTCTTTC	Negative
CGTAATGCACTCATAG	Negative
CGTAATGCATGGCTGC	Negative
CGTAATGGTACTTGTG	Hashtag1
CGTAATGGTATCGGTT	Hashtag1
CGTAATGGTTCGAACT	Hashtag1
CGTAATGGTTCTCGTC	Hashtag1
CGTAATGTCGTTATCT	Negative
CGTAGTAAGCCACCGT	Negative
CGTAGTAAGTCTTGGT	Negative
CGTAGTAAGTTGCTCA	Negative
CGTAGTACAAGCGAAC	Negative
CGTCAAAAGCGTTCCG	Negative
CGTCAAAAGTGATAAC	Hashtag1
CGTCAAACAGCGGATA	Negative
CGTCAAACATTCACCC	Negative
CGTCAAAGTCGTGTTA	Negative
CGTCAAAGTTGGCTAT	Negative
CGTCAAATCATACGGT	Negative
CGTCAAATCGTTCCTG	Negative
CGTCCATCACGGATCC	Hashtag3
CGTCCATCAGGCTCTG	Negative
CGTCCATCATACTGAC	Hashtag1
CGTCCATTCGCGATCG	Negative
CGTGAATAGACCACGA	Negative
CGTGAATGTAGTAAGT	Negative
CGTGAATGTTCCGGTG	Negative
CGTGAATTCACGGTCG	Negative
CGTGATAAGAGGTCAC	Negative
CGTGATAAGCACGGAT	Negative
CGTGATAGTTGGCCTG	Hashtag3
CGTGATATCTTGAACG	Hashtag1
CGTGCTTAGACTGTTC	Negative
CGTGCTTCAATAACCC	Negative
CGTGCTTCAATACGAA	Negative
CGTGCTTCAGCACACC	Negative
CGTGCTTCATCGGAAG	Hashtag1
CGTGCTTTCAGTCACA	Negative
CGTGCTTTCCCTTGGT	Negative
CGTTAGACAAAGGAGA	Negative
CGTTAGACAAGACCGA	Hashtag1
CGTTAGATCACGGGAA	Negative
CGTTAGATCATACGGT	Negative
CGTTAGATCCATACTT	Hashtag3
CGTTCTGAGATGGTCG	Negative
CGTTCTGCACAGAGCA	Negative
CGTTCTGCAGGCACTC	Negative
CGTTGGGAGGACTATA	Negative
CGTTGGGCATCAGTCA	Negative
CGTTGGGGTGGTCTCG	Hashtag1
CTAACCCAGTCGCTAT	Negative
CTAACCCGTGGAATGC	Negative
CTAACCCTCAACACCA	Negative
CTAACCCTCTAGCAAC	Negative
CTAACTTCAAGACAAT	Hashtag1
CTAACTTCAGGACAGT	Negative
CTAACTTGTTCGTGCG	Negative
CTAACTTTCTGCGATA	Negative
CTAAGTGCACACCGAC	Negative
CTAAGTGTCATTGGTG	Negative
CTACAGAAGTAGCATA	Negative
CTACAGAGTTGCAACT	Hashtag1
CTACATTAGGAGGCAG	Negative
CTACATTAGGTTTGAA	Negative
CTACATTAGTCAACAA	Hashtag3
CTACATTCATAGATCC	Negative
CTACATTTCCTACCGT	Negative
CTACATTTCGGTTCAA	Negative
CTACATTTCTACCACC	Negative
CTACCCAAGATGACCG	Hashtag3
CTACCCAAGCTGAAGC	Negative
CTACCCAGTACGTTCA	Negative
CTACCCAGTTAAGGGC	Negative
CTACCCATCACATCAG	Negative
CTACCCATCCACAAGT	Negative
CTACCTGAGTAAGCAT	Negative
CTACCTGAGTCTGGTT	Hashtag3
CTACCTGCAGTCGCAC	Negative
CTACCTGGTATACCCA	Hashtag3
CTACCTGTCGCCTCTA	Negative
CTACCTGTCGCTGTCT	Negative
CTACCTGTCTCTCGAC	Hashtag3
CTACGGGAGAGACAAG	Negative
CTACGGGCACAATGTC	Negative
CTACGGGCACATCATG	Negative
CTACGGGCACTTGTCC	Negative
CTACGGGGTCCTACAA	Hashtag3
CTACGGGGTCCTGTCT	Hashtag1
CTACGGGGTGGCTGAA	Negative
CTACGGGTCAGTGTCA	Negative
CTACGGGTCGAATGCT	Negative
CTACGGGTCTCGTCAC	Hashtag3
CTACTATAGATGACAT	Negative
CTACTATAGGGTACGT	Negative
CTACTATGTTCTAACG	Negative
CTAGACAGTGGATTTC	Hashtag1
CTAGACATCGACGACC	Hashtag3
CTAGGTACACCTCGTT	Negative
CTAGGTACATACAGCT	Hashtag3
CTAGGTAGTTGGGTTT	Negative
CTATAGGCAAGAATAC	Negative
CTATCCGAGCCGAATG	Hashtag3
CTATCCGAGTCTAGCT	Negative
CTATCCGCAGTTCCAA	Negative
CTATCCGGTAGGCAGT	Negative
CTATCCGTCTTCGGAA	Hashtag1
CTATCTAAGCTCGGCT	Negative
CTATCTAAGGTAGCAC	Negative
CTATCTAGTACGCTAT	Negative
CTATCTAGTGCGCTCA	Negative
CTATCTAGTGGTCAAG	Hashtag3
CTATCTAGTTCCACGG	Hashtag3
CTATCTATCGGTCACG	Negative
CTCAACCAGAACTGAT	Negative
CTCAACCCACGAGAAC	Negative
CTCAACCTCTCGCTTG	Negative
CTCAACCTCTGTAACG	Negative
CTCAAGAAGGGTTTCT	Negative
CTCAAGAAGTGAATAC	Negative
CTCAAGAGTGGCTTGC	Negative
CTCAATTAGCTGTGCC	Hashtag3
CTCAATTCAGGCTACC	Negative
CTCAATTCATAATGCC	Negative
CTCAATTCATGGCTAT	Negative
CTCAATTTCGAGTTGT	Hashtag3
CTCACTGAGTTGAATG	Hashtag3
CTCACTGCAACTTGGT	Hashtag3
CTCACTGCACACCGAC	Hashtag3
CTCACTGTCTTGGAAC	Hashtag1
CTCAGAAAGGTTCCAT	Negative
CTCAGAACAATACGAA	Negative
CTCAGAAGTCATACCA	Negative
CTCAGAATCAATCGGT	Negative
CTCAGGGAGCCAACCC	Hashtag3
CTCAGGGCAATATCCG	Hashtag3
CTCAGTCAGATCCCAT	Hashtag1
CTCAGTCCAGCTGTGC	Hashtag1
CTCATCGAGTCAGAGC	Hashtag1
CTCATCGCAGCAATTC	Negative
CTCATCGTCGCTTACC	Negative
CTCATGCGTCAGATTC	Hashtag1
CTCATGCTCGGTCGAC	Negative
CTCATGCTCTCCTGAC	Negative
CTCATTAAGGAGTATT	Negative
CTCATTACAGGTCAGA	Hashtag3
CTCATTACATCGCTCT	Negative
CTCATTAGTATGGAGC	Hashtag1_Hashtag3
CTCATTAGTCCGTACG	Negative
CTCATTATCCGATGTA	Negative
CTCCAACAGAGTAACT	Negative
CTCCAACCAACTTCTT	Negative
CTCCAACGTACCCAGC	Negative
CTCCAACGTCGCACAC	Hashtag3
CTCCACAGTCCCACGA	Negative
CTCCACAGTTCAAGTC	Negative
CTCCACATCCAGGACC	Negative
CTCCACATCTACCCAC	Negative
CTCCATGAGGAGAGTA	Negative
CTCCATGAGTCCTGTA	Hashtag3
CTCCATGGTATCGTTG	Hashtag3
CTCCCAAGTACAGAGC	Negative
CTCCCAAGTATCACGT	Hashtag3
CTCCCAATCGATACGT	Negative
CTCCCAATCGTTGCCT	Hashtag3
CTCCCTCAGCATCGAG	Negative
CTCCCTCAGCTCAGAG	Negative
CTCCCTCAGGCACCAA	Negative
CTCCCTCAGTGCCTCG	Negative
CTCCCTCGTACTGCCG	Negative
CTCCCTCGTATCGTGT	Negative
CTCCCTCGTCCTCCAT	Negative
CTCCGATGTCTTGCTC	Negative
CTCCGATGTGATATAG	Negative
CTCCTCCCACAACGCC	Hashtag1
CTCCTCCGTAACAAGT	Negative
CTCCTTTAGTGGAAAG	Hashtag1
CTCCTTTGTGGACTAG	Negative
CTCCTTTTCACAGAGG	Negative
CTCCTTTTCCAGTGTA	Negative
CTCCTTTTCCGCCTAT	Negative
CTCCTTTTCTTCGATT	Negative
CTCGAGGAGATAACAC	Negative
CTCGAGGCACCTAAAC	Negative
CTCGAGGTCGAGAATA	Negative
CTCTCAGAGAGGATCC	Hashtag3
CTCTCAGGTCTGCATA	Hashtag3
CTCTCGAAGCGGGTAT	Hashtag3
CTCTCGAAGTCCGCCA	Negative
CTCTCGAGTACCTGTA	Negative
CTCTCGAGTAGAGATT	Hashtag1
CTCTCGAGTAGCGATG	Negative
CTCTCGAGTTTACTGG	Negative
CTCTGGTGTTCTATCT	Hashtag1
CTCTGGTTCGCCAATA	Hashtag3
CTCTGGTTCTCGCTCA	Negative
CTGAATGAGTAGGAAG	Hashtag3
CTGAATGCACCCTTGT	Negative
CTGAATGCAGCATACT	Hashtag3
CTGAATGGTCGGCACT	Negative
CTGAATGGTGTTACTG	Negative
CTGAATGTCCACATAG	Negative
CTGAATGTCTTGGGCG	Hashtag3
CTGAGCGAGAACCGCA	Negative
CTGAGCGCACTTGACA	Hashtag3
CTGAGCGCATTAGGAA	Negative
CTGAGCGGTAACATCC	Negative
CTGAGCGGTCACCCTT	Hashtag3
CTGAGGCAGACGACGT	Negative
CTGAGGCCATAGGTAA	Negative
CTGATCCAGATAGTCA	Hashtag3
CTGATCCAGCGTCTGC	Negative
CTGATCCAGGTAGACC	Negative
CTGATCCGTAGTGCGA	Hashtag1
CTGATCCTCCATCTAT	Negative
CTGCAGGAGTCTAGCT	Negative
CTGCAGGGTGAGACCA	Negative
CTGCAGGTCCGACAGC	Negative
CTGCATCCAGCTCATA	Negative
CTGCATCGTGGCAACA	Hashtag3
CTGCATCTCCGAGATT	Hashtag1
CTGCCATAGTGCTCGC	Hashtag3
CTGCCATCACGTAGAG	Hashtag3
CTGCCATGTGTCGATT	Negative
CTGCCTAAGGTTCAGG	Hashtag1
CTGCCTAAGTAGATCA	Hashtag1
CTGCCTACAACAAGAT	Negative
CTGCCTACAATTCGTG	Negative
CTGCCTAGTACTGAGG	Hashtag1_Hashtag3
CTGCCTATCCTAGCGG	Negative
CTGCGAGAGAGTCTGG	Negative
CTGCGAGCACGAGAAC	Negative
CTGCGAGGTTCGTAAC	Negative
CTGCTCAAGAATAGTC	Negative
CTGCTCAAGCGCCTTG	Negative
CTGCTCACATTGAAGA	Negative
CTGCTCAGTCCCTGTT	Negative
CTGCTCATCAGGAAGC	Negative
CTGCTCATCGGCTGTG	Hashtag3
CTGGACGAGACCATGG	Negative
CTGGACGCAATTGGTC	Hashtag1
CTGGACGCACCACATA	Negative
CTGGACGCACGCGTGT	Negative
CTGGACGCAGAGGTAC	Negative
CTGGACGGTGGTAATA	Negative
CTGGACGTCAAGTTGC	Hashtag3
CTGGACGTCCCTTTGG	Negative
CTGGACGTCTCAAAGC	Hashtag1
CTGGCAGAGTTACGTC	Negative
CTGGCAGCAAACCGGA	Negative
CTGGCAGCACAACATC	Hashtag3
CTGGCAGCACCTGAAT	Negative
CTGGCAGCACGGCACT	Hashtag3
CTGGCAGCAGGATCTT	Negative
CTGGCAGCATGCAGGA	Negative
CTGGCAGGTTCGGTTA	Negative
CTGGCAGTCGTTACCC	Hashtag1
CTGGTCTAGCGCTGCT	Negative
CTGGTCTAGTCCCAAT	Hashtag3
CTGGTCTCACATGAAA	Negative
CTGGTCTTCTCCTACG	Hashtag1
CTGTACCAGTAGGTTA	Hashtag1
CTGTACCCATTGAGGG	Negative
CTGTACCTCACCATCC	Negative
CTGTAGAAGAGCTTTC	Hashtag3
CTGTAGACAGAAGCGT	Negative
CTGTAGATCCGTTGGG	Negative
CTGTAGATCGCGCTGA	Negative
CTGTATTAGCATCAGG	Negative
CTGTATTAGCTAAGTA	Negative
CTGTATTCAGGGATAC	Negative
CTGTATTGTGTAAATG	Negative
CTGTATTTCACGAACT	Negative
CTGTATTTCCTGATAG	Negative
CTGTATTTCGGAGTGA	Negative
CTGTCGTAGATAGCAT	Negative
CTGTCGTCAGCGTGCT	Hashtag3
CTGTCGTGTCAAATCC	Negative
CTGTCGTTCATGACAC	Negative
CTGTCGTTCGTAGCTA	Negative
CTGTGAACAGCCATTA	Negative
CTGTGAACATCGCTAA	Negative
CTGTGAACATGGAAGC	Negative
CTGTGAAGTACAGGTG	Hashtag3
CTGTGAAGTGTTCGAT	Hashtag3
CTGTGAATCCGACATA	Negative
CTGTGAATCTAAGCCA	Negative
CTGTGGGCAACACACT	Negative
CTGTGGGCACATGTTG	Hashtag1
CTGTGGGGTAGGACTG	Negative
CTGTGGGGTATCATGC	Hashtag1
CTGTGGGGTTGCGAAG	Negative
CTGTGGGTCGCGCCAA	Negative
CTTACCGAGCGATGGT	Negative
CTTACCGAGTCAGAGC	Negative
CTTACCGAGTTCCAGT	Negative
CTTAGGACATCGCTAA	Negative
CTTAGGAGTTCGGACC	Negative
CTTAGGATCAAAGCCT	Hashtag1
CTTCAATAGCGTGCCT	Hashtag1
CTTCAATCAATGGCAG	Negative
CTTCAATCACTGAATC	Negative
CTTCAATCACTGCACG	Negative
CTTCAATCATACTGTG	Negative
CTTCAATGTCTGTGGC	Hashtag3
CTTCAATTCGAAACAA	Negative
CTTCAATTCTGTCGCT	Negative
CTTCCGAAGCGACTTT	Hashtag1
CTTCCGAAGTAATCCC	Negative
CTTCCGACAGTACTAC	Negative
CTTCCGAGTCGTCGGT	Negative
CTTCCGAGTGAATATG	Negative
CTTCCGAGTGTTAAAG	Negative
CTTCCTTAGGTCGACA	Hashtag3
CTTCCTTAGTTATGGA	Hashtag3
CTTCCTTCATGTGACT	Negative
CTTCCTTGTTGGGACA	Hashtag3
CTTCGGTCACTTCTCG	Negative
CTTCGGTTCCGATGTA	Hashtag3
CTTCGGTTCGCACTCT	Hashtag1
CTTCTAAAGATAGCTA	Negative
CTTCTAAGTTCGTAAC	Hashtag3
CTTCTCTCAGTGGTGA	Negative
CTTCTCTCATCTGCGG	Hashtag1
CTTCTCTGTGATGGCA	Negative
CTTGAGAAGCACTCTA	Negative
CTTGAGAAGGCGTTGA	Hashtag3
CTTGAGAGTACGATGG	Hashtag3
CTTGAGAGTCAGTCTA	Negative
CTTGATTAGGAGACCT	Negative
CTTGATTCATTCTGTT	Negative
CTTGATTGTGTATCCA	Hashtag1
CTTTCAAAGCCTGAGA	Negative
CTTTCAAGTGATAGAT	Hashtag1_Hashtag3
CTTTCAATCCACTGGG	Negative
CTTTCGGAGTTAACGA	Hashtag1
CTTTCGGAGTTCCGTA	Negative
CTTTCGGGTTTCACTT	Negative
GAAACCTAGCCATGCC	Negative
GAAACCTAGGCTCAAG	Negative
GAAACCTAGTACCATC	Negative
GAAACCTAGTTCCGGC	Hashtag1
GAAACCTCAACTGATC	Hashtag1
GAAATGAGTGGCAGAT	Negative
GAAATGATCACATTGG	Negative
GAAATGATCCATACTT	Hashtag3
GAAATGATCGCATAGT	Hashtag3
GAACACTAGCAGGGAG	Negative
GAACACTCATAAGCAA	Negative
GAACACTGTGGAGAAA	Hashtag1
GAACGTTCAGCATGCC	Hashtag3
GAACGTTGTCCCGGTA	Negative
GAACGTTTCGGAGCAA	Negative
GAACGTTTCTACTGAG	Negative
GAACTGTCAAGAATAC	Negative
GAACTGTCAGATACCT	Hashtag3
GAACTGTCATCGATAC	Negative
GAACTGTCATTATGCG	Negative
GAACTGTGTTGCATGT	Negative
GAACTGTTCGTTACCC	Negative
GAAGAATCAAGCACCC	Negative
GAAGCCCAGCATCAAA	Hashtag3
GAAGCCCCATATACCG	Negative
GAAGCCCGTATGAGGC	Hashtag1
GAAGCCCTCTTAGCAG	Negative
GAAGCGAAGCTTGTGT	Hashtag3
GAAGCGACAAAGGAGA	Hashtag3
GAAGCGATCACTGAAC	Negative
GAAGGACAGCCTGACC	Negative
GAAGGACAGGCTAGCA	Negative
GAAGGACCAGTGGCTC	Hashtag1
GAAGGACCATTATGCG	Negative
GAAGGACGTTGCGAAG	Negative
GAAGGGTAGAGGTTAT	Negative
GAAGGGTAGGATCACG	Negative
GAAGGGTAGGCACCAA	Hashtag1
GAAGGGTGTACTCAAC	Hashtag3
GAAGGGTGTCTTCATT	Negative
GAAGGGTGTCTTTATC	Negative
GAAGGGTGTTCTCCTG	Negative
GAAGGGTTCGGTTCAA	Hashtag3
GAAGTAAAGTCGGCCT	Negative
GAAGTAAGTCGCACGT	Hashtag3
GAAGTAAGTTCAGTAC	Negative
GAAGTAAGTTCCGCGA	Negative
GAAGTAATCGGTAGGA	Negative
GAATAGAAGCTCAGAG	Negative
GAATAGAAGGGCCTCT	Negative
GAATAGACATCGATGT	Negative
GAATAGATCCATTGCC	Negative
GAATAGATCGCCAATA	Negative
GAATCGTAGCCTCGTG	Negative
GAATCGTAGTCGCGAA	Negative
GAATCGTAGTGCGACA	Negative
GAATCGTTCAAACGAA	Negative
GAATCGTTCCTACTGC	Negative
GAATCGTTCGTCGATA	Negative
GACACGCAGCTCGACC	Hashtag3
GACACGCAGGAAGAAC	Negative
GACACGCCACGACGTC	Negative
GACAGCCAGCGACTAG	Negative
GACAGCCCACGGTCTG	Negative
GACAGCCTCCAATCTT	Negative
GACAGCCTCCGTAGTA	Negative
GACATCAAGCAAGTCG	Hashtag1
GACATCATCCAGCAAT	Hashtag3
GACATCATCCTTGACC	Negative
GACCAATCAAAGGCTG	Negative
GACCAATCAAGGGCAT	Hashtag3
GACCAATTCCTCTGCA	Hashtag3
GACCCAGAGGGCGAGA	Hashtag1
GACCCAGGTGCAAGAC	Hashtag1
GACCCAGTCACATTGG	Negative
GACCCAGTCCTTCACG	Hashtag1
GACCCAGTCGATTTCT	Hashtag3
GACCCAGTCTATCGCC	Negative
GACCCTTCACAGCCAC	Negative
GACCCTTGTCTAGTGT	Hashtag1
GACCCTTGTGATACCT	Negative
GACCGTGAGTAAGCAT	Negative
GACCGTGCAAGCTGTT	Negative
GACCGTGGTAGCCAGA	Negative
GACCGTGGTTGGAGAC	Negative
GACCGTGTCATAGCAC	Hashtag3
GACCGTGTCTGAGGTT	Negative
GACCTTCAGTTTGAGA	Negative
GACCTTCCAGTCCGTG	Negative
GACCTTCCATACACCA	Negative
GACCTTCCATTGTGCA	Negative
GACGTTACAAAGGCTG	Negative
GACGTTACAGAACATA	Negative
GACGTTAGTCAGTCTA	Hashtag1
GACGTTAGTCCTGAAT	Hashtag3
GACTATGCAATTGAAG	Hashtag3
GACTATGCACAAGTGG	Negative
GACTATGCACCACTGG	Negative
GACTATGTCAATGCAC	Negative
GACTATGTCATGCGGC	Hashtag1
GACTCAAAGGTCCGAA	Negative
GACTCAACACCCTAGG	Negative
GACTCAACAGATTTCG	Negative
GACTCAAGTGTTAAAG	Hashtag3
GACTCAATCTTGTGCC	Hashtag3
GACTCTCTCCAAGAGG	Negative
GACTGATCACAGACGA	Hashtag3
GACTGATGTAAGACCG	Negative
GACTGATGTCTAGATC	Hashtag1
GACTGATTCAAGCCTA	Negative
GACTGATTCTAGTGTG	Hashtag3
GACTGATTCTGTCAGA	Hashtag3
GACTGATTCTTGCAAG	Negative
GACTTCCCACTAACCA	Negative
GACTTCCGTCGCTGCA	Negative
GACTTCCGTCGGTGTC	Negative
GACTTCCTCTGCATGA	Hashtag3
GAGAAATAGAATCCCT	Negative
GAGAAATAGAGTACCG	Negative
GAGAAATAGCAGATAT	Negative
GAGAAATAGCCAAGCA	Hashtag1
GAGAAATAGGAAAGGT	Negative
GAGAAATCAAAGCACG	Hashtag3
GAGAAATGTAGCGTAG	Negative
GAGAAATGTCCGTTTC	Negative
GAGAAATTCGACTCCT	Hashtag3
GAGAAATTCTAGCATG	Hashtag3
GAGACCCAGAAAGTCT	Hashtag1
GAGACCCAGTCTACCA	Negative
GAGACCCAGTTTGAGA	Hashtag1
GAGACCCCAACAGCTT	Negative
GAGACCCCACCATAAC	Hashtag3
GAGACCCCAGACTCTA	Hashtag3
GAGACCCGTCTGTGTA	Negative
GAGACCCGTGACCTGC	Hashtag1
GAGACCCTCGAACGGA	Hashtag3
GAGACCCTCTTTCTAG	Negative
GAGACTTAGTAGAGTT	Hashtag3
GAGACTTAGTTCCATG	Negative
GAGACTTCAAGCCTGC	Hashtag1
GAGACTTCAGAAGTTA	Hashtag3
GAGACTTGTAACTTCG	Negative
GAGACTTGTACTTGTG	Hashtag3
GAGACTTGTCAGTCGC	Negative
GAGACTTGTCCAAGAG	Negative
GAGACTTGTGGCACTC	Hashtag3
GAGACTTGTTCTCTCG	Negative
GAGAGGTCAGCTCGGT	Negative
GAGAGGTCAGCTTTGA	Negative
GAGAGGTGTATGCTTG	Negative
GAGAGGTTCATGCCGG	Negative
GAGATGGCATACGCAT	Hashtag1
GAGATGGTCAAAGGTA	Negative
GAGCCTGAGTTACGTC	Hashtag3
GAGCCTGAGTTGCCTA	Hashtag3
GAGCTGCAGAAGTCAT	Negative
GAGCTGCAGGTAGCCA	Negative
GAGCTGCAGTTGCGAG	Hashtag1
GAGCTGCCACCCTAAA	Hashtag3
GAGCTGCTCCTCACCA	Negative
GAGCTGCTCGATCCAA	Hashtag1_Hashtag3
GAGCTGCTCTTCGTAT	Hashtag1
GAGGCAAAGCTATCTG	Negative
GAGGCAAGTCGTCAGC	Negative
GAGGCAATCTATTCGT	Negative
GAGGCCTAGCGATGGT	Negative
GAGGCCTAGCTAAATG	Negative
GAGGCCTAGGGCAACT	Negative
GAGGCCTCAAAGGGTC	Negative
GAGGCCTGTCGTCTCT	Hashtag1_Hashtag3
GAGGCCTGTTAGGCTT	Hashtag3
GAGGGATAGACTCCGC	Negative
GAGGGATCATAACTCG	Negative
GAGGGATCATCTTAGG	Negative
GAGGGATGTACGACAG	Negative
GAGGGTAAGACATACA	Hashtag1
GAGGGTAAGTGCACCC	Hashtag1_Hashtag3
GAGGGTACAAATAGCA	Negative
GAGGGTATCAGAGTTC	Negative
GAGGGTATCGGACTTA	Negative
GAGTCATCAGAGTCTT	Negative
GAGTCATCAGTCAGTT	Hashtag1
GAGTCATTCCTATTGT	Negative
GAGTCTAAGCACACCC	Negative
GAGTCTAAGGATTCAA	Negative
GAGTCTAGTAGAGTTA	Negative
GAGTGAGCAGAACCGA	Negative
GAGTGAGTCACCTCTG	Negative
GAGTGAGTCCTGTTAT	Hashtag1
GAGTGTTCAGTAGAAT	Negative
GAGTGTTGTCTGTGGC	Negative
GAGTGTTTCTCAGAAC	Negative
GAGTTACAGTCACGCC	Negative
GAGTTACCACATTACG	Hashtag1
GAGTTACGTACCTAGT	Negative
GAGTTACGTTGTGTAC	Hashtag1
GAGTTACTCCGTGGGT	Negative
GAGTTGTCATGACCCG	Hashtag1
GAGTTGTGTAGGAGTC	Negative
GAGTTGTGTTTCACTT	Negative
GAGTTGTTCCTTGGAA	Negative
GAGTTGTTCTACACTT	Negative
GAGTTGTTCTCATTTG	Hashtag1
GATAGAAAGTGAATAC	Negative
GATAGAAGTGGTAATA	Negative
GATAGAATCGAGAAGC	Negative
GATAGCTAGAAGAACG	Hashtag3
GATAGCTCACCCTGAG	Hashtag3
GATAGCTGTCCATAGT	Hashtag1
GATAGCTTCGCCTCTA	Negative
GATCACAAGAGTCTGG	Negative
GATCACAAGCATTGAA	Hashtag3
GATCACAAGGCCACTC	Negative
GATCACACAACCGACC	Negative
GATCACACACCCAACG	Negative
GATCACACACGACAAG	Negative
GATCACAGTACCGTGC	Negative
GATCAGTGTTTGAAAG	Negative
GATCAGTTCGTTCTGC	Negative
GATCATGAGACTACCT	Hashtag1
GATCATGAGCACGGAT	Negative
GATCATGAGGGATCGT	Hashtag3
GATCATGCACGAAAGC	Negative
GATCATGGTATCGTAC	Hashtag3
GATCATGTCCTGTAGA	Negative
GATCCCTCAGGGTCTC	Hashtag3
GATCCCTTCTACTCAT	Hashtag3
GATCCCTTCTTGGCTC	Negative
GATCGTAAGCAGCCTC	Hashtag1
GATCGTACAAACTCGT	Negative
GATCGTAGTCACTTAG	Hashtag1
GATCGTAGTTCTTGTT	Negative
GATCGTATCGCTCATC	Hashtag1
GATCGTATCGGTAAGG	Negative
GATGACTAGAGGGTAA	Negative
GATGACTAGGCACTAG	Negative
GATGACTCAATCCTTT	Negative
GATGAGGAGGATACGC	Negative
GATGAGGCAACCGATT	Negative
GATGAGGCAGGAGGTT	Negative
GATGAGGTCTGGCCTT	Negative
GATGATCAGCCTGAGA	Hashtag1
GATGATCCAAGCACAG	Negative
GATGATCCATACATCG	Hashtag1
GATGATCGTAACACCT	Hashtag1
GATGATCGTATGAGAT	Hashtag1
GATGATCGTTAGAGTA	Hashtag3
GATGCTAAGGGACCAT	Negative
GATGCTACACCTGAAT	Negative
GATGCTAGTAAGCGGT	Negative
GATGCTAGTAATTGGA	Negative
GATGCTAGTTTCAGAC	Hashtag1
GATGGAGAGATACATG	Hashtag1
GATGGAGGTTGTACGT	Hashtag3
GATGGAGTCCTCACCA	Negative
GATGTTGGTAAGGCTG	Negative
GATTCGAAGACTAGAT	Hashtag3
GATTCGATCCACCTCA	Negative
GATTCGATCCTTTAGT	Negative
GATTCTTCACCTCTGT	Hashtag1
GATTCTTCAGCACAAG	Negative
GATTCTTTCGGAGTAG	Negative
GATTCTTTCTCTCGCA	Negative
GATTGGTAGAAGCTGC	Hashtag3
GATTGGTAGCCTTGAT	Negative
GATTGGTCAAGAGGTC	Hashtag1_Hashtag3
GATTGGTTCAATCGGT	Negative
GCAACATTCAACTGGT	Negative
GCAACCGAGCATTTCG	Negative
GCAACCGAGTTGGCTT	Hashtag3
GCAACCGGTCGTGGAA	Negative
GCAACCGGTGACGCCT	Hashtag3
GCACATACAGAGTCTT	Negative
GCACATATCACTGCTC	Hashtag3
GCACATATCCATCTCG	Hashtag1
GCACGGTAGAGCGACT	Negative
GCACGGTGTAATGCGG	Negative
GCACGGTGTCGGTGTC	Hashtag1
GCACGGTTCGCGTTTC	Negative
GCACGGTTCGGTGAAG	Negative
GCACGGTTCTTCTGTA	Negative
GCACGTGAGCTCGACC	Negative
GCACGTGCAACCGGAA	Negative
GCACGTGCACACCGAC	Negative
GCACGTGGTAGACAAT	Negative
GCACGTGGTATGATCC	Hashtag1
GCACGTGGTATGCTTG	Hashtag3
GCACGTGTCAACTACG	Hashtag3
GCACTAAAGCGGATCA	Negative
GCACTAACACCGTACG	Negative
GCACTAATCAAACGTC	Negative
GCACTAATCACCTACC	Negative
GCAGCCAAGACAGTCG	Hashtag3
GCAGCCAGTACTCCGG	Negative
GCAGCCATCTCAATCT	Negative
GCAGCTGGTATCGTTG	Hashtag1
GCAGCTGTCTCGCTCA	Negative
GCAGGCTAGTTCCGTA	Negative
GCAGGCTGTCGCTTGG	Negative
GCAGGCTGTGAGACCA	Negative
GCAGGCTGTGTGACCC	Negative
GCAGTTAAGGTGGGTT	Negative
GCAGTTAGTCTTCAAG	Negative
GCAGTTAGTGGGAGAG	Negative
GCATCGGCACGTTGGC	Negative
GCATCGGGTAACCCTA	Negative
GCATCGGGTGGTCTGC	Hashtag3
GCATCTCAGCATGGGT	Negative
GCATCTCTCTTGAACG	Negative
GCATGATCAAAGCAAT	Negative
GCATGATCACATTCTT	Hashtag3
GCATGATCACGTGAGA	Hashtag1
GCATGATCAGAGGTAC	Hashtag3
GCATGATGTGACCGAA	Negative
GCATGATGTTAAGACA	Negative
GCATGATTCGCTCTAC	Negative
GCATTAGAGACATAAC	Negative
GCATTAGAGCTGAGTG	Hashtag3
GCATTAGCAGTTAAAG	Negative
GCATTAGGTTTGCAGT	Negative
GCATTAGTCATGGGAG	Hashtag1
GCATTAGTCCACACAA	Negative
GCATTAGTCCATTGTT	Hashtag1_Hashtag3
GCATTAGTCTAAGCGT	Negative
GCATTAGTCTCACTCG	Hashtag3
GCCAACGAGTAACCGG	Negative
GCCAACGCACTGAGTT	Negative
GCCAACGCAGGATTCT	Negative
GCCAACGGTGAGATAT	Negative
GCCAGCAGTCAGTCGC	Negative
GCCAGGTAGACCATAA	Negative
GCCAGGTAGGTCATTC	Negative
GCCAGGTGTAAGATTG	Negative
GCCAGGTTCAGACCGC	Negative
GCCAGGTTCCATTTCA	Hashtag3
GCCAGTGCACTCTCGT	Negative
GCCAGTGTCGGAGCAA	Negative
GCCATGGAGACCGCCT	Negative
GCCATGGAGATGGGCT	Negative
GCCATGGAGGACCCAA	Negative
GCCATGGCAACGGCCT	Hashtag1
GCCATGGCAGCCTACG	Negative
GCCATGGCATGGAAGC	Negative
GCCATGGTCACACGAT	Hashtag3
GCCATGGTCGGATAAA	Hashtag3
GCCATGGTCGTTCTGC	Negative
GCCATTCAGAATTTGG	Negative
GCCATTCCATAACTCG	Hashtag3
GCCATTCGTAACTAAG	Hashtag1_Hashtag3
GCCATTCGTAGTCGTT	Hashtag3
GCCATTCTCTAACACG	Hashtag1
GCCATTCTCTTACCAT	Negative
GCCCAGAAGCTGACTT	Hashtag3
GCCCAGAGTCATAACC	Negative
GCCCAGATCGTGACTA	Negative
GCCCGAAAGAATTGTG	Negative
GCCCGAAAGATTAGTG	Hashtag1
GCCCGAACAACTTGGT	Negative
GCCCGAACACCACTGG	Hashtag1
GCCCGAATCGGCTCTT	Negative
GCCCGAATCTTCGGTC	Negative
GCCGATGCAAGGCCTC	Negative
GCCGATGCAGATACCT	Hashtag3
GCCGATGCAGCAGGAT	Negative
GCCGATGCAGCGCTTG	Negative
GCCGATGGTGTCATCA	Hashtag1
GCCGATGGTGTTTACG	Negative
GCCGATGGTTCAGGTT	Negative
GCCGTGAGTCGCACAC	Hashtag1
GCCTGTTTCTAACGGT	Negative
GCGAGAAAGAGAACCC	Hashtag1
GCGAGAAAGTGACACG	Negative
GCGAGAAGTATCTCGA	Hashtag1
GCGAGAATCACGATCA	Negative
GCGAGAATCCCTTTGG	Negative
GCGATCGAGGGCCCTT	Negative
GCGATCGCAGTAGAGC	Hashtag3
GCGATCGGTAAGAACT	Negative
GCGATCGGTCTACGAT	Negative
GCGATCGGTTTGTTCT	Hashtag1
GCGATCGTCATGAGTC	Negative
GCGGAAACATTGCCTC	Negative
GCGGAAATCTCAACCC	Negative
GCGGATCAGAGCAGTC	Negative
GCGGATCCAACACGAG	Hashtag3
GCGGATCGTACGATGG	Hashtag3
GCGGATCTCGCCAGTG	Hashtag3
GCGTGCATCAGCGGAA	Negative
GCGTGCATCTGACAGT	Negative
GCGTTTCGTACTCGCG	Negative
GCGTTTCGTATACGGG	Negative
GCGTTTCGTTTCCATT	Negative
GCTACAAAGAGCTGAC	Negative
GCTACAAAGCTTCGTA	Negative
GCTACAAGTAGTCACT	Negative
GCTACAAGTATAGGAT	Negative
GCTACAAGTTGTAAAG	Hashtag3
GCTACAATCCTCTAAT	Negative
GCTACCTAGACTGGGT	Hashtag1
GCTACCTCATGCCGAC	Negative
GCTACCTGTGGACCAA	Negative
GCTACCTTCCGCAGTG	Negative
GCTCAAACAATTGTGC	Negative
GCTCAAAGTCTACACA	Negative
GCTCAAATCCTGATAG	Negative
GCTCAAATCGCGATCG	Negative
GCTGAATGTACTTGTG	Hashtag1
GCTGCAGAGACGTCGA	Negative
GCTGCAGAGTATGCAA	Hashtag1
GCTGCAGCACTGTGTA	Negative
GCTGCAGCAGCAATTC	Hashtag3
GCTGCAGGTATGGTTC	Negative
GCTGCAGGTGGTCCGT	Negative
GCTGCAGGTTAGGGTG	Negative
GCTGCAGTCTCATGGA	Hashtag3
GCTGCAGTCTGAGGCC	Negative
GCTGGGTAGCTGACAG	Negative
GCTGGGTAGGGACCAT	Negative
GCTGGGTCACGCGGTT	Negative
GCTGGGTCATCATTTC	Negative
GCTGGGTGTGCAGATG	Negative
GCTGGGTTCACGAACT	Negative
GCTGGGTTCGCCAATA	Negative
GCTTCACTCGGCTGGT	Negative
GCTTGGGCAAGCACCC	Negative
GCTTGGGCAAGCGCAA	Negative
GCTTGGGCACATACGT	Hashtag1
GCTTGGGCACTATCGA	Negative
GCTTGGGCAGGCTATT	Hashtag3
GCTTGGGGTAGCTCGC	Negative
GCTTTCGAGGGTCACA	Hashtag3
GCTTTCGCAATACGAA	Negative
GCTTTCGGTCGACGCT	Hashtag3
GGAACCCCACCTGTCT	Negative
GGAACCCTCATCAGTG	Negative
GGAAGTGAGCATGATA	Negative
GGAAGTGGTAATACCC	Hashtag3
GGAAGTGGTTAGTCGT	Negative
GGAAGTGTCATACGGT	Hashtag3
GGAAGTGTCATTTGGG	Negative
GGAAGTGTCTCTTGCG	Negative
GGAAGTGTCTGACCCT	Negative
GGAATCTAGAAGTCAT	Negative
GGAATCTAGTTCATCG	Negative
GGAATCTTCAAACCTG	Hashtag1
GGAATGGAGCTTAGTC	Negative
GGAATGGCAAGGTTGG	Negative
GGAATGGGTACGCTTA	Negative
GGAATGGGTATTGGCT	Hashtag3
GGAATGGGTCACATTG	Negative
GGAATGGGTGTGTCCG	Negative
GGAATGGTCAATCCGA	Negative
GGAATGGTCTTCTCAA	Hashtag1
GGACGTCAGGAGATAG	Negative
GGAGAACAGACTTGTC	Negative
GGAGAACAGGTAAGAG	Negative
GGAGAACAGTAAAGCT	Hashtag3
GGAGAACAGTTATGGA	Negative
GGAGAACGTGCAATGG	Hashtag1
GGAGAACGTTACACAC	Hashtag3
GGAGAACTCCTCTCTT	Hashtag1
GGAGATGAGAACTCCT	Hashtag1
GGAGATGAGTAAGCAT	Negative
GGAGATGCAAGAGTGC	Negative
GGAGATGGTAGTCTTG	Hashtag1
GGAGATGTCACAAGAA	Negative
GGAGATGTCGAAGAAT	Hashtag3
GGAGATGTCGCCAATA	Negative
GGAGATGTCGCCCAGA	Hashtag3
GGAGCAAAGTGTCATC	Negative
GGAGCAACATAGATGA	Negative
GGAGGATAGACATATG	Negative
GGAGGATAGGCAATGC	Negative
GGAGGATCACATCCCT	Negative
GGAGGATGTCATAGTC	Negative
GGAGGATTCCGCATAA	Hashtag3
GGAGGTAAGGGCTAAC	Hashtag3
GGAGGTAAGTGCACTT	Hashtag1_Hashtag3
GGAGGTAAGTTCCGTA	Hashtag1
GGAGGTAGTGTTTACG	Negative
GGAGGTAGTTGTCTAG	Negative
GGAGGTATCCTTCAGC	Negative
GGAGGTATCGAGTCTA	Negative
GGAGGTATCGATTGAC	Hashtag1
GGATCTAAGTCATGGG	Hashtag1
GGATCTACAACTGGTT	Negative
GGATCTACAATCGCCG	Negative
GGATCTATCGAGCCAC	Hashtag1
GGATCTATCTTAGGAC	Negative
GGATGTTAGATCACCT	Hashtag3
GGATGTTCATTCTCTA	Negative
GGCACGTAGTCTGGAG	Negative
GGCACGTCAAGACGAC	Negative
GGCACGTGTCCTGGGT	Negative
GGCACGTTCAGACTGT	Negative
GGCAGTCAGAGACAAG	Negative
GGCAGTCAGGCAGCTA	Hashtag3
GGCAGTCAGTGCCGAA	Negative
GGCAGTCCATGACAGG	Negative
GGCAGTCTCTCGTGGG	Negative
GGCGTCAAGGTGCATG	Negative
GGCGTCAAGTGGCGAT	Negative
GGCGTCAGTACCCAGC	Negative
GGCGTCAGTCAGACGA	Negative
GGCGTCATCTAGTTCT	Hashtag1
GGCTGTGCAGCGGTTC	Negative
GGCTGTGGTGGTTTAC	Negative
GGCTGTGTCAACCTCC	Negative
GGCTTGGAGAGCAGTC	Negative
GGCTTGGAGGAGGTTC	Negative
GGCTTGGCAGGAAGTC	Negative
GGCTTGGTCACTTCTA	Negative
GGCTTGGTCAGCTTGA	Hashtag3
GGCTTTCAGACCTCCG	Hashtag1
GGCTTTCAGCGCCTCA	Hashtag1
GGCTTTCAGGAGAATG	Hashtag1
GGCTTTCCAGCTATTG	Negative
GGCTTTCCAGTATACC	Hashtag1
GGCTTTCGTAAGCAAT	Negative
GGGAAGTAGCGACTAG	Hashtag1
GGGAAGTAGCTGAAGC	Negative
GGGAAGTCACAAGTGG	Hashtag1
GGGAAGTGTCACTAGT	Negative
GGGAAGTTCCAATGCA	Negative
GGGAAGTTCGTTACCC	Negative
GGGACAAGTCCGACGT	Hashtag1
GGGACAATCAGAACCT	Negative
GGGACAATCCGCAAAT	Hashtag1
GGGACAATCTCCGATC	Hashtag3
GGGACCTAGTCCCAGC	Negative
GGGACCTGTAACCCTA	Negative
GGGACCTTCCATGAGT	Hashtag1
GGGACCTTCCCTCAAC	Hashtag1
GGGACCTTCGTGTCAA	Negative
GGGACCTTCTCTAAGG	Hashtag3
GGGACTCAGTGCGCTC	Negative
GGGACTCGTAGCACGA	Negative
GGGACTCGTGAGACGT	Negative
GGGACTCTCCATCTCG	Hashtag1
GGGAGATAGCATCAGG	Negative
GGGAGATGTGAGATAT	Negative
GGGAGTAAGACCAAGC	Hashtag1
GGGAGTAGTCTACGTA	Hashtag1
GGGAGTATCCCGTGAG	Hashtag1
GGGAGTATCTGTACAG	Hashtag1
GGGATCCCAAAGCGTG	Negative
GGGATCCGTGTGTGTT	Negative
GGGATCCTCTCCCAAC	Negative
GGGATGACAGTTAGAA	Hashtag3
GGGATGAGTCCTCCTA	Hashtag3
GGGCCATGTCTTGCTC	Negative
GGGCCATGTTTGGGAG	Negative
GGGCCATTCATAGACC	Hashtag3
GGGCCATTCTTGGCTC	Hashtag1
GGGCTACAGCACGTCC	Negative
GGGCTACCAACAGATA	Negative
GGGCTACCACGAGGTA	Hashtag3
GGGCTACCACTCATAG	Negative
GGGCTACGTGCCTATA	Hashtag1
GGGCTACGTGTGATGG	Hashtag3
GGGCTACTCCCAGGCA	Negative
GGGCTCAAGATGTTCC	Negative
GGGCTCAAGCACGATG	Negative
GGGCTCACACTAACGT	Hashtag3
GGGCTCACATATCGGT	Hashtag3
GGGCTCATCAGAACCT	Hashtag1
GGGCTCATCCGTCCTA	Negative
GGGCTCATCGTCGCTT	Negative
GGGTAGAAGTCAGCCC	Hashtag3
GGGTAGAGTAGCACGA	Negative
GGGTAGAGTCCGACGT	Hashtag3
GGGTAGAGTCTCGGGT	Negative
GGGTAGATCAGCGCGT	Negative
GGGTAGATCGGCTTGG	Hashtag3
GGGTATTAGTAGTCAA	Hashtag3
GGGTATTAGTCATCGT	Negative
GGGTATTGTGGTAATA	Negative
GGGTATTTCTGCGGGT	Negative
GGGTCACAGCCAGTAG	Hashtag3
GGGTCACAGCGTTCCG	Negative
GGGTCACCAACGACAG	Negative
GGGTCACGTCTCGGGT	Hashtag3
GGGTCACTCATGTCAG	Negative
GGGTCTGAGACAGCGT	Negative
GGGTCTGCAAGTTGGG	Hashtag1
GGGTCTGCACCGGTCA	Negative
GGGTCTGCAGAATTCC	Hashtag3
GGGTCTGGTCAAAGAT	Negative
GGGTCTGGTCCGGCAT	Hashtag3
GGGTGTCCAGCTTCGG	Negative
GGGTGTCCAGGCGAAT	Negative
GGGTGTCCATAGTCGT	Hashtag1
GGGTGTCGTATCAAGA	Hashtag3
GGGTGTCTCCGATAGT	Hashtag3
GGGTGTCTCTGAGATC	Negative
GGGTTATCAAAGCTAA	Hashtag3
GGGTTATCAGGTCAGA	Negative
GGGTTATGTCGGAAAC	Negative
GGGTTATGTGCCGTTG	Negative
GGGTTATTCGCCTTTG	Negative
GGGTTATTCTTTCGAT	Negative
GGGTTTAAGAACTGAT	Negative
GGGTTTAAGCCTATTG	Negative
GGGTTTAAGTCTCCTC	Hashtag3
GGGTTTAAGTGGAAAG	Negative
GGGTTTACAAAGACTA	Negative
GGGTTTACAACATCGT	Negative
GGGTTTACATTGAAGA	Hashtag3
GGGTTTATCGACCTAA	Hashtag1
GGGTTTATCTAGTCAG	Negative
GGTAACTCAGAACATA	Negative
GGTAACTCATCCTATT	Hashtag3
GGTAACTGTGCCGGTT	Hashtag3
GGTAACTTCTTTCGAT	Negative
GGTAATCCAGAGGACT	Hashtag3
GGTAATCCATCTGTTT	Hashtag3
GGTAATCTCCACAGGC	Negative
GGTAGAGAGTAGGAAG	Hashtag3
GGTAGAGCAATGCAGG	Negative
GGTAGAGCAGAGTTGG	Negative
GGTAGAGGTCACTAGT	Negative
GGTAGAGTCCGCTTAC	Hashtag1
GGTAGAGTCTGCATGA	Hashtag3
GGTCACGAGAATTGCA	Negative
GGTCACGAGACTCATC	Hashtag1_Hashtag3
GGTCTGGAGATAGTCA	Negative
GGTCTGGAGTGAGGCT	Negative
GGTCTGGGTCCCAAAT	Negative
GGTCTGGGTGCATTTG	Negative
GGTCTGGGTTATTCCT	Negative
GGTCTGGTCAAGCCGC	Negative
GGTCTGGTCCATACTT	Negative
GGTCTGGTCTCGCTTG	Negative
GGTGAAGGTCGAGCAA	Hashtag1
GGTGAAGGTTCGAAGG	Negative
GGTGAAGTCCGCACTT	Hashtag1
GGTGAAGTCGTTAGTG	Hashtag3
GGTGATTGTCCTTTGC	Negative
GGTGATTTCAACGTGT	Negative
GGTGATTTCAGGCGAA	Hashtag1
GGTGATTTCCGGTAAT	Hashtag1
GGTGATTTCGAAGGAC	Negative
GGTGGCTAGGACAGTC	Hashtag3
GGTGGCTGTAGATTGA	Hashtag3
GGTGGCTGTAGCTAAA	Negative
GGTGGCTTCTGATGGT	Hashtag3
GGTGTCGAGCGTATGG	Negative
GGTGTCGGTAGTTACC	Hashtag3
GGTGTCGGTGTCCTAA	Negative
GGTGTTAAGCGCGTTC	Negative
GGTGTTAAGGACAGCT	Negative
GGTGTTAAGTTAGTGA	Hashtag3
GGTGTTAGTTGTCATG	Negative
GGTGTTATCAACACGT	Negative
GGTTAACAGCACTGGA	Hashtag1
GGTTAACAGTAATTGG	Negative
GGTTAACCACGCCAGT	Hashtag1
GGTTAACCAGCAATTC	Negative
GGTTAACGTATCCCAA	Negative
GGTTAACGTCGGAAAC	Negative
GGTTAACTCCAAAGGG	Negative
GGTTCTCAGAGAGTTT	Negative
GGTTCTCAGAGCAGTC	Negative
GGTTCTCGTGTGAATA	Hashtag1
GGTTGTAAGAAGGATG	Negative
GGTTGTACACAGTGAG	Negative
GGTTGTATCCTCTGCA	Hashtag3
GTAACACCAGGGAATC	Hashtag1
GTAACACGTCGCTTAA	Negative
GTAACACGTGAACGGT	Negative
GTAACCAAGAGCAAGA	Hashtag3
GTAACCAAGCAAATCA	Negative
GTAACCACAAGATGGC	Hashtag3
GTAACCAGTAAGGAGA	Negative
GTAAGTCAGAGCTTTC	Negative
GTAAGTCAGTGATTCC	Negative
GTAAGTCAGTGTAGTA	Negative
GTAAGTCCAAAGCAAT	Hashtag3
GTAAGTCCAGCGATTT	Negative
GTAAGTCCAGCTTCCT	Negative
GTAAGTCTCTAGCCAA	Negative
GTAATCGAGTAGTCAA	Negative
GTAATCGAGTGTACAA	Negative
GTAATCGTCAGACAAA	Negative
GTAATCGTCGCCTTGT	Negative
GTAATCGTCTGATTCT	Negative
GTAATGCAGGATGAGA	Negative
GTAATGCCACGATAGG	Negative
GTAATGCGTGAATGTA	Hashtag1
GTAATGCTCGTCAAAC	Negative
GTAATGCTCTGCGAGC	Negative
GTACAACCAATTGCAC	Negative
GTACAACCACTGTGAT	Negative
GTACAGTCAAATCAAG	Negative
GTACAGTCAATAGTCC	Negative
GTACAGTGTGCTCCGA	Hashtag3
GTACAGTGTTGTGTTG	Negative
GTACAGTTCGCGTGAC	Hashtag3
GTAGAAACACATGTTG	Hashtag1
GTAGAAACACCGGAAA	Hashtag1
GTAGAGGAGATTAGCA	Hashtag3
GTAGAGGAGTTCCTGA	Hashtag3
GTAGAGGCACAGTCGC	Hashtag1
GTAGAGGCACCGGAAA	Negative
GTAGAGGGTCTCCTGT	Hashtag3
GTAGAGGTCCCGAATA	Negative
GTAGAGGTCTGTAAGC	Hashtag1
GTAGATCAGGGTGAGG	Negative
GTAGATCCAAGTGGTG	Hashtag1
GTAGATCCACTAACCA	Hashtag1
GTAGATCTCATGCGGC	Negative
GTAGATCTCTCTATAC	Negative
GTAGCTACAAATGGAT	Hashtag1
GTAGCTACAGTATACC	Hashtag3
GTAGCTATCGCTAATG	Negative
GTAGCTATCTAGCAAC	Hashtag3
GTAGGAGAGTGAGGTC	Negative
GTAGGAGGTAAGGCCA	Negative
GTAGGTTGTATTGAGA	Hashtag3
GTAGGTTGTGGAACAC	Negative
GTAGGTTTCAAGAGTA	Negative
GTAGTACAGCTGTGCC	Hashtag3
GTAGTACAGGAAACGA	Hashtag3
GTAGTACCAATCCTAG	Negative
GTAGTACCACCAGCCA	Hashtag3
GTAGTACTCCGTGTAA	Negative
GTAGTACTCGCAAGAG	Hashtag3
GTATTGGAGCATGAAT	Negative
GTATTGGCACCTCTAC	Negative
GTATTGGCAGAGGGTT	Hashtag3
GTATTGGGTGTATACC	Negative
GTATTGGTCCCTAGGG	Hashtag3
GTATTGGTCCCTCGAT	Negative
GTATTTCAGCATAGGC	Hashtag3
GTATTTCCAAATTGCC	Negative
GTATTTCGTCTGTGTA	Negative
GTATTTCGTTGTCTAG	Negative
GTATTTCTCAGGGATG	Hashtag3
GTCAAACAGAACTCCT	Hashtag1
GTCAAACAGCGTTAGG	Negative
GTCAAACGTCGCAGTC	Hashtag3
GTCAAACGTGACACAG	Negative
GTCAAACTCGATCCAA	Hashtag3
GTCAAGTCAAGCTACT	Negative
GTCAAGTCAAGTGGTG	Negative
GTCAAGTCACCGGTCA	Negative
GTCAAGTGTACTAGCT	Negative
GTCAAGTTCCTTATAC	Negative
GTCAAGTTCTGAGAAA	Negative
GTCACGGAGGGCCTCT	Negative
GTCACGGAGGTCCCGT	Negative
GTCACGGGTCACCACG	Negative
GTCACTCAGACTACGG	Negative
GTCACTCTCCAACCAA	Hashtag3
GTCACTCTCCATACTT	Negative
GTCACTCTCGACATAC	Negative
GTCACTCTCGAGAGCA	Negative
GTCACTCTCTCGTCGT	Hashtag3
GTCAGCGAGCCGGATA	Negative
GTCAGCGCAGAGACTG	Negative
GTCAGCGGTCGTATGT	Negative
GTCAGCGTCACTGGTA	Hashtag3
GTCAGCGTCGACACTA	Negative
GTCATCCAGAATTGCA	Negative
GTCATCCGTAACGATA	Hashtag1
GTCATCCGTAGTCTGT	Negative
GTCATCCGTTCGGTTA	Negative
GTCATCCTCTTGGTGA	Negative
GTCATGAAGGATATAC	Negative
GTCATGATCACCTCTG	Hashtag3
GTCATGATCGTAGCCG	Negative
GTCATGATCTGTCCCA	Negative
GTCATGATCTTTGCGC	Negative
GTCATTTTCGTCAGAT	Negative
GTCATTTTCTATCGGA	Negative
GTCCACTGTACACGTT	Negative
GTCCCATGTCAGGAGT	Negative
GTCCCATGTGATGAAT	Negative
GTCCCATTCTGGTCAA	Hashtag1
GTCCTCAAGCAACTCT	Hashtag3
GTCCTCACAATTGCCA	Negative
GTCCTCATCCCATTCG	Negative
GTCGAATAGATTGATG	Negative
GTCGAATAGCGTTACT	Negative
GTCGAATCAACGACAG	Hashtag1
GTCGCGATCAGAGCAG	Negative
GTCGCGATCGACGATT	Negative
GTCGCGATCGCCTCTA	Negative
GTCGTAAAGAGTAACT	Hashtag1
GTCGTAAAGGACCCAA	Hashtag3
GTCGTAATCAGTCTTT	Negative
GTCGTTCAGATCGCCC	Negative
GTCGTTCCATACCGTA	Negative
GTCGTTCGTACGGATG	Negative
GTCTACCCATGACTCA	Negative
GTCTACCGTACATTGC	Hashtag3
GTCTAGAAGATGTAGT	Negative
GTCTAGAAGGGTCAAC	Negative
GTCTAGAAGTAAGACT	Hashtag1
GTCTAGACAGCTCTGG	Negative
GTCTAGAGTAAGGCCA	Negative
GTCTAGATCCACCCTA	Hashtag3
GTCTCACAGCCTAGGA	Negative
GTCTCACAGGGCAGGA	Negative
GTCTCACCAAGCTGCC	Negative
GTCTCACGTTATAGAG	Negative
GTCTCACTCACCACAA	Negative
GTCTGTCCATAGAGGC	Hashtag3
GTCTGTCGTGGACTGA	Negative
GTCTTTAAGCCAGACA	Negative
GTCTTTACACTTGGCG	Negative
GTCTTTACATGGAACG	Hashtag3
GTCTTTAGTTCAAGGG	Negative
GTCTTTAGTTCCGCAG	Negative
GTCTTTATCTCGCTCA	Negative
GTCTTTATCTTGGTCC	Negative
GTGACGCCACGGGCTT	Hashtag1
GTGACGCCATGGTACT	Negative
GTGACGCGTGGTGATG	Negative
GTGACGCGTTATGACC	Hashtag1
GTGACGCGTTTGTTGG	Hashtag1
GTGAGCCCATAATGAG	Negative
GTGAGCCCATGGATCT	Negative
GTGAGCCGTAGGACCA	Hashtag1
GTGAGCCTCGTGGCTG	Negative
GTGAGGACAATTGCAC	Negative
GTGAGGACATGGCTAT	Negative
GTGAGGAGTGACGCCT	Hashtag3
GTGAGGATCAGAGCGA	Hashtag1
GTGAGGATCCCGAAAT	Negative
GTGAGGATCGTAACCA	Negative
GTGAGGATCTCAATCT	Hashtag1
GTGAGTTCAAGTAGTA	Negative
GTGAGTTTCATCGACA	Negative
GTGAGTTTCCTACGAA	Hashtag3
GTGATGTAGGTGATCG	Negative
GTGATGTCATCTGTTT	Negative
GTGATGTGTACTTCCC	Negative
GTGATGTTCGATTCCC	Negative
GTGCACGAGCTGAGTG	Negative
GTGCACGGTCTGCATA	Negative
GTGCACGGTTTGTTGG	Negative
GTGCACGTCCACTTTA	Negative
GTGCAGCCAACGGGTA	Negative
GTGCAGCGTATTCCTT	Negative
GTGCAGCGTCCCTGTT	Negative
GTGCAGCTCGAGAACG	Negative
GTGCAGCTCGTACACA	Negative
GTGCGTGAGATGATTG	Negative
GTGCGTGCAAGCTGCC	Negative
GTGCGTGGTAGTTCCA	Negative
GTGCTGGAGATAACGT	Hashtag1
GTGCTGGAGTAACGTA	Negative
GTGCTGGAGTATGGCG	Hashtag1
GTGCTGGAGTTAGTGA	Hashtag3
GTGCTGGTCGAAGGAC	Negative
GTGCTTCAGCACTCAT	Hashtag1
GTGCTTCAGTGTACCT	Negative
GTGCTTCCAGCGACAA	Negative
GTGCTTCGTTGGGTTT	Negative
GTGCTTCTCGCCAACG	Hashtag1
GTGGAAGAGCCGATAG	Negative
GTGGAAGAGGCGATAC	Negative
GTGGAAGAGTGTACCT	Hashtag1
GTGGAAGGTACTCGTA	Negative
GTGGAAGGTCCAGCCA	Hashtag1
GTGGAAGTCATTACCT	Negative
GTGGAGAGTACGTGTT	Negative
GTGGAGAGTCTTTATC	Negative
GTGGAGATCCTCGATC	Negative
GTGGCGTAGATCGCCC	Negative
GTGGCGTCACCTCAGG	Negative
GTGGCGTGTGAGGATC	Hashtag3
GTGGCGTTCCAGGACC	Hashtag3
GTGGGAACAACTCGTA	Negative
GTGGGAAGTGCATTAC	Hashtag3
GTGGGAATCCGAACGC	Negative
GTGGTTAAGACTGGGT	Negative
GTGGTTACAATCTCTT	Negative
GTGGTTACATTGAAGA	Hashtag3
GTGGTTAGTAATACCC	Negative
GTGGTTAGTAGAGTTA	Hashtag3
GTGGTTAGTCCTACAA	Hashtag3
GTGGTTATCTCATGCC	Hashtag3
GTGTAACCATTCGGGC	Negative
GTGTAACGTCCGAAGA	Hashtag1
GTGTCCTAGGACATCG	Negative
GTGTCCTCAGAGTTGG	Hashtag3
GTGTCCTCATTGCCGG	Negative
GTGTCCTGTACGTTCA	Negative
GTGTCCTTCATTGCTT	Negative
GTGTCCTTCCCGTGAG	Negative
GTGTCCTTCCGTGTCT	Negative
GTGTCCTTCGAGTTGT	Negative
GTGTGATAGCACCTGC	Negative
GTGTGATTCCGTAGTA	Hashtag3
GTGTGGCAGAGTGACC	Negative
GTGTGGCAGCGACCCT	Hashtag3
GTGTGGCAGTGAGTTA	Hashtag3
GTGTGGCCACAAGGTG	Hashtag3
GTGTGGCCAGCTGAAG	Negative
GTGTGGCGTGCGTCGT	Negative
GTGTGGCTCGACATCA	Hashtag3
GTGTGGCTCTTCGACC	Hashtag1
GTGTTAGAGGAATCGC	Negative
GTGTTAGCAACTGCCG	Hashtag3
GTGTTAGCACAACCGC	Negative
GTGTTAGTCTACTGCC	Negative
GTGTTAGTCTGCATAG	Hashtag3
GTGTTCCAGGCATCTT	Negative
GTGTTCCTCACCTTGC	Hashtag3
GTTACAGAGTGATAGT	Negative
GTTACAGCAAACAGGC	Hashtag3
GTTACAGCACCGGCTA	Negative
GTTACAGCACGCTGCA	Negative
GTTACAGTCCCTTCCC	Negative
GTTACAGTCTCTCCGA	Negative
GTTACAGTCTGTACAG	Negative
GTTACCCAGAAACTAC	Hashtag1
GTTACCCAGCTATCTG	Hashtag3
GTTACCCCACGTCGTG	Negative
GTTACCCCATGGACAG	Negative
GTTACCCTCCATCTCG	Negative
GTTACCCTCTGCTTAT	Hashtag3
GTTACGAAGATGTTCC	Hashtag3
GTTACGAAGTGCAGCA	Negative
GTTACGACACGTAGTT	Negative
GTTACGACACTACTTT	Hashtag1
GTTACGATCGAAGTGG	Negative
GTTACGATCGTAGAGG	Negative
GTTACGATCGTGGCTG	Negative
GTTAGACAGACGCCCT	Negative
GTTAGACCAGGGTCTC	Negative
GTTAGACCATCCTGTC	Negative
GTTAGACCATCTGTTT	Negative
GTTAGACGTACTAGCT	Negative
GTTAGACTCCTTCTAA	Hashtag1
GTTAGACTCTAGTGAC	Hashtag1
GTTAGTGGTGCCCAGT	Negative
GTTAGTGGTTATAGCC	Hashtag3
GTTAGTGTCAGGACAG	Hashtag1
GTTATGGCAACACAGG	Negative
GTTATGGTCTAAACGC	Negative
GTTCATTAGGACCCAA	Negative
GTTCATTGTTTGTTCT	Hashtag1
GTTCATTTCACTGAAC	Negative
GTTCGCTAGACATAAC	Negative
GTTCGCTCATCGCTCT	Hashtag1
GTTCGCTGTGCGGTAA	Negative
GTTCTATTCTCAATCT	Negative
GTTGAACCAACTGATC	Hashtag1
GTTGAACGTGGCCACT	Negative
GTTGAACTCATACGAC	Hashtag3
GTTGCGGAGGTCCCGT	Hashtag3
GTTGCGGGTATGTGTC	Negative
GTTGCGGTCGACTCCT	Negative
GTTGCGGTCGTCGATA	Hashtag1
GTTGCTCAGAATGTTG	Negative
GTTGCTCCAGATTAAG	Negative
GTTGCTCTCATCCTGC	Negative
GTTGCTCTCCAATCTT	Negative
GTTGCTCTCTATCGCC	Hashtag3
GTTGTAGCAGAGATTA	Negative
GTTGTAGGTAGATCGG	Negative
GTTGTAGGTATCCTCC	Negative
GTTGTAGGTCATGGCC	Negative
GTTGTAGGTTCGGCGT	Negative
GTTGTAGTCAATGTCG	Negative
GTTGTAGTCACCATAG	Negative
GTTGTCCAGTAAATGC	Negative
GTTGTCCCATGCAGCC	Negative
GTTGTCCGTTCCGCTT	Negative
GTTGTGAAGTCAATCC	Hashtag1
GTTGTGACAGAGTGTG	Negative
GTTGTGATCCGCGAGT	Negative
GTTTACTAGGAGCAAA	Hashtag3
GTTTACTCAACGCCCA	Negative
GTTTACTTCATCACAG	Negative
GTTTACTTCGGTCTAA	Negative
GTTTGGAAGAAACTAC	Negative
GTTTGGAAGAGACAAG	Negative
GTTTGGACAATTTCGG	Negative
GTTTGGAGTCTGTCAA	Negative
TAACACGAGAGAATCT	Hashtag3
TAACACGGTATGTGTC	Negative
TAACACGTCCCGATCT	Hashtag1
TAACACGTCCCTTCCC	Negative
TAACACGTCGGCGATC	Negative
TAACCAGAGCCTCTTC	Negative
TAACCAGGTCAAGTTC	Negative
TAACCAGGTGCCTGAC	Negative
TAACCAGTCTCAAAGC	Negative
TAACGACAGATGGTAT	Hashtag1
TAACGACAGCATAGGC	Negative
TAACGACGTCTAGTGT	Hashtag1
TAACGACGTGCAACGA	Hashtag1
TAACGACGTGTCCATA	Negative
TAACGACTCTCGCAGG	Negative
TAAGCACAGTAGAATC	Hashtag1
TAAGCACGTAACACCT	Negative
TAAGCACGTACGCGTC	Negative
TAAGCACTCAAGAGGC	Negative
TAAGCCAAGCTGTTCA	Hashtag3
TAAGCGTAGTGGGAAA	Negative
TAAGCGTCAAAGGCAC	Negative
TAAGCGTCAGACCATT	Hashtag1_Hashtag3
TAAGCGTGTTCCGGTG	Hashtag1
TAAGTCGAGAGCCTGA	Negative
TAAGTCGAGTGGTCAG	Negative
TAAGTCGCAGCATTGT	Negative
TAAGTCGCATGGGATG	Negative
TAAGTCGTCATACAGC	Negative
TAAGTCGTCGCAACAT	Hashtag1
TAATCTCAGCACTCAT	Negative
TAATCTCGTGTCCGGT	Negative
TAATCTCGTTCCAAAC	Negative
TAATCTCGTTTACTGG	Negative
TAATCTCTCACAGAGG	Negative
TAATCTCTCCTAGAGT	Hashtag1
TAATCTCTCTGCGGAC	Hashtag3
TAATTCCAGGGCCCTT	Negative
TAATTCCGTATGCTAC	Negative
TAATTCCGTCATAACC	Hashtag3
TACAACGAGGCAGGGA	Hashtag1
TACAACGGTCACTGAT	Hashtag3
TACAACGTCTAGAACC	Negative
TACACCCAGAAGTCAT	Negative
TACACCCCAATTCTTC	Negative
TACACCCTCAACCGAT	Negative
TACACCCTCCATTTCA	Hashtag3
TACAGGTAGGAACGAA	Hashtag1
TACAGGTAGTGATTCC	Negative
TACAGGTGTATACGGG	Hashtag3
TACATTCAGAACAAGG	Negative
TACATTCAGTACCATC	Negative
TACATTCGTAATCAGA	Hashtag3
TACATTCGTGTAACGG	Negative
TACATTCTCAAATGAG	Hashtag1
TACATTCTCGCCGATG	Hashtag3
TACCCACAGATAGGGA	Hashtag3
TACCCACCAAAGCACG	Negative
TACCCACCACAAGTTC	Negative
TACCCACCACGATTCA	Hashtag1
TACCCACTCATTTCGT	Negative
TACCCACTCCACCTCA	Negative
TACCCGTAGAGTACCG	Negative
TACCCGTCACAATTCG	Hashtag3
TACCCGTGTATAATGG	Negative
TACCCGTTCCCATGGG	Negative
TACCCGTTCTTGGGCG	Negative
TACCGAAAGGTGCTAG	Hashtag1
TACCGAACACCTAAAC	Negative
TACCGAACAGCGTGCT	Negative
TACCGAAGTGTGACCC	Hashtag3
TACCGAATCAGGAAGC	Negative
TACCGGGAGTCTAGCT	Negative
TACCGGGCATAATGAG	Negative
TACCGGGGTCTTCAAG	Negative
TACCTCGAGAGCAGAA	Hashtag3
TACCTCGAGGAAGTGA	Hashtag1
TACCTCGAGTCCGCGT	Hashtag3
TACCTCGCACAAGCCC	Negative
TACCTCGGTAAGCGGT	Hashtag3
TACCTCGGTACGACAG	Hashtag1_Hashtag3
TACCTCGTCAACTCTT	Negative
TACCTCGTCACTGTCC	Negative
TACCTCGTCCCATTCG	Negative
TACCTCGTCTGGACTA	Negative
TACCTCGTCTTGAGCA	Negative
TACCTGCAGACCATGG	Hashtag3
TACCTGCCAAGAGGTC	Hashtag1
TACCTGCCATACATCG	Negative
TACCTGCTCAATCTCT	Negative
TACGCTCTCCGAACGC	Negative
TACGGGCCATTGTACG	Negative
TACGGTAAGCCTTGAT	Hashtag1
TACGGTAGTGGACTAG	Hashtag1
TACGGTATCTGCACCT	Hashtag3
TACGTCCCATTCATCT	Negative
TACGTCCGTCACCCTT	Negative
TACGTCCTCCAAATGC	Hashtag1
TACTGCCAGTATTAGG	Hashtag1
TACTGCCGTATCGCTA	Negative
TACTGCCGTCGTGGTC	Hashtag3
TACTGCCGTGCCCACA	Hashtag3
TACTGCCGTTCGGTAT	Negative
TACTGCCTCAACTGAC	Hashtag1
TACTGCCTCAGCAGAG	Hashtag3
TACTGCCTCATCACAG	Negative
TACTTACAGAAGAGCA	Negative
TACTTACAGATACAGT	Hashtag1
TACTTACAGGATTCCT	Negative
TACTTACAGGTATCTC	Negative
TACTTACAGTTAGTAG	Negative
TACTTACCAATGTGGG	Hashtag3
TACTTACGTGATCGTT	Hashtag3
TACTTCAAGACGGAAA	Negative
TACTTCACACGAGGAT	Negative
TACTTCACAGTTACCA	Hashtag1
TACTTCATCATTCACT	Negative
TACTTCATCTGACGCG	Negative
TACTTGTAGCCGATAG	Negative
TACTTGTAGTCATCCA	Negative
TACTTGTCAGCGCGTT	Negative
TACTTGTCAGGCATGA	Hashtag3
TACTTGTTCGCGCTGA	Negative
TACTTGTTCTACAGGT	Negative
TAGACCAAGGTATTGA	Negative
TAGACCATCAAATAGG	Negative
TAGACCATCGCAACAT	Hashtag3
TAGACCATCTAGGCAT	Negative
TAGACTGAGGTGGCTA	Hashtag1
TAGACTGCAATTAGGA	Negative
TAGACTGCATGCGTGC	Negative
TAGACTGGTCATAACC	Hashtag1
TAGACTGGTGGCAGAT	Negative
TAGACTGTCGAGTTGT	Negative
TAGAGTCTCCGATGCG	Negative
TAGAGTCTCTATCGTT	Negative
TAGATCGCAAATCGGG	Negative
TAGATCGCAGCAGATG	Negative
TAGATCGTCCTTTGAT	Negative
TAGCACAAGACCTCCG	Hashtag3
TAGCACAAGATGGTCG	Hashtag1
TAGCACAAGATTAGTG	Negative
TAGCACAAGTCTGTAC	Negative
TAGCACACAATAGAGT	Negative
TAGCACAGTGGACCTC	Hashtag1
TAGGAGGCAAGGCCTC	Negative
TAGGAGGCAGGCTTGC	Hashtag3
TAGGAGGCAGTCAGCC	Hashtag3
TAGGGTTAGACAGTCG	Negative
TAGGGTTAGGAACATT	Negative
TAGGGTTAGGCTTAGG	Negative
TAGGGTTGTTCTCTAT	Negative
TAGGGTTTCAAGATAG	Negative
TAGGTACAGGTCATTC	Negative
TAGGTACCAACTTGCA	Negative
TAGGTACGTCACATTG	Hashtag1
TAGGTACTCAGCTCTC	Hashtag1
TAGGTACTCGGTTCAA	Negative
TAGGTTGAGACCATTC	Hashtag1
TAGGTTGAGGCAGTCA	Hashtag3
TAGGTTGCATGGATCT	Hashtag1
TAGGTTGGTAGGCTGA	Negative
TAGGTTGGTCGCATCG	Negative
TAGGTTGTCTAGACAC	Hashtag1
TAGGTTGTCTGTGCAA	Hashtag3
TAGTGCACACCAAATC	Negative
TAGTGCATCCGCCTAT	Hashtag3
TAGTGCATCTCGACGG	Negative
TATACCTAGATTCGCT	Negative
TATACCTAGGCACTCC	Hashtag1
TATACCTAGGGTCACA	Negative
TATACCTCAAGTATCC	Hashtag1
TATACCTGTGTTGATC	Negative
TATATCCAGCCTGTGC	Hashtag3
TATATCCAGTAGTGCG	Hashtag3
TATATCCAGTGAGCCA	Hashtag3
TATATCCCAAGAATGT	Negative
TATATCCCACAATGTC	Negative
TATATCCCACATAGCT	Negative
TATATCCCAGCCGTCA	Negative
TATATCCTCTATGCCC	Negative
TATCAGGAGCGAGTCA	Negative
TATCAGGAGCGCCTCA	Negative
TATCAGGCAACGATCT	Negative
TATCAGGCAATTGCAC	Hashtag1
TATCAGGCAATTGTGC	Negative
TATCAGGCACTCCCTA	Hashtag3
TATCCTAAGGTAGTAT	Negative
TATCCTACATCCGAAT	Hashtag3
TATCCTAGTCTTGCTC	Negative
TATCCTAGTTTCGTAG	Negative
TATCCTATCCATTGGA	Negative
TATCGCCAGGCCCACT	Negative
TATCGCCAGGGCCCTT	Hashtag3
TATCGCCCAGTCGCAC	Hashtag3
TATCGCCGTCCTGTCT	Hashtag1_Hashtag3
TATCGCCTCACCGGTG	Negative
TATCTGTAGGACAAGA	Negative
TATCTGTCATAGGTAA	Negative
TATCTGTCATGGGTTT	Negative
TATCTGTGTAGCGCTC	Negative
TATCTGTGTGCACAAG	Hashtag3
TATCTTGAGGATGTTA	Negative
TATCTTGAGTCACGCC	Negative
TATCTTGGTCCTTGTC	Hashtag1
TATCTTGGTTAGCGGA	Negative
TATCTTGGTTGTTGTG	Negative
TATCTTGTCACGATCA	Negative
TATGTTCAGACGGTTG	Negative
TATGTTCCAATCGCCG	Hashtag1
TATGTTCCAGCTCCTT	Negative
TATGTTCGTATCGGTT	Negative
TATGTTCGTGTGTCGC	Negative
TATGTTCGTTTCCCAC	Negative
TATGTTCTCCCACAGG	Hashtag1
TATTCCAAGATCGCTT	Negative
TATTCCAAGCAACAGC	Negative
TATTCCACATCGAGCC	Negative
TATTCCAGTCCACGCA	Negative
TATTGCTAGGAGACCT	Negative
TATTGCTCACGTGTGC	Negative
TATTGCTGTAAGTCAA	Negative
TATTGCTGTGATTCTG	Hashtag3
TATTGGGAGTTGGCGA	Hashtag1_Hashtag3
TATTGGGCAAACTGCT	Negative
TATTGGGCAACGGTAG	Negative
TATTGGGCACCTAAAC	Negative
TATTGGGCATAGAAAC	Hashtag1
TATTGGGGTAGGCAGT	Hashtag3
TATTTCGCAAATCAAG	Negative
TATTTCGCACAAGCTT	Negative
TATTTCGCACAGTACT	Hashtag1
TATTTCGCAGGCTACC	Negative
TATTTCGTCCCTCTCC	Hashtag3
TCAAGACAGGTACAAT	Negative
TCAAGACCAATCTCTT	Hashtag1
TCAAGACCAATGGCCC	Hashtag1
TCAAGACGTAGGAGTC	Hashtag3
TCAAGACGTGACTGTT	Hashtag1
TCAAGACTCACCTTAT	Negative
TCAAGACTCGTTCCCA	Negative
TCAAGCACAAAGACGC	Negative
TCAAGTGAGCACTAAA	Negative
TCAAGTGAGGAGGTTC	Hashtag3
TCAAGTGCACTGCACG	Negative
TCAAGTGGTTCTCCAC	Negative
TCAAGTGTCGCCAACG	Negative
TCAATCTAGATTGACA	Hashtag3
TCAATCTAGGAGGCAG	Negative
TCAATCTTCCCAAGCG	Hashtag1
TCAATCTTCCTATGGA	Hashtag3
TCAATTCAGACCAAAT	Hashtag3
TCAATTCAGGTTACCT	Negative
TCAATTCCATGAATAG	Negative
TCAATTCCATGAATCC	Hashtag1
TCAATTCGTTGGGTAG	Negative
TCAATTCTCAACGTGT	Negative
TCAATTCTCTCTCTTC	Negative
TCACAAGCATACAGAA	Negative
TCACAAGGTCTTACAG	Hashtag3
TCACAAGGTGCCTACG	Hashtag1
TCACAAGGTTCTCGCT	Negative
TCACACCTCAAGCCAT	Negative
TCACACCTCAAGTCGT	Negative
TCACACCTCCAGTACA	Hashtag3
TCACATTCACCGTGAC	Hashtag3
TCACATTCAGGGACTA	Hashtag3
TCACATTCAGTGTGCC	Negative
TCACATTGTCAGATTC	Negative
TCACATTGTCCCTAAA	Hashtag1
TCACATTGTGGACCTC	Hashtag3
TCACGCTAGTCGTCTA	Negative
TCACGCTGTATCCCTC	Negative
TCACGCTGTCAGTCCG	Negative
TCACGCTGTTGGCCTG	Negative
TCACGGGTCCGCGATG	Hashtag1
TCACTATCAGCTTTGA	Negative
TCACTATGTATCGCGC	Negative
TCACTCGAGAGAGGGC	Hashtag1
TCACTCGCACGTACAT	Negative
TCACTCGGTTACACTG	Hashtag3
TCACTCGTCGCACTCT	Hashtag1
TCACTCGTCGTGGCTG	Negative
TCAGCAAAGCTATCTG	Hashtag1
TCAGCAAGTAGTGGCA	Negative
TCAGCAAGTTATCTTC	Hashtag1
TCAGCCTCAAGATGGC	Negative
TCAGCCTGTCAGACTT	Negative
TCAGCCTGTCTAACGT	Negative
TCAGCCTGTCTCGCGA	Negative
TCAGCCTTCACTCTTA	Negative
TCAGCCTTCCAGCTCT	Hashtag3
TCAGCCTTCCGAGAAG	Negative
TCAGCCTTCTATGTGG	Negative
TCAGGGCCACCTGCAG	Negative
TCAGGGCCACTGCGAC	Hashtag3
TCAGGGCTCACGAACT	Negative
TCAGGTAGTAATCAGA	Negative
TCAGGTATCGGTCAGC	Hashtag1
TCAGTCCAGTCATAGA	Negative
TCAGTCCCAGTAACCT	Negative
TCAGTCCTCAGGGATG	Negative
TCAGTCCTCTCCAATT	Negative
TCAGTGAAGACCAGAC	Hashtag1
TCAGTGAAGCCGCTTG	Hashtag3
TCAGTGAAGGCCATAG	Hashtag3
TCAGTGAAGTCACACT	Hashtag3
TCAGTGAAGTCACGCC	Hashtag3
TCAGTGACATGGAATA	Negative
TCAGTGACATTAAAGG	Hashtag3
TCAGTGAGTAACACCT	Hashtag1
TCAGTGAGTCGAGTTT	Negative
TCAGTGAGTGCCCAGT	Hashtag3
TCAGTGATCTGAGATC	Hashtag3
TCAGTTTAGTGCAGGT	Negative
TCATACTAGTGAGGTC	Hashtag3
TCATACTCAACGCCCA	Hashtag3
TCATACTCATCCTCAC	Negative
TCATACTTCGATACTG	Hashtag1
TCATATCAGGTACAGC	Negative
TCATATCAGTAGTCAA	Negative
TCATATCCAGTTTCAG	Negative
TCATATCGTTTGCAGT	Negative
TCATATCTCATAGACC	Hashtag1
TCATATCTCTATCGGA	Hashtag1
TCATATCTCTTCACAT	Negative
TCATCATAGGATCACG	Hashtag3
TCATCATAGTAAGGGA	Negative
TCATCATGTCCGCAGT	Negative
TCATCATGTCTGATAC	Hashtag1
TCATGAGGTACGGGAT	Hashtag3
TCATGCCAGAGTCAGC	Negative
TCATGGAAGACCAGAC	Negative
TCATGGAAGTCTTGGT	Negative
TCATGGACAGTCCCGA	Hashtag1
TCATGGACATGTGGCC	Negative
TCATGGAGTCACATTG	Negative
TCATGGATCACGGACC	Hashtag3
TCATGGATCCACACCT	Hashtag3
TCATGTTAGCGCCGTT	Negative
TCATGTTCAAATGCTC	Negative
TCATGTTCAGAAATTG	Negative
TCATGTTCAGAGAGGG	Negative
TCATGTTCAGAGTTCT	Negative
TCATGTTCATCGTCCT	Negative
TCATGTTTCACCATAG	Negative
TCATTACAGCGAGAAA	Negative
TCATTACCAAGCACAG	Negative
TCATTACGTCATCGCG	Negative
TCATTACGTCGTCATA	Hashtag3
TCATTACTCCCTTGGT	Negative
TCATTCAAGAGAGTGA	Hashtag1
TCATTCAAGGAACGCT	Negative
TCATTCAGTCTAGGTT	Negative
TCATTCATCTAGTGTG	Hashtag3
TCATTGTCACAGGATG	Negative
TCATTGTTCTTACCGC	Negative
TCATTTGAGTCGTTAC	Negative
TCATTTGAGTGTACCT	Negative
TCATTTGCATAAGCAA	Negative
TCCACCAAGGAACGTC	Negative
TCCACCACACGCAAAG	Negative
TCCACCACATCACGGC	Negative
TCCACCATCCCGAGTG	Negative
TCCACGTAGCAAATCA	Hashtag3
TCCACGTCAAGCTACT	Negative
TCCACGTCACGTATAC	Negative
TCCACGTCACTGTCGG	Negative
TCCACGTGTAATCAAG	Negative
TCCACGTGTATTGAGA	Negative
TCCACGTGTTACCGTA	Negative
TCCACGTGTTTATGCG	Negative
TCCACGTTCAGACCTA	Negative
TCCACGTTCCGCTGTT	Hashtag1
TCCACGTTCCGTGTGG	Negative
TCCACGTTCGGTCTAA	Hashtag3
TCCAGAACAGCTATAC	Hashtag3
TCCAGAACAGGATTCT	Negative
TCCAGAACAGTTGCGC	Negative
TCCAGAACATCGCTGG	Negative
TCCATCGAGACCAAAT	Hashtag1
TCCATCGAGTCAAGCG	Hashtag3
TCCATCGCAAATGATG	Hashtag1
TCCATCGCATAACCCA	Negative
TCCATCGGTACTTCCC	Negative
TCCATCGTCCTGGTCT	Negative
TCCATGCAGCTAGAAT	Negative
TCCATGCGTCTTGGTA	Negative
TCCATGCGTGTTATCG	Negative
TCCATGCGTTCCGGTG	Hashtag3
TCCATGCGTTCTTCAT	Negative
TCCATGCTCAGACCCG	Hashtag1
TCCATGCTCTCGTGGG	Negative
TCCATGCTCTGCATAG	Negative
TCCCACAGTCCACTTC	Negative
TCCCACAGTCCGTACG	Negative
TCCCAGTAGAGTTCGG	Hashtag1
TCCCAGTCAGTTGTCA	Hashtag1
TCCCAGTGTAAGTTAG	Negative
TCCCAGTGTCGTCAGC	Negative
TCCCAGTGTCTCCTGT	Hashtag1
TCCCAGTGTTATAGCC	Hashtag3
TCCCAGTGTTCGGCCA	Negative
TCCGAAAAGCGCCATC	Hashtag1
TCCGAAAAGTCTGGAG	Hashtag1
TCCGAAAGTACTAAGA	Negative
TCCGAAAGTATACAGA	Hashtag1
TCCGAAAGTGCCAAGA	Hashtag1
TCCGAAATCGGAGCAA	Negative
TCCGATCAGACCGCCT	Negative
TCCGATCAGTAAGCAT	Negative
TCCGATCCAAGTTGGG	Hashtag1
TCCGATCCAATGAAAC	Negative
TCCGATCCAGAAACCG	Hashtag3
TCCGATCCAGCGTATT	Negative
TCCGATCGTAGAATGT	Negative
TCCGATCGTGCCGGTT	Negative
TCCGATCTCGATCCAA	Negative
TCCGATCTCTTGAACG	Negative
TCCGGGAAGCGTTAGG	Hashtag1
TCCGGGAAGTGCTCAT	Negative
TCCGTGTCAGACTGCC	Negative
TCCGTGTGTTCAGGTT	Negative
TCCTAATAGACATAAC	Negative
TCCTAATAGTGCAACG	Hashtag1
TCCTAATCACTCACTC	Hashtag3
TCCTAATCATACCATG	Negative
TCCTAATGTCGACTGC	Hashtag3
TCCTAATTCAACTTTC	Hashtag3
TCCTCCCCAACACAAA	Negative
TCCTCCCGTCGTATTG	Negative
TCCTCGAGTACTCGAT	Hashtag1
TCCTCGAGTGCGAGTA	Negative
TCCTCGAGTGGCTCTG	Negative
TCCTCGAGTGTTTGCA	Negative
TCCTCTTAGGAATCGC	Negative
TCCTCTTAGTATAACG	Negative
TCCTCTTCAACGACAG	Negative
TCCTCTTCACAGTACT	Negative
TCCTCTTGTACGGTTT	Hashtag1
TCCTCTTGTCAAGCCC	Negative
TCCTCTTTCCTTATCA	Hashtag1
TCCTGCAAGAGTGTGC	Hashtag3
TCCTGCAGTGACTGAG	Hashtag1
TCCTGCAGTTGCACGC	Hashtag3
TCCTGCATCTGTAAGC	Negative
TCCTTCTAGCGCCGTT	Hashtag3
TCCTTCTCAATTGCGT	Hashtag3
TCCTTCTTCATTACTC	Hashtag3
TCCTTCTTCGGATAAA	Negative
TCCTTTCAGGACACTG	Negative
TCCTTTCCATCTGCGG	Hashtag1
TCCTTTCTCAACGAGG	Negative
TCGAACAAGCTCAGAG	Negative
TCGAACAAGGGATCAC	Hashtag3
TCGAACACAGCCTTCT	Negative
TCGAACACAGCGTTTA	Negative
TCGAACACAGTCGCAC	Negative
TCGACCTAGACCCGCT	Hashtag1
TCGACCTCAAAGTGTA	Negative
TCGACCTCATCTTAGG	Hashtag3
TCGACCTGTGAGACCA	Negative
TCGACCTGTGTACAGG	Negative
TCGACCTTCATCACTT	Hashtag1
TCGACCTTCTTGCAGA	Negative
TCGACGGAGAAACTGT	Hashtag3
TCGACGGAGAGCAGTC	Negative
TCGACGGCAAGTGCTT	Hashtag1
TCGACGGCAGCAGTTT	Hashtag1
TCGACGGCAGTTCCAA	Hashtag1
TCGACGGGTTGTTGAC	Negative
TCGACGGTCACGGGAA	Hashtag3
TCGATTTAGCGAGAAA	Hashtag1
TCGATTTCAGAAGCTG	Hashtag1
TCGATTTCATACACCA	Hashtag3
TCGCACTAGGCCACCT	Hashtag1
TCGCACTCAGTATACC	Hashtag1
TCGCACTGTCGTGTTA	Negative
TCGCAGGAGCTAATGA	Negative
TCGCAGGGTCACCCTT	Hashtag3
TCGCAGGGTCGACTGC	Hashtag3
TCGCAGGGTTAGGACG	Hashtag1
TCGCAGGGTTCGAACT	Negative
TCGCAGGTCCATTTGT	Negative
TCGCAGGTCGACGACC	Negative
TCGCAGGTCTGCGGAC	Negative
TCGCTCAAGATGGCAC	Hashtag1
TCGCTCAAGGGATCGT	Negative
TCGCTCACAACAGAGC	Hashtag1
TCGCTCAGTCACTTAG	Hashtag3
TCGCTCAGTCCGCAGT	Negative
TCGCTCATCGTTGTGA	Negative
TCGCTTGAGAATCTAG	Hashtag1
TCGCTTGAGCACCTGC	Negative
TCGCTTGAGGCTTTCA	Negative
TCGCTTGGTACATACC	Negative
TCGCTTGGTATCCTTT	Hashtag1
TCGCTTGGTCTCAGGC	Negative
TCGCTTGTCAGTAGGG	Negative
TCGGATAAGAATGTTG	Negative
TCGGATAGTGCTAGCC	Negative
TCGGATAGTTATAGAG	Negative
TCGGATATCCCAACTC	Negative
TCGGATATCCTGTTAT	Negative
TCGGGACAGAAATTCG	Hashtag1
TCGGGACCATAGATGA	Negative
TCGGGACGTAGCACAG	Negative
TCGGGCACACTAGAGG	Hashtag1
TCGGGCAGTCAACATC	Hashtag3
TCGGGCATCTTCACAT	Negative
TCGGGTGAGTTCCGGC	Negative
TCGGGTGTCCATCTGC	Negative
TCGGTCTAGACCTCAT	Negative
TCGGTCTCACAGCTTA	Negative
TCGGTCTCATGTGGTT	Negative
TCGGTCTGTCCAACGC	Negative
TCGGTCTGTGTCTTGA	Hashtag3
TCGGTCTGTTGGTGTT	Negative
TCGGTCTTCACTTGTT	Negative
TCGTAGAAGGTAGATT	Negative
TCGTAGACATAACAGA	Negative
TCGTAGACATGCGGTC	Hashtag1
TCGTAGACATGTGTCA	Negative
TCGTAGAGTGATAGTA	Negative
TCGTAGAGTGTCTTCC	Negative
TCGTAGAGTTGAATCC	Negative
TCGTCCAAGAGGATGA	Negative
TCGTCCAAGGCTATCT	Negative
TCGTCCAGTACGCTTA	Hashtag3
TCGTCCAGTGGGACAT	Negative
TCGTCCATCAACTGGT	Negative
TCGTGGGAGTAAGAGG	Negative
TCGTGGGCAGGGAATC	Negative
TCGTGGGTCTCCGTGT	Negative
TCTAACTAGCATGCGA	Negative
TCTAACTCAGTTCACA	Hashtag3
TCTACATAGCTACTAC	Negative
TCTACATCAACAGCCC	Negative
TCTACATCATCGCTGG	Negative
TCTACATGTACGTGAG	Negative
TCTACATTCTGGGTCG	Negative
TCTACCGAGCTAAATG	Negative
TCTACCGAGTCTTGGT	Hashtag1
TCTACCGGTGTTACTG	Negative
TCTACCGTCAGTGTCA	Negative
TCTACCGTCATTCATC	Negative
TCTACCGTCGGTCACG	Negative
TCTATACAGAAGTATC	Negative
TCTATACAGGACTTCT	Negative
TCTATACCATGAAGCG	Hashtag3
TCTATACGTGTGAATA	Negative
TCTATACTCATGCCGG	Negative
TCTATACTCATTTGCT	Hashtag3
TCTATACTCGCACGAC	Negative
TCTATCAAGAGTCTGG	Hashtag1
TCTATCACACCAATTG	Negative
TCTATCAGTGTTAAAG	Negative
TCTCACGAGTTCAACC	Negative
TCTCACGTCAAGGCTT	Hashtag3
TCTCACGTCCGTCAAA	Hashtag1
TCTCAGCAGTCTACCA	Negative
TCTCAGCCAAAGCACG	Negative
TCTCAGCGTTCTTCAT	Negative
TCTCAGCTCCCGAATA	Negative
TCTCAGCTCTCTCGCA	Hashtag3
TCTCCGACATCCTCAC	Hashtag1
TCTCCGATCACGACTA	Negative
TCTCCGATCAGACTGT	Hashtag3
TCTCTGGAGAAACTGT	Hashtag1
TCTCTGGAGGATGTTA	Negative
TCTCTGGGTAGGGAGG	Negative
TCTGCCAAGTAGATCA	Negative
TCTGCCACAACCCGCA	Hashtag1
TCTGCCACACTATCGA	Hashtag1
TCTGCCATCCTTTGAT	Negative
TCTGGCTAGATCCCGC	Negative
TCTGGCTAGTAAACAC	Negative
TCTGGCTAGTGCTACT	Hashtag3
TCTGGCTCAGGTCAGA	Hashtag3
TCTGGCTCATTGGATC	Hashtag3
TCTGGCTTCACCGGTG	Hashtag1
TCTGTCGCACTGCACG	Hashtag1
TCTGTCGCAGTCTTCC	Negative
TCTGTCGGTCCTACAA	Hashtag3
TCTGTCGGTGTAGCAG	Negative
TCTTAGTAGAAAGCGA	Negative
TCTTAGTGTGACTATC	Negative
TCTTAGTTCCACGTAA	Hashtag3
TCTTCCTAGATCCAAA	Hashtag3
TCTTCCTAGATTGAGT	Hashtag3
TCTTCCTAGTAGTCTC	Hashtag1
TCTTCCTAGTGATAAC	Negative
TCTTCCTCACGACTAT	Negative
TCTTCCTTCCCAGGCA	Negative
TCTTGCGCAACGGGTA	Hashtag1
TCTTGCGCACAGCCTG	Negative
TCTTGCGTCGACATCA	Negative
TCTTTGACAAACGAGC	Hashtag3
TCTTTGACAATTCACG	Negative
TCTTTGAGTCTGTCAA	Hashtag3
TGAACGTAGTCCCGAC	Negative
TGAACGTCAATGTCAC	Negative
TGAACGTCATGGCTAT	Negative
TGAACGTGTCTTAGTG	Negative
TGAATCGGTAGTATAG	Negative
TGAATCGGTCGGAAAC	Hashtag3
TGAATCGTCTTCTGGC	Negative
TGAATGCCAACATCGT	Negative
TGAATGCCACACTTAG	Negative
TGAATGCGTTTCAGAC	Negative
TGAATGCTCACTGTTT	Negative
TGACAGTAGATGGGCT	Negative
TGACAGTAGGGTATAT	Negative
TGACAGTAGTTGCATC	Negative
TGACAGTTCAGACATC	Negative
TGACCCTAGTACTGGG	Negative
TGACCCTTCAGTCAGT	Negative
TGACCCTTCTGAGGCC	Negative
TGACGCGCAAATGCGG	Negative
TGACGCGCACCTCTAC	Negative
TGACGCGCACGACAGA	Negative
TGACGCGCACGGCCAT	Negative
TGACGCGGTGACGTCC	Hashtag3
TGACGCGGTTTCGTAG	Negative
TGACGCGTCCCGATCT	Negative
TGACTCCAGTGGTGGT	Hashtag3
TGACTCCTCATGAAAG	Negative
TGACTCCTCATTACCT	Negative
TGACTCCTCGGACGTC	Hashtag3
TGACTCCTCGTAACCA	Negative
TGAGACTAGTCTTCCC	Hashtag3
TGAGCATAGGACGCAT	Hashtag3
TGAGCATCACAGTATC	Negative
TGAGCATGTTACGTAC	Hashtag3
TGAGCATTCTCACGAA	Hashtag1
TGAGCATTCTCGGTAA	Negative
TGAGCGCAGCCTCTTC	Negative
TGAGCGCGTCTTACAG	Negative
TGAGCGCGTTCTCAGA	Hashtag3
TGAGCGCTCGTAACTG	Negative
TGAGGAGAGCGCTTCG	Hashtag3
TGAGGAGCAACAACAA	Hashtag1
TGAGGAGCATTGCCGG	Negative
TGAGGAGTCACTTATC	Hashtag1
TGAGGAGTCCATAGGT	Negative
TGAGGGAAGTGGTGGT	Hashtag3
TGAGGGAGTCATGGCC	Negative
TGAGGGATCAACACCA	Hashtag3
TGAGGGATCCGATCTC	Negative
TGAGGGATCGGCTCTT	Negative
TGAGGGATCGGTGCAC	Negative
TGAGGTTAGAAACACT	Negative
TGAGGTTGTCCACGCA	Negative
TGAGGTTTCCTCGATC	Negative
TGAGGTTTCGCTGCGA	Negative
TGAGTCAAGAAGCCAC	Hashtag1
TGAGTCAAGACGACTG	Hashtag3
TGAGTCAGTCAAGTTC	Hashtag3
TGATCAGAGTAGGCCA	Hashtag1
TGATCAGAGTAGTCCT	Negative
TGATCAGTCAGTCAGT	Negative
TGATCAGTCTCTCAAT	Negative
TGATCTTCAACTCCCT	Hashtag3
TGATCTTCAAGGGCAT	Hashtag3
TGATCTTCACGACTAT	Negative
TGATGCAAGATTGCGG	Hashtag1
TGATGCACACCTAAAC	Negative
TGATGCACATCATGAC	Hashtag3
TGATGGTCAATCCAGT	Hashtag1
TGATGGTCAATGGCCC	Hashtag3
TGATGGTCAGCGTGAA	Negative
TGATGGTTCCATTGCC	Negative
TGATGGTTCTCGACCT	Negative
TGATTCTGTGGCCCAT	Negative
TGATTCTTCAACACGT	Negative
TGATTTCAGTTGCGAG	Hashtag1
TGATTTCGTTAAGCAA	Negative
TGATTTCTCAGCCTTC	Negative
TGATTTCTCTGATTCT	Negative
TGCACGGCAACAGCCC	Hashtag3
TGCACGGGTTGTGCCG	Negative
TGCACGGTCGGTATGT	Negative
TGCACGGTCTCAATCT	Negative
TGCAGATAGTCTGCAT	Hashtag3
TGCAGATCACAGCTTA	Negative
TGCAGATCACATGAAA	Negative
TGCAGATCACTTCATT	Negative
TGCAGATTCCACGTAA	Negative
TGCAGATTCTGCTTTA	Negative
TGCAGGCAGCACCGTC	Negative
TGCAGGCAGGACAGTC	Negative
TGCAGGCGTGTTCCAA	Hashtag3
TGCAGTACAAATACGA	Hashtag1
TGCAGTACAGCAGTAG	Negative
TGCAGTAGTCTCTCCA	Negative
TGCAGTAGTGAGAACC	Negative
TGCAGTAGTGCCCGTA	Hashtag1
TGCAGTAGTTGTCATG	Negative
TGCAGTAGTTTACGTG	Negative
TGCAGTATCTCACCCA	Hashtag3
TGCAGTATCTTCCTAA	Negative
TGCATCCAGAGTTGCG	Negative
TGCATCCAGTGTTCCA	Negative
TGCATCCGTAAGTAGT	Negative
TGCATCCTCGTCCATC	Hashtag3
TGCATGAAGGAACTAT	Hashtag3
TGCATGAAGGTCGTAG	Negative
TGCATGACACTCAGAT	Hashtag3
TGCATGACATCAACCA	Negative
TGCATGAGTTATCTGG	Hashtag1
TGCATGATCCGTGTAA	Hashtag1
TGCCGAGAGGGACCAT	Hashtag1
TGCCGAGAGGTAATCA	Negative
TGCCGAGCACGACAGA	Hashtag3
TGCCGAGGTAACACGG	Negative
TGCCGAGGTCCTCCTA	Negative
TGCCGAGGTCGGATTT	Negative
TGCCGAGGTCTCAGAT	Negative
TGCCGAGTCCTAGCCT	Negative
TGCCGAGTCTGTCAGA	Negative
TGCGACGAGTAGGCCA	Hashtag3
TGCGACGCAGCAGTAG	Negative
TGCGACGCATATCTGG	Hashtag1
TGCGACGGTGGGATTG	Hashtag3
TGCGACGGTTTCGACA	Negative
TGCGACGTCTACGCAA	Negative
TGCGATAAGGAAGAAC	Hashtag3
TGCGATAGTACTGACT	Negative
TGCGATAGTTACCCAA	Hashtag3
TGCGATATCACAAGAA	Negative
TGCGGCAAGCACGATG	Negative
TGCGGCAAGGCACGAT	Negative
TGCGGCAAGGCTAAAT	Negative
TGCGGCAAGTGCTCAT	Negative
TGCGGCAAGTGGTTGG	Hashtag3
TGCGGCACAGTAACGG	Negative
TGCGGCAGTATCAGCT	Hashtag1
TGCGGCAGTTTCTTAC	Hashtag1
TGCGGCATCACTTCTA	Negative
TGCGGGTAGACGCAGT	Negative
TGCGGGTAGATACATG	Negative
TGCGGGTGTGCCTGAC	Negative
TGCTCCAGTGACTCGC	Hashtag1
TGCTCCATCTCGAACA	Negative
TGCTCGTAGCTTGTTG	Negative
TGCTCGTCACAGTATC	Hashtag3
TGCTCGTCACGTCGTG	Negative
TGCTCGTGTGGACCAA	Negative
TGCTCGTTCACCGGGT	Hashtag1
TGCTGAAGTAATGCTC	Hashtag1
TGCTGAAGTCATCCGG	Hashtag1
TGCTGAAGTGACACGA	Hashtag1
TGCTTCGAGAGGTCGT	Negative
TGCTTCGGTCCCTAAA	Hashtag3
TGCTTGCAGAGAGTTT	Negative
TGCTTGCAGTAAGAGG	Negative
TGCTTGCCAGGCCTGT	Negative
TGCTTGCCAGTCGGTC	Hashtag3
TGCTTGCTCTGGTGCG	Negative
TGGAACTAGAGCTGCA	Negative
TGGAACTAGTGCTAGG	Negative
TGGAACTGTGATGTAA	Negative
TGGAGAGAGAATGTTG	Hashtag3
TGGAGAGTCCCGAATA	Negative
TGGAGAGTCGTTATCT	Negative
TGGAGGAAGACATACA	Negative
TGGAGGAAGATGCTAA	Hashtag3
TGGAGGAAGCCTTCTC	Negative
TGGAGGAAGTCGAAGC	Negative
TGGAGGAGTCTAACGT	Hashtag1
TGGATCACATTGGGAG	Negative
TGGATCAGTCAACATC	Hashtag1
TGGATCAGTTCTTGCC	Hashtag1
TGGATCATCTGTGTGA	Negative
TGGATGTAGTGCTCGC	Hashtag1
TGGATGTGTTGCCAAT	Negative
TGGATGTTCGGACTGC	Negative
TGGATGTTCTCTGCCA	Negative
TGGCGTGAGGACTGGT	Hashtag3
TGGCGTGCAATAGGAT	Negative
TGGCGTGGTCCAACGC	Negative
TGGCGTGGTTGAATCC	Negative
TGGGAAGAGGATCATA	Negative
TGGGAAGTCAGAGTGG	Negative
TGGGAAGTCCACTGAA	Hashtag3
TGGGAGAAGCCTTTCC	Hashtag3
TGGGAGAAGCGTTACT	Negative
TGGGAGAAGGGCGAGA	Hashtag3
TGGGAGAGTACGTGAG	Negative
TGGGAGAGTCGTGATT	Hashtag1
TGGGAGAGTTCCAAAC	Hashtag3
TGGGAGAGTTCCATTT	Negative
TGGGAGATCATTATCC	Hashtag1
TGGGAGATCTCTGACC	Hashtag1
TGGGATTAGCGTTGTT	Negative
TGGGATTCAGCGAGTA	Hashtag3
TGGGATTCATTGGGAG	Negative
TGGGATTGTAACCCTA	Negative
TGGGCGTAGCTGTCCG	Negative
TGGGCGTAGTAAGACT	Negative
TGGGCGTCATCGATAC	Hashtag3
TGGGCGTGTCAGCGTC	Negative
TGGGCGTTCATCTATC	Negative
TGGGCGTTCCTATGGA	Negative
TGGGCTGCAAATCGTC	Negative
TGGGCTGGTTCCCAAA	Negative
TGGGCTGTCCATACTT	Negative
TGGGTTACACTGTGTA	Hashtag1
TGGGTTAGTTATGTCG	Negative
TGGGTTATCCATCTAT	Hashtag3
TGGTACAAGCTGCCAC	Negative
TGGTACACAGGCCTGT	Hashtag3
TGGTACATCACTGTCC	Negative
TGGTACATCTACCTTA	Hashtag3
TGGTAGTAGACTACCT	Hashtag3
TGGTAGTAGCGTGTTT	Negative
TGGTAGTAGGATATGT	Hashtag3
TGGTAGTAGTCGTCTA	Hashtag3
TGGTAGTCAAGGGCAT	Negative
TGGTAGTGTCAGGAGT	Negative
TGGTAGTGTGAGTGAC	Negative
TGGTAGTGTTAAGGAT	Hashtag1
TGGTGATAGAAGCCTG	Hashtag1
TGGTGATAGACCGCCT	Hashtag1
TGGTGATAGATTGGGC	Negative
TGGTGATCAACGATCT	Negative
TGGTGATGTCACGTGC	Negative
TGGTTAGAGTATTGCC	Negative
TGGTTAGAGTCTAACC	Negative
TGGTTAGCAATCAGCT	Negative
TGGTTAGCAATGAAAC	Hashtag3
TGTAACGCAACGTTAC	Hashtag3
TGTAACGCATGAGGGT	Hashtag1
TGTAACGGTAGTATAG	Hashtag3
TGTAACGGTTCGTGCG	Negative
TGTAACGTCCGTCCTA	Negative
TGTAAGCAGTATAGGT	Hashtag3
TGTAAGCCATCCTCAC	Negative
TGTAAGCTCCGTGCGA	Hashtag3
TGTAAGCTCTGCGAGC	Negative
TGTACAGCATCCCGTT	Negative
TGTACAGCATTACGGT	Negative
TGTACAGGTAACACGG	Hashtag3
TGTACAGGTATCTCGA	Negative
TGTACAGGTGGCCCAT	Hashtag3
TGTAGACAGCACTCAT	Negative
TGTAGACAGCATACTC	Negative
TGTAGACAGCCTTTCC	Negative
TGTAGACTCGGAGTGA	Negative
TGTCAGAAGAGAAGGT	Hashtag1
TGTCAGAGTCGAGTTT	Hashtag1
TGTCAGAGTGAGGCAT	Negative
TGTCAGATCCGTGCGA	Negative
TGTCCACAGGACTTCT	Negative
TGTCCACTCCTAGCGG	Hashtag1
TGTCCCAAGGAAGTCC	Negative
TGTCCCAAGGTCGTAG	Negative
TGTCCCAAGTTTCGGT	Negative
TGTCCCAGTGACAGCA	Hashtag1_Hashtag3
TGTCCCATCGAGTTGT	Negative
TGTCCCATCGCCAATA	Negative
TGTCCTGGTAGATCGG	Hashtag3
TGTGAGTCACGGCGTT	Hashtag1
TGTGAGTGTCCCTCAT	Hashtag3
TGTGAGTGTGCCTACG	Negative
TGTGAGTGTGTTGATC	Negative
TGTGAGTTCTCCTGTG	Negative
TGTGATGCACCGTCGA	Negative
TGTGATGCACCTCGTT	Negative
TGTGATGCAGAGTGTG	Negative
TGTGATGCAGGTACGA	Negative
TGTGATGGTAACTAAG	Negative
TGTGATGGTACAATAG	Negative
TGTGATGGTTAACAGA	Negative
TGTGCGGAGGTCATCT	Hashtag3
TGTGCGGGTGAGATAT	Hashtag1
TGTGGCGGTACTCCGG	Hashtag1
TGTGGCGGTCTTGTCC	Negative
TGTGGCGGTGGCATCC	Hashtag3
TGTGGCGTCCTTGAAG	Hashtag3
TGTGGCGTCGGCACTG	Hashtag1
TGTGTGACAAATGATG	Hashtag1
TGTGTGACACAGCTGC	Negative
TGTGTGACAGTGTATC	Negative
TGTGTGACATACCACA	Negative
TGTGTGAGTACTCAAC	Hashtag1
TGTTACTCAAAGTATG	Negative
TGTTACTCAACAAGAT	Negative
TGTTACTCAATGAGCG	Negative
TGTTACTCACACCAGC	Hashtag3
TGTTACTCAGAGTTCT	Negative
TGTTACTCATGAGGGT	Negative
TGTTACTGTTGGATCT	Negative
TGTTACTTCACTTATC	Negative
TGTTCATAGCAATAGT	Negative
TGTTCCGAGGCATTTC	Negative
TGTTCCGAGGTGCATG	Negative
TGTTCCGGTCGGTGAA	Negative
TGTTCCGTCTATCCAT	Negative
TGTTCTAAGCCTCAGC	Negative
TGTTCTAAGCGGTATG	Negative
TGTTCTAAGGATGAGA	Negative
TGTTCTACAAACTAAG	Negative
TGTTGAGAGGGCAGAG	Negative
TGTTGAGCACCAAAGG	Hashtag3
TGTTGAGGTAGCTTAC	Negative
TGTTGAGTCGGCATAT	Negative
TGTTGGAAGCCACCGT	Negative
TGTTGGATCGTCTAAG	Negative
TGTTTGTAGGCCTGAA	Hashtag3
TGTTTGTGTAACACCT	Hashtag1
TTAATCCAGCACCGTC	Negative
TTAATCCCACGCGGTT	Negative
TTAATCCCAGAGGTAC	Negative
TTAATCCGTGAGTTTC	Negative
TTAATCCGTTAGAAGT	Negative
TTACAGGAGCATCTTG	Hashtag1
TTACAGGAGCGACTTT	Hashtag3
TTACAGGCATTACTCT	Negative
TTACAGGGTGGTCTTA	Negative
TTACAGGTCTTGGGCG	Negative
TTACCATCACATATCG	Hashtag3
TTACCATCACTCAAGT	Negative
TTACCATTCCTTCACG	Negative
TTACCGCAGAATTTGG	Negative
TTACCGCAGGTAACTA	Negative
TTACCGCGTAAGCGGT	Negative
TTACCGCGTCATCGGC	Hashtag1
TTACCGCGTCGATTCA	Hashtag3
TTACCGCGTGGTAATA	Negative
TTACCGCGTGTTTGCA	Negative
TTACGCCAGAGAGCGG	Hashtag1
TTACGCCAGCCTCATA	Negative
TTACGCCAGTACGAGC	Negative
TTACGCCCACATAGCT	Negative
TTACGCCCACGGGCTT	Negative
TTACGCCCAGACCTAT	Negative
TTACGCCGTTGCTCCT	Negative
TTACGCCTCAAGCCAT	Negative
TTACGTTAGAGCAGAA	Negative
TTACGTTAGGATGCGT	Hashtag1
TTACGTTGTTGTGCAT	Negative
TTACTGTCAAGCCCAC	Negative
TTACTGTGTGCAATGG	Negative
TTACTGTTCAGCTTCC	Negative
TTAGGCAAGGAACGAA	Negative
TTAGGCACAGCGCTTG	Negative
TTAGGCAGTACTGACT	Negative
TTAGGCAGTAGCGTTT	Hashtag3
TTAGGCAGTAGTATAG	Hashtag3
TTAGGCAGTCGCATCG	Hashtag1
TTAGGCATCAAATAGG	Hashtag1
TTAGGGTAGCAACTTC	Negative
TTAGGGTAGGACAGTC	Hashtag1
TTAGGGTAGTTACGGG	Negative
TTAGGGTCAGACTCTA	Negative
TTAGGGTCAGATTAAG	Hashtag3
TTAGGGTGTAGTCCTA	Negative
TTAGTCTCACTTGACA	Negative
TTAGTCTCAGACGCTC	Negative
TTAGTCTCAGATCCAT	Negative
TTAGTCTGTGTCTTAG	Hashtag1
TTAGTCTTCACGAGGA	Negative
TTATTGCAGAGCGACT	Hashtag3
TTATTGCGTCAAGTTC	Negative
TTCAATCAGTTAGTAG	Negative
TTCAATCCACCAGCTG	Negative
TTCAATCCACGACCTG	Hashtag3
TTCAATCTCGAAGCAG	Negative
TTCAATCTCTTTGCGC	Hashtag3
TTCACCGAGAACTGAT	Hashtag1
TTCACCGAGGTGTGAC	Negative
TTCACCGCAATTGGTC	Hashtag1
TTCACCGCACACTTAG	Hashtag3
TTCACCGGTAGTGGCA	Negative
TTCACCGGTTCCGCAG	Negative
TTCACCGGTTTCGTAG	Hashtag1
TTCACGCAGGTTAGTA	Negative
TTCACGCCAATGGCAG	Negative
TTCACGCCACATACGT	Negative
TTCACGCTCAGCGGAA	Negative
TTCACGCTCGTAGGGA	Negative
TTCAGGAAGGTCGCCT	Hashtag3
TTCAGGAAGTTCATGC	Hashtag1
TTCAGGACAGTCTTCC	Hashtag3
TTCATGTGTGGCCTCA	Hashtag3
TTCATTGCACACTGGC	Negative
TTCATTGGTATCCCTC	Negative
TTCATTGTCTCTATGT	Hashtag1
TTCCAATAGCTGTTCA	Hashtag3
TTCCAATGTACAGTCT	Hashtag1_Hashtag3
TTCCAATTCATGGTAC	Negative
TTCCAATTCCCGTTCA	Negative
TTCCAATTCGGCACTG	Negative
TTCCACGAGAAGATCT	Negative
TTCCACGCAAGAAACT	Hashtag3
TTCCACGCAAGCGATG	Negative
TTCCACGCAGGCTACC	Negative
TTCCACGGTACGACAG	Negative
TTCCACGGTCATTCCC	Hashtag3
TTCCACGGTTGATGTC	Negative
TTCCGGTAGATGACAT	Hashtag3
TTCCGGTAGGAACGTC	Hashtag1
TTCCGGTCATGTCAGT	Hashtag3
TTCCGGTTCAATCGGT	Negative
TTCCGGTTCCGCAACG	Hashtag1
TTCCGGTTCTATGCCC	Negative
TTCCGTGAGCACACCC	Negative
TTCCGTGAGGCACGAT	Hashtag1
TTCCGTGGTCTGTGAT	Negative
TTCCGTGTCGCAGATT	Negative
TTCCTAACAACATACC	Negative
TTCCTAAGTGCCGTTG	Negative
TTCCTAAGTTTCGATG	Negative
TTCCTAATCTGAGCAT	Hashtag3
TTCCTCTGTACTTCCC	Negative
TTCCTCTGTGAGATAT	Hashtag1
TTCCTTCGTGACTGTT	Hashtag1
TTCGATTAGTCCCGAC	Negative
TTCGATTCAAATAAGC	Hashtag1
TTCGATTTCCATCTAT	Hashtag1
TTCGCTGTCCGTAGTA	Negative
TTCGCTGTCCTACGAA	Negative
TTCGCTGTCTCACGAA	Hashtag3
TTCGGTCCATGTCGTA	Hashtag1
TTCTAACCAAGTGCAG	Hashtag3
TTCTAACCAGCTATAC	Hashtag1
TTCTAACCATTGTACG	Hashtag3
TTCTAACGTATCGTGT	Negative
TTCTAGTCAAGCCCAC	Negative
TTCTAGTTCGCTGTCT	Negative
TTCTAGTTCTCTCGAC	Negative
TTCTCTCAGACTCCGC	Negative
TTCTCTCAGAGGCCAT	Negative
TTCTCTCAGGCGTTGA	Negative
TTCTCTCAGTCAGAGC	Hashtag1
TTCTCTCCAACGGCCT	Hashtag1
TTCTCTCCAACTTGGT	Hashtag1
TTCTCTCCAGTCGCTG	Hashtag1
TTCTCTCGTATAGGGC	Hashtag1
TTCTCTCGTCACCACG	Hashtag3
TTCTCTCGTGCTCCGA	Hashtag1
TTCTCTCGTTTGATCG	Negative
TTCTCTCTCCTAGCGG	Hashtag3
TTCTCTCTCGCCTTTG	Hashtag1
TTCTCTCTCGGTCAGC	Negative
TTCTGTAAGGTCTACT	Negative
TTCTGTACATGGAATA	Negative
TTCTGTACATGTGTCA	Hashtag3
TTCTGTATCACACGAT	Negative
TTCTGTATCCATATGG	Hashtag3
TTCTTCCAGAAGTGTT	Negative
TTCTTCCGTAGGGTAC	Hashtag1
TTCTTCCTCATCACAG	Negative
TTCTTCCTCCAAGAGG	Negative
TTCTTCCTCCAGCCTT	Negative
TTCTTCCTCTAAGGAA	Negative
TTCTTCCTCTTCCACG	Negative
TTCTTGAAGAGGTTTA	Hashtag3
TTCTTGACAATGAAAC	Hashtag3
TTCTTGATCATGCAGT	Negative
TTCTTGATCTCGACGG	Hashtag3
TTCTTGATCTTAGCCC	Negative
TTGAACGTCAGGAAAT	Negative
TTGAACGTCTTGGTGA	Negative
TTGACCCAGAGGTATT	Hashtag1
TTGACCCAGGCCGCTT	Negative
TTGACCCCACCCAATA	Negative
TTGACCCCATGTCAGT	Negative
TTGACCCTCCTATGGA	Negative
TTGACCCTCGGTCAGC	Negative
TTGAGTGAGCTTAAGA	Negative
TTGAGTGCACTAACGT	Negative
TTGAGTGCATCCGGCA	Negative
TTGAGTGCATCTTTCA	Negative
TTGATGGAGGTAAGAG	Hashtag3
TTGATGGCACAGGATG	Hashtag1
TTGCATTCAATCAAGA	Negative
TTGCATTCAGTCCGTG	Negative
TTGCATTCATACATCG	Negative
TTGCATTGTTGGGTAG	Negative
TTGCATTTCACTGAAC	Hashtag3
TTGCCTGCACAGGATG	Hashtag1
TTGCCTGCAGGTGTTT	Negative
TTGCCTGCATGACGGA	Negative
TTGCGTCAGACCTCCG	Negative
TTGCGTCGTAAGGAGA	Negative
TTGCGTCTCTACCCAC	Hashtag3
TTGCTGCAGATCCAAA	Hashtag1
TTGCTGCGTACTCCCT	Negative
TTGGATGAGTACTGTC	Hashtag3
TTGGATGGTGATTAGA	Hashtag3
TTGGATGGTTACCGTA	Negative
TTGGATGTCGCATTAG	Hashtag1
TTGGGATAGAATTCAG	Hashtag1
TTGGGATAGCGTTAGG	Hashtag3
TTGGGATAGCTGGTGA	Hashtag3
TTGGGATCAACGGCTC	Hashtag3
TTGGGATCACCCTTGT	Hashtag3
TTGGGATGTCCCGTGA	Hashtag1
TTGGGATGTGCCTTCT	Hashtag3
TTGGGCGAGGAAGTCC	Negative
TTGGGCGCAACGCCCA	Negative
TTGGGCGCATGGGCAA	Negative
TTGGGTAAGGGATCTG	Negative
TTGGGTACAGTTCCAA	Negative
TTGGGTAGTAGCTGCC	Negative
TTGGGTAGTAGGACTG	Negative
TTGGGTAGTCGCTTGG	Negative
TTGGGTAGTTGACTAC	Negative
TTGGGTATCGCATTGA	Hashtag3
TTGGTTTAGCTGACTT	Negative
TTGGTTTCAGCTAACT	Hashtag3
TTGGTTTCATCTCATT	Hashtag1
TTGGTTTCATCTTTCA	Negative
TTGGTTTGTATGAGGC	Hashtag3
TTGGTTTGTCGTCGGT	Hashtag1_Hashtag3
TTGGTTTGTCTATGAC	Hashtag1
TTGTGGACAAGATGGC	Negative
TTGTGGAGTTGCAACT	Negative
TTGTGTTAGCTAATCC	Negative
TTGTGTTAGGCACCAA	Negative
TTGTGTTAGTAGGGTC	Hashtag3
TTGTGTTCAAGAGTGC	Negative
TTGTGTTGTAGAGCTG	Hashtag3
TTGTGTTGTCGGAACA	Negative
TTGTGTTTCCGATAAC	Hashtag1
TTGTTCAAGGTATAGT	Negative
TTGTTGTCAGAGACTG	Hashtag1
TTGTTGTGTGTTGATC	Hashtag3
TTGTTGTTCACTTATC	Hashtag3
TTGTTTGCAGACTCTA	Negative
TTGTTTGGTAGGCTCC	Negative
TTGTTTGGTGTTAGCT	Hashtag1
TTGTTTGTCTATCGTT	Negative
TTGTTTGTCTCGGCTT	Negative
TTTACCAAGTCATTGC	Negative
TTTACCACATAACTCG	Negative
TTTACCAGTTGCTTGA	Negative
TTTACCATCTCCTGAC	Hashtag3
TTTACGTAGCCGAACA	Hashtag1
TTTACGTAGTAGTCCT	Negative
TTTACGTCAGCCGGTT	Negative
TTTACGTGTCCATAGT	Negative
TTTACGTGTCCCTAAA	Negative
TTTACTGAGCTCGTGC	Negative
TTTACTGAGCTGCCAC	Negative
TTTACTGCACCGTCGA	Hashtag1
TTTACTGCACTTGAAC	Hashtag1
TTTACTGGTCGTTGCG	Negative
TTTACTGGTGAGGATC	Negative
TTTACTGTCATCCCGT	Negative
TTTACTGTCGCGTGAC	Negative
TTTAGTCAGCTGACTT	Negative
TTTAGTCGTACCGGCT	Negative
TTTAGTCGTATGCTTG	Negative
TTTAGTCGTTAAGTCC	Hashtag3
TTTAGTCTCACACCCT	Negative
TTTAGTCTCACCTGGG	Negative
TTTATGCCAATTGAAG	Hashtag3
TTTATGCCACGGGTAA	Negative
TTTATGCGTGTCCATA	Negative
TTTATGCTCGTAGGGA	Hashtag1
TTTCACAAGCGATGAC	Negative
TTTCACACACATATCG	Negative
TTTCACACACCCTTAC	Hashtag1
TTTCACAGTGGTCCCA	Negative
TTTCACATCCATCTCG	Hashtag1
TTTCACATCCATGATG	Negative
TTTCAGTAGGGAGATA	Hashtag1
TTTCAGTAGGTACTGG	Hashtag1
TTTCAGTGTATCGCTA	Negative
TTTCAGTGTCACCCTT	Negative
TTTCAGTGTGTCCAAT	Hashtag3
TTTCAGTTCCCGTTGT	Hashtag3
TTTCAGTTCTGCGGAC	Negative
TTTCATGCACTGCTTC	Negative
TTTCATGCATTCACCC	Negative
TTTCATGGTAGATGTA	Negative
TTTCATGGTCAATCTG	Negative
TTTCATGGTCCCTAAA	Negative
TTTCATGGTTGCGGAA	Negative
TTTCCTCAGCCAGACA	Negative
TTTCCTCAGCCTATTG	Negative
TTTCCTCAGCGAATGC	Negative
TTTCCTCAGGAGCAAA	Negative
TTTCCTCAGTATGCAA	Negative
TTTCCTCGTGGCAACA	Hashtag3
TTTCCTCTCAAGAAAC	Hashtag1_Hashtag3
TTTCCTCTCAATCAGC	Negative
TTTCCTCTCACTCACC	Negative
TTTCGATAGTCCTGTA	Negative
TTTCGATAGTGGAAAG	Hashtag3
TTTCGATCATCCTATT	Hashtag1
TTTCGATGTCGTCATA	Hashtag3
TTTCGATGTGGCCTCA	Hashtag1
TTTCGATTCTGATTCT	Negative
TTTGACTAGTTACGGG	Hashtag3
TTTGACTCACATTACG	Negative
TTTGACTGTAACATCC	Negative
TTTGACTGTCCTGTTC	Negative
TTTGACTGTGAACTAA	Negative
TTTGACTGTGATTCTG	Negative
TTTGACTGTTCGTGCG	Negative
TTTGACTTCATCGCAA	Negative
TTTGACTTCCAAGCTA	Negative
TTTGATCAGGCTATCT	Negative
TTTGATCAGGGACTGT	Hashtag3
TTTGATCAGGTTCACT	Hashtag3
TTTGATCCAATCGCCG	Negative
TTTGATCCACTCCCTA	Negative
TTTGATCCACTTGTCC	Hashtag1
TTTGATCCAGCTACCG	Negative
TTTGATCGTGGCTGCT	Hashtag1
TTTGGAGGTGATACTC	Hashtag3
TTTGGAGGTGCAATAA	Hashtag3
TTTGGAGGTGCGTGCT	Negative
TTTGGAGTCACTGAAC	Hashtag1
TTTGGTTCAAGGCCTC	Hashtag1
TTTGGTTCAATGTCTG	Negative
TTTGGTTGTAACAGGC	Negative
TTTGGTTGTATCGAGG	Negative
TTTGGTTTCAGTGTGT	Negative
TTTGGTTTCCACCTCA	Negative
TTTGGTTTCCCGTAAA	Hashtag3
TTTGGTTTCGGTTCAA	Negative
TTTGGTTTCTCCTGTG	Hashtag1
TTTGTTGAGTGATTCC	Negative
TTTGTTGGTAACATCC	Hashtag3
TTTGTTGTCCAATCCC	Negative
