cells	sample
AAACCCAAGGGCAGGA	Hashtag11
AAACCCACACTGTCGG	Hashtag11
AAACCCAGTAGTCTTG	Hashtag11
AAACCCATCCGATGTA	Hashtag12
AAACGAAAGACGACTG	Negative
AAACGAAAGTACAGCG	Negative
AAACGAACACAACATC	Negative
AAACGAACAGGTGGAT	Negative
AAACGAACATCCGGTG	Hashtag11
AAACGAAGTCCCGGTA	Negative
AAACGAAGTCCTCATC	Negative
AAACGCTAGACTCAAA	Hashtag11
AAACGCTAGCACTCCG	Negative
AAACGCTAGGACCCAA	Negative
AAACGCTAGGTTCAGG	Negative
AAACGCTAGTAGCAAT	Negative
AAACGCTAGTAGCATA	Hashtag11
AAACGCTCAAGAGTTA	Negative
AAACGCTGTAACTAAG	Hashtag11
AAACGCTGTCCTTTGC	Negative
AAAGAACCATATGAAG	Hashtag11
AAAGAACGTATTTCTC	Negative
AAAGGATAGCCAAGCA	Negative
AAAGGATAGTGGTTGG	Hashtag12
AAAGGATCACTGGACC	Hashtag11
AAAGGATGTGACTGAG	Negative
AAAGGATGTTATAGAG	Hashtag11
AAAGGATTCACAAGGG	Hashtag11
AAAGGGCAGCGTGCTC	Hashtag11
AAAGGGCCACCAGCGT	Negative
AAAGGGCTCACCTCTG	Hashtag11
AAAGGGCTCATCACAG	Hashtag11
AAAGGGCTCGCTCTCA	Negative
AAAGGTAAGTGTACAA	Negative
AAAGGTAGTACCCACG	Negative
AAAGGTATCACGTAGT	Hashtag11
AAAGGTATCGCCTAGG	Hashtag11
AAAGTCCAGACTCCGC	Hashtag11
AAAGTCCAGCCGCTTG	Hashtag11_Hashtag12
AAAGTCCGTAACATCC	Hashtag12
AAAGTCCGTTAGAGAT	Negative
AAAGTGAAGCGTCAGA	Hashtag11
AAAGTGAAGGCGCTTC	Hashtag11
AAATGGAAGAGGGTCT	Hashtag11
AAATGGAAGTGGTTAA	Hashtag11
AAATGGACAGGACTAG	Hashtag11_Hashtag12
AAATGGATCCGCAGTG	Negative
AACAAAGAGCGGGTAT	Hashtag11
AACAAAGGTCTAGTGT	Hashtag11
AACAAAGGTGGCTACC	Hashtag11
AACAAAGTCGATAACC	Negative
AACAAAGTCTTTGCGC	Hashtag11
AACAACCCAACCGGAA	Hashtag11
AACAACCTCTTGCAGA	Hashtag11
AACAAGAAGATCGGTG	Negative
AACAAGACAAGAAATC	Negative
AACAAGACACGTCTCT	Negative
AACAAGACAGAGCGTA	Negative
AACAAGACAGGCGATA	Hashtag11
AACAAGATCTGAGTCA	Hashtag12
AACACACCAAGGATGC	Hashtag11
AACACACGTTACCCTC	Negative
AACACACTCACGGAGA	Negative
AACACACTCCCTATTA	Hashtag11
AACACACTCGCGGACT	Negative
AACAGGGAGGTTCTAC	Hashtag11
AACAGGGAGTTTAGGA	Hashtag11
AACAGGGCAAGCTGCC	Hashtag12
AACAGGGCACAAGTTC	Negative
AACAGGGGTAGCGTCC	Hashtag11
AACAGGGTCTCCTGTG	Negative
AACCAACCAAAGGTTA	Hashtag11
AACCAACCAATGTGGG	Negative
AACCAACGTAATCAGA	Negative
AACCAACGTACGGTTT	Negative
AACCAACGTTAACCTG	Hashtag11
AACCAACTCAAGTCTG	Negative
AACCAACTCGAGCCAC	Negative
AACCACACATATGCGT	Negative
AACCACAGTAGGTCAG	Negative
AACCACAGTTTCCAAG	Hashtag11
AACCACATCCCAGTGG	Negative
AACCATGAGACAAGCC	Negative
AACCATGAGACTGAGC	Hashtag11
AACCATGAGTTGCCTA	Negative
AACCATGGTGTGGTCC	Negative
AACCATGTCAAATGCC	Negative
AACCATGTCGCGTGCA	Negative
AACCCAAAGCTTTCTT	Hashtag11
AACCCAACACAGTGTT	Hashtag11
AACCCAACACATGAAA	Hashtag11
AACCCAAGTGCCTACG	Negative
AACCCAAGTGTATTCG	Hashtag12
AACCTGATCAAGCCAT	Negative
AACCTGATCACTGATG	Hashtag11
AACCTGATCGCCAATA	Hashtag11
AACCTGATCGGTCACG	Negative
AACCTTTAGACCCTTA	Hashtag11
AACCTTTAGTTGAAGT	Hashtag11
AACCTTTGTCGTTGCG	Negative
AACCTTTTCCTGGGAC	Negative
AACGAAACACAACGTT	Negative
AACGAAAGTAACACGG	Hashtag11
AACGAAATCGTTGTTT	Hashtag11
AACGGGATCCACTGGG	Hashtag11
AACGGGATCTGGGCAC	Negative
AACGTCACAGCTTTGA	Negative
AACGTCACATATTCGG	Negative
AACGTCACATCCGTGG	Negative
AACTTCTAGTCTAGCT	Negative
AACTTCTCAGATCATC	Hashtag11
AACTTCTTCACGGGAA	Hashtag11
AACTTCTTCGAGATAA	Negative
AAGAACAAGACTAAGT	Negative
AAGAACAAGAGGTGCT	Negative
AAGAACAAGCTTGTGT	Hashtag11
AAGAACAGTGAGTGAC	Hashtag11
AAGAACAGTTACTCAG	Negative
AAGACAACAATCTCTT	Negative
AAGACAACACCGCTAG	Hashtag11
AAGACAAGTGTTGACT	Hashtag11
AAGACTCTCATGGCCG	Hashtag11
AAGACTCTCGGAATTC	Negative
AAGATAGAGACGCCCT	Hashtag11_Hashtag12
AAGATAGCATTGCCGG	Negative
AAGATAGGTATAGGGC	Hashtag12
AAGATAGGTCGAGTTT	Hashtag12
AAGATAGGTTCTCACC	Hashtag11
AAGCATCAGCACACCC	Negative
AAGCATCTCAAGCCTA	Negative
AAGCATCTCATGCCGG	Hashtag11
AAGCATCTCGTCGACG	Negative
AAGCATCTCGTCGGGT	Hashtag11
AAGCATCTCGTTATCT	Negative
AAGCCATAGATACATG	Negative
AAGCCATAGCAAGGAA	Negative
AAGCCATAGGGCATGT	Hashtag11
AAGCCATCATGTCTAG	Negative
AAGCCATGTCAAGTTC	Negative
AAGCCATGTCTTTCTA	Negative
AAGCCATTCGTCAGAT	Hashtag11
AAGCGAGAGAATCCCT	Negative
AAGCGAGAGAGCAACC	Hashtag11
AAGCGAGCAAATAGCA	Negative
AAGCGAGGTCATCCGG	Hashtag11
AAGCGAGTCCTCTTTC	Hashtag12
AAGCGTTAGACATGCG	Negative
AAGCGTTCAAGGTCGA	Negative
AAGCGTTCACTATCGA	Hashtag11
AAGCGTTTCTAGTTCT	Negative
AAGCGTTTCTTTCTAG	Negative
AAGGAATCAGGAATAT	Hashtag11
AAGGAATCATACCATG	Negative
AAGGAATGTAACTGCT	Negative
AAGGAATTCGTCGGGT	Hashtag11
AAGGAATTCTCCGTGT	Negative
AAGGTAACAATTGCTG	Hashtag12
AAGGTAATCAAGCCTA	Hashtag11
AAGTACCAGCCTGAAG	Negative
AAGTACCCATGACGGA	Hashtag11
AAGTACCGTCAAAGCG	Hashtag12
AAGTACCGTGCATGTT	Negative
AAGTCGTGTGAGCAGT	Negative
AAGTCGTGTTAGGCCC	Negative
AAGTGAACACCCTATC	Negative
AAGTGAAGTGGATGAC	Hashtag11
AAGTGAATCTTTCCGG	Hashtag11
AATAGAGAGCCTAGGA	Negative
AATAGAGTCGCATGAT	Hashtag11
AATCACGAGGGTTAGC	Negative
AATCACGCATCCGGTG	Negative
AATCACGGTGGCTGCT	Negative
AATCACGGTGTCCACG	Hashtag11
AATCACGTCGGAGATG	Negative
AATCGACAGCTAATGA	Negative
AATCGACCAACGTATC	Hashtag11
AATCGACCAGTCAGTT	Hashtag11
AATCGACCATCTCCCA	Hashtag11_Hashtag12
AATCGACCATTGACCA	Hashtag11
AATCGACTCCATTGCC	Negative
AATCGTGAGGATACGC	Hashtag11
AATCGTGAGGTCACAG	Negative
AATCGTGCACAAGGTG	Negative
AATCGTGCACTCAGAT	Negative
AATCGTGTCACATTGG	Negative
AATGAAGAGCAAGTCG	Negative
AATGAAGCAATCGAAA	Negative
AATGAAGGTCATAGTC	Negative
AATGAAGGTTCTGAGT	Hashtag11
AATGAAGTCGCAATGT	Hashtag11
AATGACCGTGGACTAG	Negative
AATGACCTCACTTGTT	Hashtag11
AATGCCAAGTATGAAC	Negative
AATGCCACAAGCTACT	Hashtag12
AATGCCACATTAGGAA	Negative
AATGCCAGTGATACCT	Hashtag12
AATGCCATCCGCTTAC	Hashtag11
AATGCCATCCTTATGT	Negative
AATGCCATCTCCGCAT	Hashtag11
AATGGAAAGAGGCGTT	Negative
AATGGAAAGGTACTGG	Hashtag11
AATGGAATCATTGTTC	Negative
AATGGAATCCAAGCCG	Hashtag11
AATGGAATCGAGAAAT	Negative
AATGGCTAGGGCTAAC	Hashtag11
AATGGCTCACATGACT	Negative
AATGGCTCATCAACCA	Negative
AATGGCTGTCTGTGGC	Negative
AATTCCTCAGTTTGGT	Hashtag11
AATTCCTCATGCCGGT	Hashtag11
AATTCCTGTTCCTTGC	Hashtag12
AATTCCTTCTGAGGCC	Negative
AATTTCCAGCACGATG	Negative
AATTTCCAGCCATATC	Negative
AATTTCCCAGTTTCGA	Hashtag11
AATTTCCTCAGGACAG	Hashtag11
AATTTCCTCGCCTAGG	Hashtag12
ACAAAGACAAATACAG	Negative
ACAACCAAGGCCCGTT	Hashtag11
ACAACCACAGCGCGTT	Negative
ACAACCACATACCATG	Hashtag11
ACAACCATCACGTAGT	Hashtag11
ACAACCATCATAGACC	Negative
ACAAGCTTCTGGGCGT	Hashtag11
ACACAGTCAACGATTC	Negative
ACACAGTCACCTGAAT	Negative
ACACAGTGTCCTGAAT	Hashtag11
ACACAGTTCGACCAAT	Negative
ACACCAAAGGTAAACT	Hashtag11
ACACCAAGTGACACGA	Hashtag11
ACACCAATCGTGTCAA	Negative
ACACCAATCGTTCCTG	Hashtag11
ACACGCGAGATACCAA	Negative
ACACGCGAGGTTCCGC	Negative
ACACGCGAGTCCTGCG	Hashtag11
ACACGCGAGTGAGTTA	Hashtag12
ACACGCGGTTAGTTCG	Hashtag11
ACACGCGTCCCTCTTT	Negative
ACACGCGTCGCACTCT	Hashtag11
ACACTGAAGCGCATCC	Hashtag11
ACACTGACACGATTCA	Negative
ACACTGAGTTGATGTC	Hashtag11
ACACTGATCACCTTGC	Hashtag11
ACACTGATCCGTGCGA	Negative
ACACTGATCTCTGACC	Negative
ACAGAAACAAGCGCAA	Hashtag12
ACAGAAACACAGAGAC	Negative
ACAGAAACATATCTGG	Hashtag11
ACAGCCGAGAGGATGA	Negative
ACAGCCGCAGACATCT	Hashtag12
ACAGCCGGTAGTTACC	Hashtag11
ACAGGGAAGCAACAGC	Hashtag11
ACAGGGAGTATCACGT	Hashtag11
ACATCCCAGAAAGCGA	Negative
ACATCCCAGGACCCAA	Negative
ACATCCCCAACCACGC	Hashtag11
ACATCCCCACGGGTAA	Negative
ACATCCCGTTAGCTAC	Negative
ACATCCCTCTTTCCAA	Hashtag11
ACATGCAAGATGCTTC	Negative
ACATGCAAGGGTGGGA	Hashtag11
ACATGCAAGTTGAAAC	Negative
ACATGCACAATACGAA	Hashtag11
ACATGCACATAAGCAA	Hashtag11
ACATGCAGTGTTGATC	Hashtag11
ACATGCAGTTGGTAGG	Hashtag11
ACATTTCAGAAGGCTC	Negative
ACATTTCAGAATTGCA	Hashtag12
ACATTTCGTATCCCAA	Hashtag11
ACATTTCGTCTACACA	Negative
ACATTTCGTGTTCGTA	Hashtag11
ACATTTCTCACCGCTT	Negative
ACATTTCTCTCAATCT	Negative
ACCAACAAGTCACTGT	Hashtag11
ACCAACAGTACTGCCG	Negative
ACCACAAAGCCTGAGA	Hashtag11
ACCACAAAGCTAAACA	Hashtag11
ACCACAAAGCTCAGAG	Hashtag11
ACCACAAAGTCCTGCG	Negative
ACCACAAGTACAGCGA	Negative
ACCACAAGTCCTATAG	Negative
ACCACAATCAGGTGTT	Negative
ACCACAATCCATTGTT	Negative
ACCATTTAGGCACCAA	Negative
ACCATTTAGGTGGTTG	Negative
ACCATTTCAAAGGTTA	Negative
ACCATTTGTCAAAGAT	Negative
ACCCAAAAGCGCAATG	Negative
ACCCAAAAGTTGTAAG	Hashtag11
ACCCAAACACTGGACC	Hashtag11
ACCCAAATCTCTCAAT	Negative
ACCCTCAAGGCCCACT	Negative
ACCCTCACACACGCCA	Hashtag11
ACCCTCAGTACCGTGC	Negative
ACCCTCAGTCGTGCCA	Negative
ACCCTCATCACGTCCT	Hashtag11
ACCCTCATCCAATGCA	Hashtag12
ACCCTTGAGTGGATAT	Hashtag11
ACCCTTGCAGCTCCTT	Negative
ACCCTTGGTAGCTGTT	Hashtag11
ACCGTTCAGCAGGCAT	Negative
ACCGTTCCACATTCTT	Hashtag11
ACCGTTCCATAATGAG	Hashtag11
ACCGTTCTCACTCCGT	Negative
ACCGTTCTCGCAGAGA	Hashtag12
ACCTACCAGGTACTGG	Hashtag11
ACCTACCCACTAGTAC	Negative
ACCTACCCAGAACCGA	Hashtag11
ACCTACCCAGGAATAT	Negative
ACCTACCGTCCTACGG	Negative
ACCTACCGTCTTGCGG	Negative
ACCTACCGTTGTGTTG	Hashtag12
ACCTACCTCCGGTTCT	Hashtag12
ACCTACCTCTGTCTCG	Hashtag11
ACCTGAACAAAGTATG	Hashtag11
ACCTGAACAGCCTATA	Negative
ACCTGAACATTGGATC	Hashtag12
ACCTGAAGTATGAGCG	Negative
ACCTGAAGTGTCCGGT	Hashtag12
ACCTGAATCCTATTGT	Hashtag12
ACCTGTCGTCTATGAC	Hashtag12
ACCTGTCGTTGAAGTA	Negative
ACGATCAAGTGATTCC	Negative
ACGATCACAACAGCCC	Hashtag11
ACGATCAGTAGCTTGT	Negative
ACGATCAGTGACATCT	Hashtag12
ACGATCAGTGGTCAAG	Hashtag11
ACGATCATCGTAATGC	Negative
ACGATGTAGACGGAAA	Negative
ACGATGTCAAACCGGA	Hashtag11
ACGATGTCACGGTAGA	Negative
ACGATGTGTGGACAGT	Negative
ACGATGTGTGTTAACC	Hashtag11
ACGATGTTCCGTATGA	Negative
ACGATGTTCGTAGGGA	Hashtag11
ACGCACGAGGTTCCGC	Hashtag12
ACGGAAGCACAGTCAT	Negative
ACGGAAGCATCTTCGC	Negative
ACGGAAGGTGCCGAAA	Negative
ACGGAAGTCAACCTCC	Hashtag11
ACGGAAGTCATAAGGA	Hashtag12
ACGGAAGTCATGACAC	Hashtag12
ACGGGTCGTAGCTTAC	Hashtag11
ACGGGTCGTATCGATC	Negative
ACGGGTCGTGCCCACA	Hashtag11
ACGGGTCTCATGGAGG	Hashtag11
ACGGTCGAGCAAGTCG	Hashtag11
ACGGTCGAGTCTGGAG	Negative
ACGGTCGGTGCCTTTC	Hashtag11
ACGGTCGGTGCTTATG	Negative
ACGGTCGTCTCAATCT	Hashtag11
ACGGTCGTCTTACCAT	Hashtag12
ACGGTTAAGGGTAATT	Hashtag11
ACGGTTAAGTAGCAAT	Negative
ACGGTTAGTGTTCCAA	Hashtag12
ACGTAACCACGTCGTG	Hashtag11
ACGTAACGTTCTCCTG	Negative
ACGTAACTCTACGCAA	Hashtag11
ACGTACAAGTGTACCT	Negative
ACGTACATCAAGGTGG	Negative
ACGTACATCAAGTCGT	Negative
ACGTAGTAGACCCGCT	Negative
ACGTAGTAGTCGGCCT	Hashtag11
ACGTAGTGTCCTCCAT	Hashtag11
ACGTAGTTCCCGAGTG	Hashtag12
ACGTCCTGTATCTCTT	Negative
ACGTTCCCAGGTTCAT	Negative
ACTACGAAGCGAGGAG	Hashtag11
ACTACGAAGTTTGTCG	Hashtag11
ACTACGACAAGTATAG	Hashtag11
ACTACGACACCAGACC	Negative
ACTACGACATCCGGCA	Hashtag11
ACTACGACATTGTGCA	Negative
ACTACGATCGGAAACG	Hashtag11
ACTATCTCAGAGGTTG	Hashtag11
ACTATCTTCGGCTGTG	Negative
ACTATCTTCGGCTTCT	Negative
ACTATGGGTACCAGAG	Hashtag11
ACTATGGGTCTGTTAG	Hashtag11
ACTATGGTCCGCTAGG	Hashtag11
ACTATGGTCTGAACGT	Hashtag11
ACTATTCAGATTAGCA	Hashtag11
ACTATTCGTATGAGAT	Hashtag11
ACTATTCGTCTTGGTA	Hashtag11
ACTATTCGTGAGAACC	Hashtag11
ACTATTCTCTCTCAAT	Negative
ACTCCCAGTAGAAACT	Negative
ACTCCCAGTCACTACA	Negative
ACTCCCAGTGACTCTA	Hashtag11
ACTCCCATCCAGTGTA	Negative
ACTCTCGGTCCTCAGG	Hashtag11
ACTCTCGTCATGGTAC	Negative
ACTGATGAGATAGCTA	Hashtag11
ACTGATGCAAGATTGA	Negative
ACTGATGTCAAACGTC	Hashtag11
ACTGCAACAATCCTAG	Hashtag11
ACTGCAAGTCGCGGTT	Hashtag12
ACTGCAAGTCGCGTCA	Hashtag11
ACTGCAATCAGAGCAG	Hashtag12
ACTGTCCAGCTATCCA	Negative
ACTGTCCAGCTGTTAC	Hashtag11
ACTGTCCCACTTCCTG	Negative
ACTGTCCGTCATTCCC	Hashtag11
ACTGTCCGTGCGGATA	Hashtag11
ACTGTCCTCACTGATG	Negative
ACTGTCCTCTCTTGCG	Hashtag11
ACTGTGACAACAGAGC	Hashtag11
ACTGTGACACTAAACC	Hashtag12
ACTGTGAGTACAAACA	Negative
ACTGTGAGTCACTTAG	Negative
ACTGTGAGTCAGTCGC	Negative
ACTGTGAGTCGATTTG	Hashtag11
ACTGTGATCAACTGGT	Negative
ACTTAGGAGGTTACCT	Hashtag11
ACTTAGGCAGAGATGC	Hashtag11_Hashtag12
ACTTAGGTCCAAGGGA	Negative
ACTTATCAGATTAGAC	Hashtag11
ACTTCCGAGAAATCCA	Hashtag11
ACTTCCGCATGTTACG	Negative
ACTTCGCAGGGAGAAT	Hashtag12
ACTTTCAAGACCCTTA	Hashtag11
ACTTTCACAACTGCCG	Hashtag11
ACTTTCACACTAACGT	Negative
ACTTTCACATTAAGCC	Hashtag11
ACTTTCATCCCTCTCC	Hashtag12
ACTTTGTAGACTTAAG	Negative
ACTTTGTAGGTTCACT	Hashtag11
ACTTTGTTCCAACTAG	Hashtag12
ACTTTGTTCCGAGTGC	Negative
AGAAATGAGCTAAACA	Hashtag11
AGAAATGAGGTCATTC	Negative
AGAAATGCACTACCCT	Hashtag11
AGAAATGGTCACTAGT	Negative
AGAAATGTCGCATTAG	Negative
AGAACAAAGACAGCGT	Hashtag11
AGAACAAAGGTCGCCT	Negative
AGAACAACAGCAGTGA	Hashtag11
AGAACAAGTACAGAAT	Negative
AGAACCTAGTTGCCTA	Hashtag11
AGAACCTCAATGAAAC	Hashtag11
AGAACCTCAATTGCCA	Hashtag12
AGAACCTCACGCTTAA	Negative
AGAACCTCATCGTGGC	Hashtag11
AGAACCTCATGACTAC	Hashtag11
AGAACCTTCAATCTTC	Hashtag11
AGAAGCGAGTCTAGAA	Negative
AGAAGCGAGTTGCGCC	Negative
AGAAGCGTCGGAATGG	Negative
AGAAGTACACTCCTTG	Negative
AGAAGTATCAATCAGC	Negative
AGAAGTATCCATTCAT	Negative
AGACAAAGTCTGCCTT	Hashtag11
AGACAAATCAGACTGT	Hashtag12
AGACACTGTGACTCGC	Hashtag12
AGACACTGTTGTCATG	Negative
AGACACTTCGACGTCG	Negative
AGACACTTCGTCTAAG	Hashtag11
AGACACTTCTACACTT	Negative
AGACAGGAGAGAATCT	Hashtag12
AGACAGGCAAATGGAT	Negative
AGACAGGCACTCCTTG	Hashtag11
AGACAGGCAGTCTTCC	Hashtag11
AGACCATAGATGAAGG	Negative
AGACCATAGCACTAGG	Negative
AGACCATAGTCGCCCA	Negative
AGACCATGTAAGGCTG	Negative
AGACCATTCAGTCATG	Hashtag11
AGACCCGAGCAATTCC	Hashtag11
AGACCCGCAGTTCACA	Hashtag11
AGACCCGGTACCTGTA	Negative
AGACCCGGTCACCTTC	Hashtag12
AGACCCGGTCTCAAGT	Hashtag11
AGACCCGGTGTATTCG	Negative
AGACCCGGTTAGTCGT	Hashtag12
AGACCCGTCCAAGCAT	Negative
AGACTCAAGATAACGT	Hashtag11
AGACTCACAACACTAC	Negative
AGACTCACAGCATGCC	Negative
AGACTCATCCAACCAA	Negative
AGAGAATCAATGACCT	Hashtag11
AGAGAATTCTGGCCTT	Negative
AGAGAGCAGGCGACAT	Negative
AGAGAGCGTTCTTAGG	Negative
AGAGAGCTCAAAGGAT	Negative
AGAGCAGAGAAGGCTC	Hashtag11
AGAGCAGTCTGCACCT	Hashtag11
AGAGCCCAGCACTCTA	Hashtag12
AGAGCCCGTGCCTACG	Hashtag11
AGATAGAAGGTAAGAG	Hashtag11
AGATAGAAGTGATAGT	Hashtag11
AGATAGACATGGGTTT	Hashtag11
AGATAGATCGAAGGAC	Hashtag11
AGATAGATCGGATTAC	Hashtag11
AGATCCACAAACACCT	Negative
AGATCCACACGGTGAA	Negative
AGATCCACATCTAACG	Hashtag11
AGATCCAGTGAACTAA	Hashtag11
AGATCCATCGCTTTAT	Negative
AGATCGTAGCCTCTTC	Hashtag11
AGATCGTAGGTCACAG	Negative
AGATCGTAGTGACCTT	Hashtag11
AGATCGTCAGATACCT	Negative
AGATCGTCAGGGATAC	Hashtag11
AGATCGTTCCTAGCCT	Negative
AGATCGTTCGTCCTCA	Hashtag11
AGATCGTTCTTCTTCC	Negative
AGATGAAAGATCACCT	Hashtag11
AGATGAAAGATCCTAC	Hashtag12
AGATGAAAGTCACTAC	Hashtag11
AGATGAACAATTGTGC	Hashtag11
AGATGAAGTACAGAAT	Negative
AGATGAAGTATCATGC	Hashtag11
AGATGAATCACTGGGC	Hashtag11
AGATGCTGTCGAATGG	Hashtag11
AGATGCTGTCTTCATT	Hashtag11
AGATGCTGTTCTCTCG	Hashtag11
AGATGCTTCCTATTGT	Hashtag11
AGATGCTTCCTCTAAT	Negative
AGCATCAAGAAATCCA	Hashtag11
AGCATCAAGATCGCTT	Negative
AGCATCAAGTTGTACC	Hashtag11
AGCATCACACACACTA	Hashtag12
AGCATCACAGTTAAAG	Hashtag11
AGCATCAGTAACAGGC	Hashtag11
AGCCAATCAACTACGT	Negative
AGCCAATGTTGCAACT	Hashtag11
AGCCACGTCCCTTCCC	Hashtag12
AGCCAGCCAACAGAGC	Negative
AGCCAGCCACAGTGTT	Negative
AGCCAGCGTCATTGCA	Negative
AGCCAGCGTCTAGGTT	Hashtag11
AGCCAGCGTGCCTAAT	Negative
AGCCAGCTCATTTCCA	Negative
AGCGATTTCTCCTGTG	Negative
AGCGCCAAGGAACTAT	Negative
AGCGCTGAGACGCAGT	Negative
AGCGCTGCAAGAAATC	Hashtag11
AGCGCTGCAGTAACCT	Negative
AGCGCTGCATTGACTG	Negative
AGCGCTGGTACCGTGC	Negative
AGCGCTGTCCTAACAG	Negative
AGCGCTGTCTACCACC	Negative
AGCGTATAGAGTACCG	Negative
AGCGTATAGTATGCAA	Hashtag11
AGCGTATCATCCTCAC	Negative
AGCGTATGTAATTGGA	Negative
AGCGTATTCGAGATAA	Negative
AGCGTATTCTCATGCC	Hashtag11
AGCTACACACTGGACC	Hashtag11
AGCTACAGTTTGCAGT	Negative
AGCTACATCCGTGTAA	Hashtag11
AGCTACATCGCCAACG	Negative
AGCTACATCGGTTAGT	Hashtag11
AGCTCAAGTCCAAATC	Hashtag11
AGCTCAAGTTGCAACT	Hashtag11
AGCTCAATCGACACCG	Hashtag11
AGCTTCCCAAGAATGT	Negative
AGCTTCCCACGACGCT	Hashtag11
AGGAAATAGGACACTG	Hashtag11
AGGAAATAGTCTGTAC	Hashtag12
AGGAAATGTAGGGAGG	Negative
AGGAATAAGGTACAAT	Negative
AGGACGAAGAGAAGGT	Negative
AGGACGATCATTACCT	Negative
AGGACTTGTACAATAG	Negative
AGGACTTTCGACGCGT	Negative
AGGAGGTAGGCCTAAG	Hashtag11
AGGAGGTCATGGAAGC	Hashtag11
AGGAGGTGTGCTTCAA	Hashtag11
AGGAGGTGTTGGGACA	Negative
AGGATAACACATATCG	Negative
AGGATAACATTCGATG	Negative
AGGATAAGTTCTTAGG	Hashtag12
AGGATCTAGCCACTCG	Negative
AGGATCTGTATCACGT	Hashtag11
AGGATCTGTCTGTCCT	Hashtag11
AGGATCTGTGACCGTC	Hashtag11
AGGATCTGTTGGTGTT	Negative
AGGCATTAGCACGGAT	Negative
AGGCATTCATATCTCT	Negative
AGGCATTGTAGAAACT	Hashtag11
AGGCCACAGAAGCCTG	Hashtag11
AGGCCACCACAGTCGC	Negative
AGGCCACCAGGGACTA	Hashtag11
AGGCCACGTGGCTTAT	Hashtag11
AGGCTGCCATGGCTAT	Negative
AGGCTGCGTCCATAGT	Negative
AGGCTGCTCATAGCAC	Negative
AGGCTGCTCCCAGGCA	Negative
AGGGAGTCAGAGATTA	Negative
AGGGAGTCAGCTTCCT	Hashtag11
AGGGCCTAGCTGGCCT	Hashtag11
AGGGCCTAGTGGTTAA	Hashtag11
AGGGCCTCAATTCACG	Hashtag11
AGGGCCTGTCCTCCAT	Hashtag11
AGGGCTCCAAGGTCAG	Negative
AGGGCTCCAAGTGCAG	Negative
AGGGCTCCACTGGACC	Negative
AGGGTCCCACTCCGAG	Negative
AGGGTCCCAGGTACGA	Negative
AGGGTCCGTGATTGGG	Negative
AGGGTCCTCCTAACAG	Negative
AGGGTGAGTGGGAGAG	Hashtag11
AGGGTTTAGTAGCATA	Negative
AGGGTTTCAGTGTGGA	Negative
AGGGTTTGTACAGCGA	Hashtag11
AGGGTTTGTCAAGGCA	Negative
AGGGTTTGTCGGCTAC	Negative
AGGGTTTTCGCCTAGG	Hashtag11
AGGTAGGCATACTTTC	Hashtag11
AGGTAGGGTATCATGC	Hashtag12
AGGTAGGGTTAGTTCG	Hashtag11
AGGTAGGTCTACCCAC	Negative
AGGTCATGTGCTGATT	Hashtag11
AGGTCATTCACTTTGT	Hashtag11
AGGTCATTCCATCTGC	Negative
AGGTCATTCGACCCAG	Hashtag11
AGGTCATTCGGATACT	Hashtag11
AGGTCTAAGCTCCCTT	Hashtag11
AGGTCTAAGTGTAGAT	Hashtag11
AGGTCTAGTGGATCGA	Negative
AGGTCTAGTTATTCCT	Negative
AGGTCTATCGGACCAC	Hashtag12
AGGTGTTAGAAGGGAT	Negative
AGGTGTTAGACATACA	Negative
AGGTGTTAGCCGAATG	Negative
AGGTGTTGTGTCTTGA	Hashtag11
AGGTGTTGTTGCAACT	Negative
AGGTGTTTCTGAACGT	Hashtag12
AGGTTACAGAGCACTG	Negative
AGGTTACAGGTAGGCT	Negative
AGGTTACAGTTATGGA	Negative
AGGTTACGTACGTACT	Negative
AGGTTACTCCGCTGTT	Negative
AGGTTACTCGCCAACG	Hashtag11
AGGTTGTGTTGCATCA	Hashtag11
AGTAACCAGTTAGTAG	Hashtag12
AGTAACCCACGTTCGG	Hashtag11
AGTAACCCAGGTGAGT	Hashtag11
AGTAACCGTCACGACC	Negative
AGTAACCGTCCCTGAG	Negative
AGTAACCGTCCTGGGT	Hashtag12
AGTAACCTCAGACAAA	Negative
AGTAACCTCTGCCTCA	Negative
AGTAACCTCTGTACAG	Negative
AGTACCAGTGTCCATA	Negative
AGTACCATCCATGCAA	Hashtag11
AGTACTGGTGCAGTGA	Hashtag11
AGTACTGGTTAAGGGC	Hashtag11
AGTAGCTAGGTAAAGG	Hashtag11
AGTAGCTAGTTGAATG	Hashtag11
AGTAGCTCAGGGACTA	Hashtag12
AGTAGCTTCACCTCTG	Hashtag11
AGTAGCTTCGACGATT	Hashtag11
AGTAGCTTCGTCTAAG	Negative
AGTAGCTTCGTTAGTG	Hashtag11
AGTAGTCAGAGCAGAA	Hashtag11
AGTAGTCCAACACACT	Negative
AGTAGTCGTAGCTGTT	Negative
AGTAGTCTCCTAGCGG	Hashtag11
AGTCACACACCCTAAA	Hashtag11
AGTCACACATGACGAG	Negative
AGTCACACATGGGTTT	Hashtag11
AGTCACAGTACCTAGT	Hashtag11
AGTCACAGTGTCACAT	Negative
AGTCACATCAACCTTT	Negative
AGTCACATCAACTTTC	Hashtag11
AGTCATGGTAGGGAGG	Negative
AGTCATGGTCGTGGAA	Hashtag11
AGTCATGGTGGCGTAA	Negative
AGTCATGTCGCTAATG	Negative
AGTCTCCAGGTCTACT	Negative
AGTCTCCCAAGAAACT	Negative
AGTCTCCGTACACGTT	Negative
AGTCTCCTCAGTCCGG	Negative
AGTCTCCTCATGGTAC	Hashtag11
AGTGACTAGGATACAT	Negative
AGTGACTCAGAGGTTG	Hashtag11
AGTGACTGTACACGTT	Negative
AGTGACTGTCTGCATA	Negative
AGTGACTGTCTTACTT	Negative
AGTGACTGTGAGAGGG	Negative
AGTGATCAGGAATTAC	Hashtag11
AGTGATCAGGTCACTT	Negative
AGTGATCCAGGATCTT	Hashtag11
AGTGATCCATGTGGCC	Hashtag11_Hashtag12
AGTGATCGTTTCGTAG	Negative
AGTGATCTCAGCATTG	Hashtag11
AGTGATCTCTTGGTCC	Hashtag11
AGTGCCGCAGGTCCCA	Hashtag11
AGTGCCGTCGGAATGG	Hashtag12
AGTGCCGTCTGTGTGA	Negative
AGTGTTGAGCAAGTGC	Negative
AGTGTTGAGGTTAAAC	Negative
AGTGTTGCAGACTCTA	Negative
AGTGTTGTCATCGCTC	Hashtag11
AGTGTTGTCGCACGAC	Hashtag11
AGTTAGCAGAACTTCC	Hashtag11
AGTTAGCAGTAGACCG	Negative
AGTTAGCCAACCACAT	Hashtag11
AGTTAGCCACTGAGGA	Hashtag12
AGTTAGCCATCGGCCA	Negative
AGTTAGCGTAGCGTTT	Hashtag12
AGTTAGCGTCCTCCTA	Hashtag11
AGTTAGCGTCCTTAAG	Negative
AGTTAGCGTCTTTCAT	Hashtag11
AGTTAGCTCACTACTT	Hashtag12
AGTTAGCTCAGAGTGG	Negative
AGTTCCCAGCCAACCC	Hashtag11
AGTTCCCCAACATACC	Hashtag11
AGTTCCCTCTTGTTAC	Hashtag11
AGTTCGACAATAGTGA	Hashtag11
AGTTCGACAATCTCGA	Negative
AGTTCGACAGAAGTGC	Negative
AGTTCGAGTACGGTTT	Hashtag11
AGTTCGATCTGAGATC	Hashtag11
ATACCGATCAAAGACA	Negative
ATACCTTCAAGTGACG	Negative
ATACCTTCAGGGCTTC	Hashtag12
ATACCTTGTAGCTGCC	Hashtag11
ATACCTTGTCTTGAGT	Negative
ATACCTTGTGTCCTAA	Negative
ATACTTCAGGCTCACC	Hashtag11
ATACTTCTCAGGTGTT	Negative
ATACTTCTCCACCTGT	Negative
ATACTTCTCTTCTTCC	Hashtag11
ATAGACCAGATGATTG	Hashtag11
ATAGACCCAATCAGCT	Negative
ATAGACCCAATCGCAT	Negative
ATAGACCCACCGAATT	Hashtag12
ATAGACCCAGGTCCCA	Negative
ATAGACCCATTCTTCA	Hashtag11
ATAGACCGTCCGGACT	Negative
ATAGACCTCCCTCTCC	Hashtag11
ATAGACCTCTTCCACG	Negative
ATAGAGAAGGATTACA	Hashtag12
ATAGAGAGTACAACGG	Negative
ATAGAGAGTTCTCCCA	Hashtag11
ATAGAGATCTTCTCAA	Negative
ATAGAGATCTTGGCTC	Hashtag11
ATAGGCTAGACTAGAT	Negative
ATAGGCTAGCAGGTCA	Hashtag11
ATAGGCTAGCGTACAG	Negative
ATAGGCTAGTGAGTTA	Negative
ATAGGCTCACTGCGAC	Hashtag11
ATATCCTCACCGTGAC	Negative
ATATCCTGTCTCGACG	Negative
ATATCCTGTTTCACAG	Negative
ATATCCTTCCACACAA	Negative
ATCACAGCAAGGTTGG	Negative
ATCACAGGTGACAGCA	Hashtag11
ATCACAGTCCTACACC	Hashtag11
ATCACAGTCGGCATTA	Hashtag12
ATCACGACAGAGCGTA	Hashtag11
ATCACGAGTCCCTCAT	Negative
ATCACGATCGTTTACT	Hashtag11
ATCACTTAGACCGTTT	Negative
ATCACTTAGACTAAGT	Negative
ATCACTTAGTCACACT	Hashtag11
ATCACTTCAAAGTATG	Negative
ATCACTTGTGCTCTTC	Negative
ATCACTTTCCGATGTA	Hashtag12
ATCAGGTCACATTGTG	Hashtag11
ATCAGGTTCATCACTT	Negative
ATCAGGTTCGGTCATA	Negative
ATCAGGTTCGGTCTGG	Hashtag11
ATCAGGTTCTCACGAA	Hashtag12
ATCAGGTTCTTACGTT	Hashtag11
ATCATTCAGCTCGTGC	Negative
ATCATTCCATCACCAA	Negative
ATCATTCTCCGTGGCA	Hashtag11
ATCCACCCACGACAGA	Hashtag12
ATCCACCGTAATTAGG	Hashtag12
ATCCACCTCCGAGAAG	Hashtag11
ATCCATTCACATTGTG	Negative
ATCCATTCACTGGCGT	Hashtag11
ATCCCTGAGTAGACCG	Negative
ATCCCTGGTCACCTTC	Hashtag12
ATCCCTGGTCGAATGG	Negative
ATCCCTGGTGTCATCA	Hashtag11
ATCCCTGTCGTTAGAC	Negative
ATCCCTGTCTCGTTTA	Negative
ATCCGTCAGACAACTA	Hashtag11
ATCCGTCCAGGCACAA	Negative
ATCCGTCTCCTAAGTG	Hashtag11
ATCCGTCTCGGCACTG	Negative
ATCCTATCACAACCGC	Negative
ATCCTATCACCAGCGT	Negative
ATCCTATCATGTCTAG	Negative
ATCCTATGTGTCCACG	Negative
ATCCTATGTTGACTGT	Negative
ATCCTATGTTGTGGCC	Hashtag11
ATCCTATTCGAACGGA	Negative
ATCGATGAGCGCTGCT	Negative
ATCGATGAGTAATCCC	Hashtag12
ATCGATGCACACGCCA	Negative
ATCGATGCACTAGGCC	Hashtag11
ATCGATGGTACGGGAT	Negative
ATCGATGTCAATGTCG	Hashtag11
ATCGCCTGTAGGAGGG	Negative
ATCGCCTGTCTAGGCC	Negative
ATCGCCTTCTCGCTCA	Negative
ATCGGATAGGTTCAGG	Hashtag11
ATCGGATGTGAGTTGG	Hashtag11
ATCGGATTCAAAGGAT	Hashtag11
ATCGGCGAGTGGTTGG	Negative
ATCGGCGGTAAGATAC	Hashtag11
ATCGGCGGTTAGCGGA	Hashtag11
ATCGGCGGTTAGTTCG	Hashtag11
ATCGGCGGTTCCAAAC	Hashtag11
ATCGTAGAGGGTGAGG	Hashtag11
ATCGTAGAGTTGAATG	Hashtag11
ATCGTAGCAACCTATG	Hashtag12
ATCGTAGCACAGCCAC	Hashtag11
ATCGTAGGTTTCACAG	Hashtag12
ATCGTAGTCACCTCTG	Hashtag12
ATCGTCCCATCCTCAC	Negative
ATCGTCCGTCTGTGAT	Hashtag12
ATCGTGAAGCTCAGAG	Negative
ATCGTGAGTCGCACAC	Hashtag11
ATCTCTAAGAGCTGCA	Hashtag11
ATCTCTACATTGAGCT	Negative
ATCTCTATCAATGTCG	Negative
ATCTTCACATCCTTCG	Negative
ATCTTCAGTTGGCCTG	Negative
ATGAAAGAGGGCAGGA	Negative
ATGAAAGCATTAAAGG	Negative
ATGAAAGGTTTGACAC	Negative
ATGAAAGTCCTACACC	Hashtag11
ATGACCAAGGGATGTC	Negative
ATGACCAAGGTAAGAG	Negative
ATGACCAGTACTCCGG	Hashtag12
ATGACCAGTTCAGCGC	Negative
ATGACCATCCTCTTTC	Negative
ATGACCATCGGACTGC	Hashtag11
ATGACCATCTGCGTCT	Negative
ATGAGGGAGGATACCG	Hashtag11
ATGAGGGCATGACTAC	Negative
ATGAGGGGTGCGTGCT	Hashtag11
ATGAGGGGTGTTCCTC	Hashtag12
ATGAGGGTCACTACTT	Negative
ATGAGGGTCGTGGGTC	Negative
ATGAGTCCAGCAGTTT	Negative
ATGAGTCGTGCAACGA	Negative
ATGAGTCTCGAGTTGT	Negative
ATGAGTCTCTATCGGA	Hashtag11
ATGAGTCTCTCTATAC	Hashtag11
ATGATCGAGGAGTATT	Hashtag11
ATGATCGAGGTCCGAA	Hashtag11
ATGATCGTCTTTCAGT	Negative
ATGCCTCGTAGCTTTG	Negative
ATGCCTCGTCAAAGTA	Negative
ATGCCTCGTCACTAGT	Hashtag11
ATGCCTCGTCCTGGTG	Hashtag11
ATGCCTCTCCAAATGC	Hashtag11
ATGCGATAGACGCAGT	Negative
ATGCGATAGATTCGCT	Negative
ATGCGATAGCCTCTCT	Hashtag11_Hashtag12
ATGCGATAGGATCATA	Hashtag11
ATGCGATCAAGGCTTT	Hashtag11
ATGCGATCAGCTCATA	Negative
ATGCGATGTGACTGAG	Negative
ATGGAGGCACGGGTAA	Hashtag12
ATGGAGGCAGAATTCC	Hashtag12
ATGGAGGCATCCTTGC	Negative
ATGGAGGTCACTACTT	Negative
ATGGAGGTCTCGGTAA	Hashtag11
ATGGATCAGACCGCCT	Negative
ATGGATCAGAGTATAC	Hashtag11
ATGGATCGTTCAGGTT	Hashtag11
ATGGATCGTTGGATCT	Hashtag11
ATGGATCTCCACGAAT	Hashtag11
ATGGGAGAGCGTTACT	Hashtag11
ATGGGAGCAACACGAG	Negative
ATGGGAGCAGGACTTT	Negative
ATGGGAGCAGTTTGGT	Hashtag11
ATGGGAGCATGTCTAG	Negative
ATGGGAGGTACCCGAC	Hashtag11
ATGGGAGGTCGTACAT	Hashtag11
ATGGGAGTCGCTGATA	Negative
ATGGGAGTCTCTCCGA	Negative
ATGGGTTCAAAGGCTG	Negative
ATGGGTTGTTACAGCT	Hashtag11
ATGGTTGAGTTAGTGA	Hashtag11
ATGGTTGCAAGATGTA	Hashtag11
ATGGTTGCAAGCTACT	Hashtag11
ATGTCCCAGCAGGCTA	Hashtag12
ATGTCCCAGGCACTCC	Hashtag11
ATGTCCCCAGAAACCG	Negative
ATGTCCCTCCCTCATG	Negative
ATGTCCCTCCCTGGTT	Negative
ATGTCTTAGACTCTTG	Hashtag11
ATGTCTTCACTGTGTA	Hashtag12
ATGTCTTGTACCTGTA	Negative
ATGTCTTGTTCCGCTT	Hashtag11
ATGTCTTTCAAGCCGC	Hashtag11
ATGTCTTTCCATGATG	Hashtag11
ATGTCTTTCGCATGAT	Hashtag11
ATTACCTAGTTAGAAC	Hashtag12
ATTACCTTCCTAACAG	Negative
ATTACCTTCCTCTCGA	Hashtag11_Hashtag12
ATTACCTTCGCGATCG	Negative
ATTACTCAGAAGCCTG	Negative
ATTACTCCAAATTGGA	Negative
ATTATCCAGCGCCATC	Negative
ATTATCCCAACGGTAG	Hashtag11
ATTATCCCACAGCATT	Negative
ATTATCCGTGCTAGCC	Negative
ATTATCCTCTCTCGCA	Hashtag11
ATTCACTAGGGCAGGA	Hashtag11
ATTCACTAGGGTCTTT	Negative
ATTCACTCACAACCGC	Negative
ATTCACTCACGAAAGC	Hashtag11
ATTCACTCAGAGTGAC	Negative
ATTCACTGTAGCGATG	Negative
ATTCACTGTCGTAATC	Negative
ATTCAGGCACAAGCAG	Hashtag11
ATTCAGGGTGCTATTG	Negative
ATTCAGGTCACTGATG	Hashtag11
ATTCAGGTCGGCCAAC	Negative
ATTCATCTCACCATGA	Negative
ATTCATCTCACGATAC	Negative
ATTCCATCAACACAAA	Hashtag11
ATTCCATCAAGTATCC	Hashtag11
ATTCCATCACTGTTCC	Hashtag11
ATTCCATCAGACCAAG	Negative
ATTCCATGTAGAGCTG	Negative
ATTCCCGAGCTCCCTT	Negative
ATTCCCGCATTGACCA	Hashtag11
ATTCCCGTCGCCTTTG	Hashtag12
ATTCCCGTCTAGGCAT	Negative
ATTCCTACAACCAATC	Negative
ATTCCTAGTTGGGCCT	Negative
ATTCCTATCTCGTTTA	Hashtag11
ATTCGTTAGCCATTTG	Negative
ATTCGTTAGGTAAACT	Negative
ATTCGTTGTTAAGTCC	Hashtag11
ATTCGTTTCATTACCT	Negative
ATTCTACCAAAGGATT	Hashtag12
ATTCTACGTAGAGATT	Negative
ATTCTTGGTATGCAAA	Negative
ATTCTTGTCCTGTACC	Negative
ATTGGGTAGCCTTTCC	Hashtag11
ATTGGGTCACAAGTTC	Hashtag11
ATTGGGTTCAGGGATG	Negative
ATTGTTCAGCGCCTAC	Negative
ATTGTTCAGCTTGTGT	Negative
ATTGTTCCAAGCCTGC	Hashtag12
ATTGTTCCACAAGGTG	Negative
ATTGTTCCAGTTTGGT	Hashtag11
ATTGTTCTCACCATCC	Negative
ATTGTTCTCCTCAGAA	Negative
ATTGTTCTCGCATTAG	Hashtag12
ATTGTTCTCGTAGTGT	Hashtag11
ATTGTTCTCGTTCCCA	Hashtag12
ATTTACCCATGCCGCA	Negative
ATTTACCCATTCAGCA	Hashtag11
ATTTACCGTAGCTGCC	Negative
ATTTACCGTCAGTCGC	Negative
ATTTACCGTCGCGGTT	Hashtag11
ATTTACCGTCGCTGCA	Negative
ATTTACCTCCTTCTTC	Hashtag11
ATTTCACCACCTCTAC	Hashtag12
ATTTCACCAGCATCTA	Hashtag11
ATTTCACGTCTAGATC	Negative
ATTTCTGCAACCACGC	Hashtag11
ATTTCTGGTAGTTACC	Hashtag11
ATTTCTGTCGTCTAAG	Hashtag11
CAAAGAAAGAGAACCC	Hashtag12
CAAAGAAAGCAACTCT	Negative
CAAAGAAAGTAGAATC	Hashtag11
CAAAGAAGTAGTCGGA	Hashtag11
CAACAACAGAACTTCC	Hashtag11
CAACAACCACTTGAAC	Negative
CAACAACCATGTACGT	Negative
CAACAACCATGTCGTA	Hashtag11
CAACAACTCGGAATGG	Hashtag11
CAACAGTAGGAAACGA	Hashtag11
CAACAGTCAATGCAAA	Negative
CAACAGTGTCGTTATG	Hashtag11
CAACAGTTCATTACTC	Negative
CAACAGTTCTGAGTCA	Negative
CAACCAACACAAGCAG	Hashtag12
CAACCAACATTACGGT	Negative
CAACCAAGTGGACTAG	Hashtag11
CAACCAATCCCAATAG	Hashtag11
CAACCAATCGAACCTA	Hashtag11
CAACCAATCGTCGACG	Negative
CAACCTCAGGCAATGC	Negative
CAACCTCCAAACTCTG	Negative
CAACCTCTCCAATCTT	Hashtag11
CAACCTCTCCTAAGTG	Hashtag11
CAACCTCTCGGAAACG	Hashtag12
CAACGATAGCAAGTCG	Hashtag11
CAACGATAGTCTCTGA	Hashtag11
CAACGATCAGTCGTTA	Hashtag11
CAACGATTCCTTGACC	Hashtag11_Hashtag12
CAACGGCAGACAGCTG	Hashtag11
CAACGGCCATACACCA	Hashtag11
CAACGGCGTATGACAA	Negative
CAACGGCGTCACTTAG	Negative
CAACGGCTCGGACGTC	Hashtag11
CAAGACTGTTGTGGAG	Hashtag11
CAAGACTTCACTCTTA	Negative
CAAGACTTCGATACGT	Hashtag11
CAAGAGGAGCCTCTCT	Hashtag12
CAAGAGGCACATTGTG	Negative
CAAGAGGGTGATTAGA	Negative
CAAGAGGGTTTAGAGA	Hashtag11
CAAGAGGTCATAGCAC	Hashtag11
CAAGAGGTCCCAGGCA	Negative
CAAGAGGTCCTTCAGC	Negative
CAAGCTAAGATGCTAA	Negative
CAAGCTAAGGGTTGCA	Hashtag12
CAAGCTAGTGATAGAT	Hashtag11
CAAGCTATCGAGAGCA	Negative
CAAGGGACACCCAATA	Negative
CAAGGGACACCGCTGA	Negative
CAAGGGACAGAGTCAG	Hashtag11
CAAGGGATCTCGACCT	Hashtag11
CAATACGAGGTCTACT	Negative
CAATACGCACTCGATA	Negative
CAATACGTCTTCGTGC	Hashtag12
CAATCGAAGCGCAATG	Hashtag11
CAATCGAAGTGGCCTC	Hashtag12
CAATCGACATTGCTTT	Negative
CAATCGAGTACCTAAC	Hashtag11
CAATCGAGTACGTGAG	Negative
CAATCGAGTGAGTCAG	Negative
CAATCGAGTGCACATT	Hashtag12
CAATCGAGTGGACTAG	Hashtag11
CAATGACCAATGCTCA	Hashtag11_Hashtag12
CAATGACGTATTTCGG	Negative
CAATGACTCCTATTTG	Hashtag11
CAATGACTCTCGACGG	Negative
CAATTTCAGGCTTAAA	Hashtag11
CAATTTCAGTTCATGC	Negative
CAATTTCCAGGTATGG	Hashtag11
CAATTTCTCGATTCCC	Negative
CAATTTCTCTCCACTG	Negative
CACAACAAGATGACCG	Negative
CACAACAGTCTGATCA	Negative
CACAACAGTGACTCTA	Hashtag11
CACAACATCATTTCGT	Hashtag11
CACACAAAGCACTCCG	Negative
CACACAACAGCTGCCA	Negative
CACACAAGTGTTTCTT	Hashtag11
CACAGATAGAATGTTG	Hashtag11
CACAGATGTGTTCATG	Hashtag11
CACAGATTCTCTCGAC	Negative
CACAGGCAGGAAACGA	Negative
CACAGGCCAACCACAT	Hashtag11
CACAGGCCAACGATCT	Negative
CACAGGCCAAGTGGCA	Hashtag11
CACAGGCGTCAATGGG	Hashtag11
CACAGGCTCCCATGGG	Negative
CACAGGCTCGGTGCAC	Negative
CACATGAAGCCTTCTC	Hashtag12
CACATGAAGGTGCTGA	Hashtag11
CACATGAGTACGAGTG	Hashtag11
CACATGAGTGATTGGG	Hashtag11
CACATGATCAACCCGG	Negative
CACATGATCGCGTGAC	Negative
CACCAAAAGCACTCAT	Hashtag12
CACCAAACAAAGACGC	Negative
CACCAAAGTACGACAG	Negative
CACCAAAGTACGTTCA	Hashtag11
CACCAAATCAGACCCG	Negative
CACCAAATCCATTGTT	Negative
CACCGTTAGAAATCCA	Negative
CACCGTTAGCACAAAT	Negative
CACCGTTAGCAGGCAT	Negative
CACCGTTCAATTAGGA	Negative
CACCGTTCACGAGGAT	Negative
CACCGTTCAGGGTCTC	Negative
CACCGTTTCGGCCCAA	Negative
CACCGTTTCGTAACAC	Negative
CACGAATAGAAGAGCA	Hashtag11
CACGAATAGTAAACAC	Negative
CACGAATAGTAGTCCT	Hashtag11
CACGAATCAACTCCCT	Hashtag11
CACGAATCAGGTCTCG	Hashtag11
CACGAATGTAAGGCTG	Negative
CACGAATGTAGAGATT	Hashtag11
CACGAATTCCCGAAAT	Negative
CACGAATTCTTACACT	Negative
CACGGGTGTCTAGGTT	Hashtag11
CACGGGTGTTTCGTTT	Hashtag11
CACGTGGAGATGGCAC	Negative
CACGTGGAGCCATATC	Hashtag12
CACGTGGAGTAAGAGG	Negative
CACGTGGCACTCAGAT	Negative
CACGTGGGTACACGTT	Hashtag11
CACGTGGGTAGCTTTG	Hashtag11
CACGTGGTCATCGACA	Hashtag12
CACGTTCCACCTCAGG	Hashtag11
CACGTTCGTCCAGTTA	Hashtag12
CACGTTCTCGTGGACC	Hashtag11
CACGTTCTCTTGGTCC	Negative
CACTAAGTCATGAGTC	Negative
CACTAAGTCGTAACAC	Hashtag11
CACTGAACAATAGTCC	Hashtag11
CACTGAACAGCTCTGG	Negative
CACTGGGAGTGCTACT	Hashtag11
CACTGGGAGTTCGCAT	Hashtag11
CACTGGGCAGGTCTCG	Negative
CACTGGGGTAAGCAAT	Negative
CACTGGGGTCACAATC	Negative
CACTGGGTCAAATAGG	Negative
CACTGGGTCAATCTTC	Negative
CACTGGGTCTCAGTCC	Negative
CACTGGGTCTTGGTGA	Hashtag11
CACTGTCCACAGCTTA	Negative
CACTGTCTCTGTGCTC	Hashtag11
CACTTCGCAACAGCTT	Hashtag11
CACTTCGCAGTAGTGG	Hashtag11
CACTTCGGTATGTGTC	Negative
CACTTCGGTCACAGTT	Negative
CACTTCGTCAAGTGTC	Hashtag11
CAGAGCCAGCAAACAT	Hashtag11
CAGAGCCAGCCACAAG	Hashtag11
CAGAGCCCATCTCATT	Hashtag11
CAGAGCCCATCTGTTT	Hashtag11
CAGAGCCTCCCTTGGT	Hashtag11
CAGAGCCTCTTCACAT	Hashtag12
CAGATACAGGAACGTC	Negative
CAGATACAGGGCCAAT	Hashtag11
CAGATACAGTAACCGG	Negative
CAGATACGTAGACAGC	Negative
CAGATACGTTAAGGGC	Negative
CAGATACGTTTAAGGA	Hashtag11
CAGATACTCGACGATT	Negative
CAGATACTCGATACGT	Negative
CAGATACTCGGTGCAC	Negative
CAGATACTCTAGTCAG	Hashtag11_Hashtag12
CAGATCAAGGTGCGAT	Negative
CAGATCACAGCTGTTA	Negative
CAGATCATCGTGTCAA	Hashtag11
CAGATTGAGAAGCGGG	Hashtag11
CAGATTGAGTACCCTA	Negative
CAGATTGGTAGCACGA	Hashtag11
CAGATTGTCCGCACTT	Hashtag12
CAGCAATCATAGGTAA	Negative
CAGCAATGTAGGGAGG	Negative
CAGCAATTCAAAGCCT	Hashtag11
CAGCAATTCAGACCGC	Negative
CAGCAATTCCACGTAA	Hashtag11
CAGCACGAGACATATG	Negative
CAGCACGTCTAGGCCG	Hashtag11
CAGCAGCAGATAACGT	Negative
CAGCAGCAGGAGATAG	Negative
CAGCAGCAGTCTAGAA	Negative
CAGCAGCTCCCTGGTT	Hashtag11
CAGCAGCTCTGCTAGA	Hashtag11
CAGCCAGAGATGGTAT	Negative
CAGCCAGAGCGAGTCA	Negative
CAGCCAGAGGCATCTT	Hashtag11
CAGCCAGAGGTGCGAT	Hashtag11_Hashtag12
CAGCCAGCAGAGCGTA	Hashtag12
CAGCCAGGTTGCTTGA	Hashtag11
CAGCCAGTCACCTACC	Negative
CAGCCAGTCATAGCAC	Hashtag11
CAGCGTGAGTATGAAC	Hashtag11
CAGCGTGCAAGCTGTT	Hashtag11
CAGCGTGGTACGCTAT	Negative
CAGCGTGTCACATTGG	Negative
CAGCGTGTCATGCCAA	Hashtag11_Hashtag12
CAGCGTGTCTCACTCG	Negative
CAGGCCAAGCTCGGCT	Negative
CAGGCCACAAGCGCAA	Hashtag11
CAGGCCACACTCCTTG	Hashtag11
CAGGCCACATCTGCGG	Hashtag11
CAGGCCACATTGCTTT	Negative
CAGGCCATCAACTTTC	Negative
CAGGGCTAGAGGCTGT	Hashtag11
CAGGGCTAGCGTTAGG	Hashtag11
CAGGGCTCACGACGCT	Negative
CAGGGCTCATCAGCGC	Hashtag11
CAGGGCTGTACAGAAT	Hashtag11
CAGGGCTTCACGGACC	Negative
CAGGTATAGCGTATAA	Hashtag11
CAGGTATAGGGAGGTG	Hashtag11
CAGGTATCACAGACGA	Hashtag11
CAGGTATCAGATAAAC	Hashtag11
CAGGTATGTCTTCATT	Hashtag11
CAGGTATTCGGTATGT	Hashtag11_Hashtag12
CAGGTATTCTCGTTTA	Hashtag11
CAGTGCGGTCGATTAC	Hashtag11
CAGTTAGAGCAGCCTC	Negative
CAGTTAGGTCGATTCA	Negative
CAGTTAGTCCATCAGA	Hashtag11
CAGTTAGTCTGAGTCA	Hashtag11
CATAAGCCATGTACGT	Hashtag11
CATAAGCTCAAAGAAC	Hashtag11
CATAAGCTCACCACAA	Negative
CATAAGCTCGCAGTCG	Hashtag11
CATACAGCAGGAGGAG	Negative
CATACAGGTACCACGC	Negative
CATACAGGTCTACATG	Hashtag11
CATACCCAGATTTGCC	Hashtag12
CATACCCTCAACCTTT	Negative
CATACTTAGCCGGATA	Hashtag11
CATACTTAGTGCGCTC	Negative
CATACTTCACCGGTCA	Negative
CATACTTGTACCGCGT	Negative
CATACTTGTCACTTAG	Hashtag11
CATACTTGTCTTTCAT	Hashtag11
CATACTTTCCATAAGC	Hashtag11
CATACTTTCTTTGCAT	Negative
CATAGACCATAACAGA	Hashtag11
CATAGACTCCGGACTG	Negative
CATAGACTCTGTGCGG	Hashtag11
CATAGACTCTTGCAGA	Negative
CATCAAGAGATGCTGG	Negative
CATCAAGAGCGCCGTT	Negative
CATCAAGCAGGACATG	Negative
CATCAAGTCTGGCTGG	Negative
CATCCACAGTCAGCGA	Negative
CATCCACCAACACGAG	Negative
CATCCACTCCATACAG	Negative
CATCCCACAAGGAGTC	Negative
CATCCCAGTAACGCGA	Hashtag11
CATCCCATCCTACACC	Hashtag11
CATCCGTAGGCCACCT	Hashtag12
CATCCGTAGTCGCGAA	Hashtag11
CATCCGTCACACCGAC	Negative
CATCGCTCAGGTTTAC	Hashtag11
CATCGCTCATCGTGGC	Hashtag12
CATCGCTGTGTAGGAC	Negative
CATCGCTTCAGGACGA	Negative
CATCGGGAGATGGCAC	Negative
CATCGGGCAACTCCAA	Hashtag11
CATCGGGCAGACCTGC	Negative
CATCGGGTCTGTCAGA	Negative
CATCGTCAGCGAATGC	Negative
CATCGTCAGTTGGCGA	Hashtag11
CATCGTCCATCGAGCC	Negative
CATCGTCTCCGGGACT	Hashtag11
CATGAGTAGCTTTCTT	Hashtag11
CATGAGTAGGCTTTCA	Negative
CATGAGTCACAGCCTG	Negative
CATGAGTGTCTATGAC	Hashtag11
CATGAGTTCAACTGGT	Hashtag11
CATGCAAAGCTTTCCC	Negative
CATGCAAGTAACGCGA	Hashtag11
CATGCAAGTAATGCGG	Hashtag11
CATGCAATCCTACTGC	Hashtag11
CATGCAATCTTCCACG	Negative
CATGCCTAGGATACGC	Negative
CATGCCTAGGTTGAGC	Hashtag12
CATGCCTGTAACAAGT	Hashtag12
CATGCCTTCCACCTGT	Negative
CATGCCTTCTAGTTCT	Negative
CATGCGGCATCCGGCA	Negative
CATGCGGGTATGAAAC	Hashtag11
CATGCGGTCCTCAGGG	Hashtag11
CATGCGGTCCTTACCG	Negative
CATGCGGTCGTGTGGC	Negative
CATGCTCCAAGTCGTT	Hashtag11
CATGCTCCAGGTTCAT	Hashtag12
CATGCTCGTAGGGAGG	Hashtag11
CATGCTCTCTCCTACG	Hashtag11
CATGGATCAAGCAATA	Negative
CATGGATGTAACGCGA	Hashtag11
CATGGATGTGCCTAAT	Hashtag11
CATGGATTCGCCATAA	Negative
CATGGATTCGCTGTCT	Negative
CATGGATTCTGAGGTT	Hashtag11
CATGGTAAGATAGTGT	Negative
CATGGTACAAGTTCCA	Negative
CATGGTACAGAAGTGC	Negative
CATGGTAGTGACGCCT	Hashtag11
CATGGTATCTGTAAGC	Hashtag11
CATGGTATCTTCGCTG	Negative
CATTCATGTACAGTAA	Hashtag11
CATTCATTCCGCGGAT	Negative
CATTCATTCTATCGCC	Hashtag11
CATTCATTCTGCTAGA	Hashtag12
CATTCCGAGACCAGAC	Negative
CATTCCGCAAATCAGA	Hashtag12
CATTCCGCAATACGCT	Negative
CATTCCGCACCACTGG	Hashtag11
CATTCCGGTGGATCGA	Negative
CATTCCGTCCTCTCTT	Hashtag11
CATTCTATCATCGCTC	Negative
CATTGAGAGCAGGCAT	Hashtag11
CATTGAGTCCAACCGG	Hashtag12
CATTGAGTCTAACGGT	Hashtag11
CATTGAGTCTCACGAA	Hashtag11
CATTGCCAGAAACTAC	Hashtag12
CATTGCCGTGACACGA	Negative
CATTGCCTCGGAGATG	Hashtag11
CATTGCCTCGTGCATA	Negative
CATTGTTAGTTGCGAG	Hashtag11
CATTGTTCATCGATGT	Negative
CATTGTTGTTTACCAG	Negative
CATTGTTTCAACGCTA	Negative
CATTTCAGTCAACGCC	Negative
CATTTCAGTCATAAAG	Negative
CATTTCAGTGGCTGCT	Negative
CATTTCATCCTTATCA	Hashtag11
CCAAGCGCACAAATCC	Hashtag11
CCAAGCGGTAAGAACT	Negative
CCAAGCGGTCACCCTT	Hashtag11
CCAAGCGTCAGCCTTC	Hashtag12
CCAAGCGTCCTACCGT	Hashtag11
CCAAGCGTCGAAGAAT	Hashtag11
CCAATGAAGTAAAGCT	Negative
CCAATGACAATTTCCT	Negative
CCAATGATCATCGCCT	Negative
CCAATGATCCCATAAG	Negative
CCAATTTAGGCTAGCA	Negative
CCAATTTCACAAATAG	Negative
CCAATTTTCACTGGTA	Negative
CCAATTTTCCGATAAC	Negative
CCAATTTTCTAGCCAA	Hashtag11
CCACAAAAGCCAAGCA	Negative
CCACAAAGTATCGTAC	Negative
CCACAAAGTCATATGC	Hashtag11
CCACAAAGTGCCTTCT	Hashtag11
CCACAAAGTTGGACTT	Negative
CCACAAATCCGAAGGA	Negative
CCACAAATCCTCTCTT	Negative
CCACAAATCGCAATTG	Hashtag11
CCACACTAGCAACAAT	Hashtag11
CCACACTTCCCTCTAG	Negative
CCACACTTCTTTCTAG	Hashtag11
CCACCATAGGGTACAC	Negative
CCACCATAGTCATCGT	Hashtag11
CCACCATCATTAAAGG	Negative
CCACCATGTCGACTGC	Hashtag11
CCACCATTCGCTTGCT	Negative
CCACCATTCTACGGTA	Negative
CCACCATTCTCTTGCG	Hashtag11
CCACGAGCACTTGAAC	Negative
CCACGAGGTTTCGTTT	Negative
CCACGAGTCAAGCCAT	Negative
CCACGAGTCTAGCAAC	Hashtag11
CCACGTTAGACCGCCT	Hashtag11
CCACGTTCACCAATTG	Negative
CCACGTTTCCCGTTCA	Negative
CCACGTTTCCTGTAAG	Negative
CCACGTTTCGAGCCTG	Negative
CCACGTTTCGGCATTA	Hashtag11
CCACTTGAGGCAGGGA	Negative
CCACTTGCACCGCTAG	Hashtag11
CCACTTGGTCGCTCGA	Hashtag12
CCACTTGGTTCTCACC	Negative
CCATAAGAGCGGGTAT	Hashtag11
CCATCACCACGCGTGT	Negative
CCATCACCATACCAGT	Hashtag11
CCATCACCATAGCACT	Negative
CCATCACGTCTCCCTA	Hashtag12
CCATCACTCAATCTTC	Negative
CCATCACTCGCTGCGA	Hashtag11
CCCAACTCAGGATGAC	Hashtag11
CCCAACTGTAAGGCTG	Negative
CCCAACTGTCCTGTCT	Hashtag12
CCCAACTTCTCGCAGG	Hashtag12
CCCAACTTCTGTGCTC	Hashtag11
CCCATTGAGGAACATT	Hashtag11
CCCATTGCACCAGTTA	Negative
CCCGAAGCAAGACGGT	Negative
CCCGAAGGTCCGGATC	Hashtag12
CCCGAAGTCCAGGACC	Negative
CCCGAAGTCGGACGTC	Hashtag11
CCCGAAGTCGTGCTCT	Negative
CCCGGAAAGCTAATGA	Hashtag11
CCCGGAACATGACAGG	Hashtag11
CCCGGAACATGACGAG	Hashtag11
CCCGGAAGTAGTTCCA	Hashtag11
CCCTAACGTATCGCAT	Hashtag11
CCCTAACGTTCATCTT	Hashtag12
CCCTAACGTTGTTGTG	Hashtag11
CCCTAACTCCGCGGAT	Negative
CCCTAACTCGCCTATC	Hashtag12
CCCTCAAAGAGCATCG	Negative
CCCTCAAAGGTTCACT	Negative
CCCTCAAAGGTTCCGC	Hashtag11
CCCTCAAGTCTACTGA	Negative
CCCTCAAGTCTGCGCA	Hashtag11
CCCTCAATCAATCCGA	Hashtag11
CCCTCAATCTATTCGT	Negative
CCCTCTCAGGTCGTAG	Hashtag11
CCCTCTCCACTCCCTA	Negative
CCCTCTCCAGCTAACT	Negative
CCCTCTCCATATGGCT	Hashtag11
CCCTCTCGTGCGGATA	Negative
CCCTCTCGTTCCACGG	Negative
CCCTGATAGCGCCTAC	Hashtag11
CCCTGATAGGCTGGAT	Hashtag11
CCCTGATCACGCGCAT	Hashtag11
CCCTGATGTCAAGTTC	Negative
CCCTGATGTGGGAGAG	Negative
CCCTGATGTTTCGATG	Hashtag12
CCCTGATTCGGTGTAT	Hashtag11
CCCTTAGAGGGCTGAT	Hashtag11
CCCTTAGAGTTCATGC	Negative
CCCTTAGGTAGTTAGA	Hashtag11
CCCTTAGGTCAGGAGT	Negative
CCCTTAGGTCATAGTC	Hashtag11
CCCTTAGGTGTTCATG	Negative
CCCTTAGGTTAACAGA	Negative
CCGAACGAGCAACAAT	Negative
CCGAACGAGGAGGCAG	Hashtag11
CCGAACGAGTTAGTAG	Hashtag11
CCGAACGCAACTCGTA	Hashtag11
CCGAACGGTTAATGAG	Hashtag12
CCGAACGTCACCATAG	Hashtag12
CCGAACGTCGCTAGCG	Negative
CCGATCTAGATCGCTT	Hashtag11
CCGATCTAGTACCGGA	Hashtag11
CCGATCTCAATCGCCG	Hashtag12
CCGATGGAGCGCCATC	Hashtag11
CCGATGGAGTCCCGAC	Negative
CCGATGGCAATCTCGA	Hashtag11
CCGATGGCAGGATCTT	Negative
CCGATGGGTAGCTTGT	Hashtag11
CCGATGGGTGTGTCCG	Hashtag11
CCGATGGGTTTCGACA	Negative
CCGATGGTCACAAGAA	Negative
CCGATGGTCTCTTCAA	Hashtag11
CCGCAAGAGTGCGTCC	Hashtag12
CCGCAAGGTCGCCTAG	Hashtag11
CCGCAAGGTTTCGTGA	Hashtag11
CCGCAAGTCGCAACAT	Hashtag11_Hashtag12
CCGGACAAGGCACGAT	Hashtag11
CCGGACACAGTTGAAA	Hashtag12
CCGGACAGTGGACAGT	Hashtag11
CCGGACATCGCAACAT	Hashtag11
CCGGGTACACGGCACT	Negative
CCGGGTAGTCTCGGGT	Hashtag11
CCGGTAGAGGTAATCA	Hashtag11_Hashtag12
CCGGTAGGTGACCGAA	Negative
CCGGTGACATAGTCGT	Negative
CCGGTGAGTAAGTTAG	Hashtag11
CCGGTGAGTACTAAGA	Hashtag11
CCGTAGGCAATACAGA	Negative
CCGTAGGCATATGAAG	Hashtag11
CCGTAGGTCACATACG	Negative
CCGTAGGTCACCGCTT	Negative
CCGTAGGTCTAGCCTC	Negative
CCGTGAGCAGTCAGCC	Hashtag12
CCGTGAGTCCATACTT	Negative
CCGTTCAAGTGGTCAG	Hashtag11
CCGTTCACATCGGATT	Negative
CCGTTCAGTCCGAAAG	Hashtag12
CCGTTCAGTTATTCTC	Negative
CCGTTCATCGCAACAT	Negative
CCGTTCATCGCTATTT	Negative
CCTAACCAGGTACAGC	Hashtag11
CCTAACCTCAAACGAA	Negative
CCTAACCTCAGACTGT	Hashtag11
CCTAAGAAGGAACTCG	Negative
CCTAAGAAGTGTAGTA	Hashtag12
CCTAAGACATCTTCGC	Hashtag11
CCTAAGAGTTGGCCTG	Hashtag11
CCTACGTAGGATATGT	Negative
CCTACGTTCAACTGGT	Negative
CCTACGTTCACAGTGT	Negative
CCTACGTTCTTCTAAC	Hashtag11
CCTATCGAGTAGCCAG	Hashtag11
CCTATCGCAGGCGATA	Negative
CCTATCGCAGGTGTGA	Hashtag11
CCTATCGGTACACGTT	Negative
CCTATCGTCAACCCGG	Hashtag11
CCTATCGTCACTGAAC	Negative
CCTATCGTCTGTCTCG	Hashtag11
CCTCAACAGAACGTGC	Hashtag11
CCTCAACAGCGGTATG	Hashtag11
CCTCAACCAACGGTAG	Hashtag11
CCTCAACCACCTCAGG	Negative
CCTCAACGTTGCGGAA	Hashtag11
CCTCAACTCGCACTCT	Hashtag11
CCTCAACTCGTTGTAG	Negative
CCTCAACTCTCCTGTG	Hashtag11
CCTCACAAGACCAAGC	Negative
CCTCACACACCCTGAG	Hashtag11
CCTCACACACGCTGTG	Hashtag11
CCTCACATCCGTATGA	Hashtag11
CCTCAGTAGCCTTGAT	Negative
CCTCAGTCAGGCACAA	Negative
CCTCATGAGATCCCGC	Hashtag11
CCTCATGCAACCAGAG	Negative
CCTCATGCACCTGTCT	Hashtag11
CCTCATGCACTATCCC	Hashtag11
CCTCATGTCAGAACCT	Negative
CCTCATGTCATTACGG	Hashtag11
CCTCCAACACGTACAT	Negative
CCTCCAATCACTGGGC	Hashtag11
CCTCCAATCCACTAGA	Hashtag11
CCTCCTCAGGTTATAG	Hashtag12
CCTCCTCGTACCATAC	Negative
CCTCCTCGTCAAGGCA	Negative
CCTCTAGAGACTTCGT	Negative
CCTCTAGAGCTCGCAC	Hashtag11
CCTCTAGCACCAGCCA	Hashtag11
CCTCTAGGTCGTGTTA	Hashtag11
CCTCTAGGTGCTGTCG	Hashtag11
CCTCTCCAGAAGGTAG	Hashtag11
CCTCTCCTCATTTGGG	Negative
CCTGCATAGTCATGGG	Negative
CCTGCATCACGCGTCA	Hashtag11
CCTGCATGTGGTATGG	Hashtag12
CCTGCATTCGTGACTA	Hashtag11
CCTGTTGAGGCGTTAG	Hashtag11
CCTGTTGGTTTCAGAC	Hashtag11
CCTTCAGAGATACATG	Negative
CCTTCAGAGGCATTTC	Negative
CCTTCAGCAGATACCT	Hashtag11
CCTTCAGCAGATTCGT	Hashtag11
CCTTCAGGTCGAATGG	Hashtag11
CCTTCAGGTGCATTAC	Hashtag11
CCTTCAGGTTACACTG	Hashtag11
CCTTCAGTCCAAGGGA	Hashtag11
CCTTCAGTCTGTAACG	Hashtag11
CCTTGTGAGCTAGAGC	Negative
CCTTGTGCAAGAGTAT	Hashtag11
CCTTGTGCACCGTGAC	Hashtag11
CCTTGTGCAGCAGATG	Negative
CCTTGTGCATCAGCTA	Hashtag11
CCTTGTGGTATGGAAT	Negative
CCTTTGGAGTCTGGTT	Hashtag11
CCTTTGGCAAACACCT	Negative
CCTTTGGCATCAGCGC	Negative
CCTTTGGTCTTACCGC	Hashtag11
CGAAGGACAAGTGCTT	Hashtag11
CGAAGGAGTATGCTTG	Hashtag12
CGAAGGATCCCTTCCC	Hashtag11
CGAAGGATCGAGTGGA	Hashtag11
CGAAGTTCATGCCATA	Hashtag11
CGAAGTTGTAACATCC	Negative
CGAAGTTGTCTCGGAC	Negative
CGAAGTTGTGAGTAAT	Negative
CGAAGTTTCGAGAAAT	Negative
CGAAGTTTCGAGTCTA	Hashtag11
CGAAGTTTCGTACCTC	Hashtag11
CGAATTGAGAAGCCAC	Negative
CGAATTGGTCAGACTT	Hashtag11
CGACAGCAGACCGTTT	Hashtag11
CGACAGCGTGAGATAT	Hashtag11
CGACAGCGTTTACGAC	Hashtag11
CGACAGCTCTGAGTCA	Negative
CGAGAAGGTGAAGCTG	Negative
CGAGAAGTCGTAGTCA	Negative
CGAGGAACATAGGTTC	Hashtag11
CGAGGAATCCTACCAC	Hashtag11
CGAGGCTAGTCGGGAT	Hashtag11
CGAGGCTAGTGGACTG	Negative
CGAGGCTTCAGTCAGT	Negative
CGAGTGCAGGGTAATT	Negative
CGAGTGCAGTTTCAGC	Hashtag11
CGAGTGCGTGCTCCGA	Hashtag12
CGAGTGCGTGGAAATT	Hashtag11
CGAGTGCTCCCTCTAG	Hashtag11
CGAGTGCTCCGAAATC	Negative
CGAGTGCTCTTCGTGC	Negative
CGAGTTAAGAGTTGTA	Hashtag11
CGAGTTACATTAGGCT	Hashtag12
CGAGTTAGTCACAGAG	Hashtag12
CGAGTTAGTGCCTTCT	Hashtag11
CGAGTTAGTTAACCTG	Hashtag11
CGAGTTATCTGGACTA	Hashtag11
CGATCGGAGCCTCTTC	Hashtag12
CGATCGGCACACCAGC	Negative
CGATCGGCACTCCACT	Negative
CGATCGGCAGAAATCA	Hashtag11
CGATCGGCATTGAAGA	Negative
CGATCGGTCCGGTTCT	Hashtag11
CGATGCGAGCACACAG	Negative
CGATGCGCAAGTTGGG	Hashtag11
CGATGCGCATCGATGT	Hashtag11
CGATGCGGTTCCACGG	Negative
CGATGCGGTTGGGATG	Negative
CGATGCGTCATCCTAT	Negative
CGATGGCAGCCGTAAG	Hashtag11
CGATGGCCAACGGTAG	Hashtag11
CGATGGCCAAGGCTTT	Hashtag12
CGATGGCCATTCACAG	Hashtag11
CGATGGCGTCTTCGAA	Negative
CGATGGCGTCTTTCAT	Negative
CGATGGCTCTTAGGAC	Hashtag11
CGCAGGTAGCTGAAAT	Hashtag12
CGCAGGTCAAAGACGC	Hashtag11
CGCAGGTCATTGCCGG	Negative
CGCAGGTGTCAGACTT	Negative
CGCAGGTGTCATCTAG	Hashtag11
CGCAGGTTCACTCACC	Hashtag11
CGCAGGTTCGTCCTTG	Hashtag12
CGCATAAGTAGACAAT	Hashtag12
CGCATAAGTGACCGAA	Negative
CGCATAAGTTATCTGG	Hashtag11
CGCATGGAGCTCACTA	Negative
CGCATGGAGGCCGCTT	Negative
CGCATGGCAAGAATGT	Negative
CGCATGGGTATGACAA	Negative
CGCATGGGTTGTGCAT	Hashtag11
CGCCAGAAGCTATCTG	Hashtag11
CGCCAGAGTCCAAATC	Hashtag11
CGCCATTAGACTCTAC	Hashtag11
CGCCATTAGCCAGTAG	Negative
CGCCATTAGCTGGAGT	Negative
CGCCATTCAGACACCC	Hashtag11
CGCCATTCAGCAGTAG	Hashtag11
CGCCATTCATGGCTGC	Hashtag11
CGCCATTTCCGAAGGA	Hashtag12
CGCCATTTCTAGTCAG	Hashtag11
CGCGTGAAGACCAAAT	Hashtag11
CGCGTGACAGCACACC	Negative
CGCGTGACAGGAATCG	Hashtag11
CGCGTGAGTTGCATTG	Negative
CGGAACCAGCACCAGA	Negative
CGGAACCGTTCCAAAC	Hashtag11
CGGAATTAGAGCATTA	Negative
CGGAATTAGTCTACCA	Negative
CGGAATTCACGGGCTT	Hashtag11
CGGAATTGTACAATAG	Hashtag11_Hashtag12
CGGAATTGTAGCTGAG	Negative
CGGAATTGTAGGAGGG	Hashtag11
CGGAATTGTTTCGCTC	Hashtag11
CGGACACGTAGGTTTC	Negative
CGGACACGTGGAACCA	Hashtag11
CGGAGAAAGAGTTCGG	Hashtag11
CGGAGAAAGCGTGCCT	Hashtag11
CGGAGAAGTTCTTAGG	Negative
CGGAGAATCTCTTAAC	Negative
CGGCAGTAGAAATTCG	Hashtag11
CGGCAGTAGTTGCGAG	Hashtag11
CGGCAGTGTCCGAAGA	Hashtag11
CGGCAGTGTGTCCCTT	Hashtag11
CGGCAGTTCACATTGG	Hashtag11
CGGCAGTTCGTAGAGG	Hashtag11
CGGGACTAGTGTAGTA	Negative
CGGGACTTCATTGGTG	Negative
CGGGACTTCTGCTAGA	Hashtag12
CGGGCATAGCCTCTCT	Hashtag11
CGGGCATAGCGACTTT	Negative
CGGGCATAGGGAGGCA	Negative
CGGGCATTCGCGAAGA	Hashtag11
CGGGCATTCTGTGCAA	Negative
CGGGTCACAAGTGGTG	Negative
CGGGTCAGTTTCACAG	Hashtag12
CGGGTGTCAGCCGTCA	Hashtag11
CGGGTGTGTACCAGAG	Hashtag12
CGGGTGTGTGTGCCTG	Hashtag11
CGGGTGTTCGCCTTTG	Hashtag11
CGGTCAGAGCGTGTCC	Negative
CGGTCAGCACTGTCGG	Negative
CGGTCAGCAGGTGGAT	Hashtag11
CGGTCAGTCGGAAACG	Negative
CGTAAGTAGCACCTGC	Hashtag11
CGTAAGTAGGTTTGAA	Hashtag11
CGTAAGTGTAGGGTAC	Negative
CGTAAGTTCGAACTCA	Hashtag11
CGTAATGAGAGCGACT	Hashtag11
CGTAATGAGTGCCGAA	Negative
CGTAATGCAACGTTAC	Hashtag11
CGTAATGCATGCGTGC	Negative
CGTAATGGTCCACTCT	Hashtag11
CGTAGTAAGTCGAAGC	Hashtag11
CGTCAAAAGTTCCGTA	Hashtag11
CGTCAAAGTGAGACGT	Negative
CGTCCATGTATGTGTC	Hashtag11
CGTCCATGTCGCTTAA	Hashtag11
CGTCCATTCCTATTGT	Hashtag11
CGTCCATTCGTGGACC	Negative
CGTGAATGTGTCCTAA	Hashtag11
CGTGAATTCCTCAGGG	Hashtag11
CGTGAATTCGCTACGG	Hashtag11
CGTGAATTCGGATAAA	Negative
CGTGATACAATCCTTT	Hashtag11
CGTGATATCAGGGATG	Negative
CGTGATATCCGGGACT	Hashtag11
CGTGATATCTAGGCCG	Hashtag11
CGTGATATCTGAGAGG	Negative
CGTGCTTGTCTCTCCA	Hashtag11
CGTGCTTGTGTATTCG	Hashtag11
CGTGCTTTCTACCCAC	Hashtag11
CGTGTCTAGTCAAGCG	Hashtag11
CGTGTCTGTACGTTCA	Negative
CGTGTCTGTCGTTGGC	Negative
CGTTAGAAGTACAGAT	Negative
CGTTAGAAGTACTGTC	Hashtag11
CGTTAGAGTATCTCGA	Hashtag11
CGTTAGAGTGTGTACT	Hashtag11
CGTTAGATCTACTTCA	Negative
CGTTCTGTCAGCGCAC	Negative
CGTTCTGTCGACGACC	Negative
CGTTGGGAGACTCATC	Negative
CGTTGGGAGGACAAGA	Negative
CGTTGGGAGGATTTAG	Hashtag12
CGTTGGGGTTCTTGCC	Hashtag11
CTAACCCCAACACAAA	Negative
CTAACCCTCCTATTTG	Hashtag11
CTAACCCTCGCCAACG	Negative
CTAACTTCAACTGGTT	Negative
CTAAGTGAGTTGTAAG	Hashtag12
CTAAGTGCAACAAAGT	Negative
CTAAGTGCAGGTCCCA	Hashtag11
CTAAGTGCATCGCTAA	Negative
CTAAGTGTCTGTGCTC	Negative
CTACAGAGTCACAGAG	Negative
CTACAGATCAAGAATG	Hashtag11
CTACATTAGGATTTGA	Negative
CTACATTCACCGCTGA	Hashtag11
CTACATTCAGTAACGG	Negative
CTACATTTCGTTCATT	Hashtag11
CTACCCACAGCACGAA	Negative
CTACCCACAGTAACAA	Negative
CTACCCACATCCTAAG	Hashtag11
CTACCTGAGAAATCCA	Hashtag11
CTACCTGAGAGGTATT	Hashtag11
CTACCTGCACAGAGAC	Hashtag12
CTACCTGTCATGCCCT	Negative
CTACCTGTCCCATAAG	Negative
CTACCTGTCGCTTTAT	Negative
CTACGGGCACTTACAG	Negative
CTACGGGGTCGTCTCT	Hashtag11
CTACTATAGTGCTACT	Negative
CTACTATTCCATAGAC	Hashtag11
CTAGACAAGTATCTGC	Negative
CTAGACAAGTCTCCTC	Negative
CTAGACACAACACGTT	Negative
CTAGACAGTGACCGTC	Negative
CTAGGTAAGCACCTGC	Negative
CTAGGTACATCCTATT	Hashtag11
CTAGGTAGTAACGCGA	Negative
CTAGGTAGTCCACATA	Hashtag11
CTAGGTATCAGTCACA	Hashtag11
CTAGGTATCGCGTGCA	Negative
CTAGGTATCTAGTGTG	Hashtag11
CTATAGGAGACCTCAT	Hashtag11
CTATAGGCAGTATGAA	Negative
CTATAGGGTGTAAACA	Hashtag11
CTATAGGTCACTTGTT	Negative
CTATAGGTCGCAGATT	Hashtag11
CTATCCGAGCGTGAAC	Hashtag12
CTATCCGAGGCCCACT	Negative
CTATCCGAGTCTTCGA	Negative
CTATCCGAGTGATTCC	Negative
CTATCCGCACTGGACC	Hashtag11
CTATCCGTCACTGAAC	Hashtag11
CTATCCGTCCACGTGG	Hashtag11
CTATCTAGTTGCTCGG	Hashtag12
CTATCTATCATGTCTT	Hashtag11
CTATCTATCCGTTGAA	Negative
CTATCTATCGGTCTGG	Negative
CTATCTATCTAGCAAC	Hashtag11
CTCAACCAGAGGATGA	Hashtag11
CTCAACCCACCTATCC	Hashtag11
CTCAACCTCATGGTAC	Hashtag11
CTCAACCTCGTTGTAG	Negative
CTCAAGACACAACGAG	Hashtag11
CTCAAGACACACTGGC	Hashtag11
CTCAAGATCCCTCTTT	Negative
CTCAAGATCGCATAGT	Hashtag12
CTCAATTCAGCTCCTT	Negative
CTCACTGAGCAATTCC	Negative
CTCACTGAGGGCAGTT	Hashtag11
CTCACTGAGGTTAGTA	Hashtag11
CTCACTGCACTCTGCT	Negative
CTCACTGGTAGAGATT	Negative
CTCAGAAGTAACCCGC	Negative
CTCAGAAGTCCTCATC	Hashtag11
CTCAGAATCAAACGAA	Hashtag11
CTCAGAATCCCAGGCA	Hashtag11
CTCAGGGCAGCGAACA	Negative
CTCAGGGCATAGAGGC	Negative
CTCAGGGGTCATTGCA	Negative
CTCAGGGTCACATACG	Hashtag11
CTCAGGGTCCTACCAC	Negative
CTCAGGGTCGGCTGGT	Hashtag11
CTCAGTCAGGGTACGT	Hashtag11
CTCAGTCGTATCGTGT	Hashtag11
CTCATCGCACACCGCA	Hashtag11
CTCATCGCAGGTGGAT	Hashtag11
CTCATCGCAGTCAGTT	Hashtag11
CTCATCGGTGACACAG	Negative
CTCATGCAGGAATCGC	Hashtag11
CTCATGCAGTTACGAA	Hashtag11
CTCATTAAGCAAACAT	Hashtag11
CTCATTAAGTTCCAGT	Negative
CTCATTACAGAAGCTG	Hashtag11
CTCATTAGTATGCGGA	Hashtag11
CTCCAACCAACTTCTT	Hashtag12
CTCCAACCAAGCAATA	Negative
CTCCAACCATACCATG	Negative
CTCCAACGTTCCCAAA	Hashtag12
CTCCACAAGCAGGCTA	Negative
CTCCACAAGCGCAATG	Negative
CTCCACACATATGCGT	Hashtag11
CTCCACAGTATGGTAA	Hashtag11
CTCCACAGTTGGCCGT	Hashtag11
CTCCACATCATGTCTT	Negative
CTCCACATCCGTGTCT	Hashtag11
CTCCACATCTGAATGC	Hashtag11
CTCCATGAGACGGAAA	Hashtag12
CTCCATGCACGGCCAT	Negative
CTCCATGCACGTTCGG	Hashtag12
CTCCATGCAGGACGAT	Hashtag11
CTCCATGCATCAGCGC	Negative
CTCCATGTCATCGACA	Hashtag11
CTCCCAAAGAGTGACC	Negative
CTCCCAACACTAACGT	Negative
CTCCCAACATGTGACT	Hashtag11
CTCCCAATCTACGGTA	Hashtag11
CTCCCTCAGAGAAGGT	Negative
CTCCCTCAGCCAAGCA	Negative
CTCCCTCCAAGAAACT	Negative
CTCCCTCCAGAGAAAG	Negative
CTCCCTCTCCCAGGCA	Hashtag11
CTCCGATAGAGCTGAC	Hashtag11
CTCCGATGTCCACGCA	Hashtag12
CTCCGATTCCGATCTC	Negative
CTCCTCCAGCGCCATC	Hashtag11
CTCCTCCAGTTATGGA	Negative
CTCCTCCTCGAGTGAG	Hashtag11_Hashtag12
CTCCTTTAGCGAATGC	Negative
CTCCTTTCACTCACTC	Negative
CTCCTTTCAGGTCCCA	Hashtag11
CTCCTTTGTAGCGTAG	Negative
CTCCTTTGTCGAAACG	Hashtag11
CTCCTTTTCTGCCCTA	Hashtag11
CTCGAGGAGGGTAGCT	Hashtag11
CTCGAGGAGTATGAGT	Hashtag11
CTCGAGGAGTGCAACG	Hashtag12
CTCGAGGAGTGCTCAT	Hashtag11
CTCGAGGCATCCGGTG	Negative
CTCGAGGCATTACTCT	Negative
CTCGAGGGTCCCTGAG	Hashtag11
CTCGAGGTCTTGATTC	Negative
CTCTCAGAGTATGGAT	Hashtag12
CTCTCAGCATTCCTAT	Negative
CTCTCAGGTGTGGTCC	Hashtag11
CTCTCAGTCCACGGGT	Hashtag12
CTCTCAGTCGCCTAGG	Negative
CTCTCGAAGTTGCATC	Hashtag12
CTCTCGACATTAGGCT	Negative
CTCTCGAGTGGTCCCA	Negative
CTCTGGTAGGTAGATT	Negative
CTCTGGTGTATAGGAT	Hashtag12
CTCTGGTGTCATCCGG	Negative
CTCTGGTTCGAACACT	Hashtag11
CTCTGGTTCGAATGCT	Negative
CTCTGGTTCGCTGACG	Negative
CTGAATGAGATGCAGC	Negative
CTGAATGAGTTGGACG	Hashtag11
CTGAATGGTCATCACA	Hashtag11
CTGAATGGTTTAGAGA	Hashtag11
CTGAATGTCCGGTTCT	Negative
CTGAATGTCTGCGATA	Hashtag12
CTGAGCGAGAGTCTTC	Hashtag11
CTGAGCGAGGGTTAGC	Hashtag11
CTGAGCGAGTTCCTGA	Hashtag12
CTGAGCGTCAGCGCAC	Hashtag12
CTGAGCGTCTAAACGC	Negative
CTGAGGCAGACGCCAA	Negative
CTGATCCAGGATATAC	Hashtag11
CTGCAGGAGATGGCAC	Negative
CTGCAGGCAGCCCAGT	Negative
CTGCAGGCATGACTCA	Hashtag11
CTGCAGGGTCGTTATG	Hashtag11
CTGCAGGGTTGGAGGT	Hashtag11
CTGCAGGTCAGCATTG	Hashtag11
CTGCATCAGCTACAAA	Negative
CTGCATCCAAGTTCGT	Hashtag11
CTGCATCCACACCGCA	Hashtag12
CTGCATCGTTATGGTC	Hashtag12
CTGCCATAGAGCACTG	Negative
CTGCCATCAAGAGAGA	Negative
CTGCCTAGTGACGTCC	Negative
CTGCGAGGTACGATTC	Negative
CTGCGAGTCCCTCGTA	Hashtag12
CTGCGAGTCCGGGACT	Hashtag12
CTGCGAGTCGAGATGG	Negative
CTGCGAGTCTACTCAT	Negative
CTGCGAGTCTAGTCAG	Negative
CTGCTCAAGGCATTTC	Hashtag11
CTGCTCACAGAAGTTA	Hashtag11
CTGCTCACAGGGAATC	Hashtag11
CTGCTCAGTCCGTACG	Hashtag11
CTGCTCATCATTATCC	Negative
CTGCTCATCCGTTGGG	Hashtag11
CTGGACGCACCCTGAG	Hashtag11
CTGGACGCATCCGAGC	Negative
CTGGACGCATCTATCT	Hashtag11
CTGGACGGTGATGAAT	Hashtag11
CTGGACGGTTACACTG	Hashtag12
CTGGACGTCAATGTCG	Negative
CTGGCAGAGAATTCAG	Hashtag11
CTGGCAGAGCAGCACA	Hashtag11
CTGGCAGCATTATGCG	Negative
CTGGCAGGTCACTCGG	Negative
CTGGCAGGTCTCAGAT	Hashtag11
CTGGTCTAGAGTCTTC	Negative
CTGGTCTGTCTACACA	Negative
CTGGTCTGTGCTCGTG	Negative
CTGGTCTTCGACTCCT	Hashtag12
CTGGTCTTCGAGAACG	Hashtag11
CTGGTCTTCTCCCATG	Negative
CTGTACCCACAGTGTT	Negative
CTGTACCCACTGTGAT	Negative
CTGTACCCATGACAAA	Hashtag11
CTGTACCGTTCATCTT	Negative
CTGTACCGTTTATGCG	Hashtag11
CTGTAGAGTCTTGGTA	Hashtag11
CTGTAGATCGTGTTCC	Hashtag11
CTGTATTCAACAACAA	Hashtag12
CTGTATTGTCATTCCC	Negative
CTGTATTGTCTACGTA	Hashtag11
CTGTATTGTGCTCGTG	Negative
CTGTATTGTTGGGTTT	Negative
CTGTATTTCAGCGCAC	Negative
CTGTCGTAGTTAGTAG	Negative
CTGTCGTCAAATTGCC	Hashtag11
CTGTCGTCAGAGAGGG	Hashtag11
CTGTCGTGTGCATGTT	Negative
CTGTCGTTCGGTCTAA	Hashtag11
CTGTGAAAGGTGCTAG	Negative
CTGTGAACAAATAGCA	Hashtag11
CTGTGAACATCTTCGC	Negative
CTGTGAAGTCCTCCTA	Negative
CTGTGAAGTTAAGAAC	Hashtag11
CTGTGAATCCCTGTTG	Hashtag11
CTGTGAATCGAAACAA	Hashtag11
CTGTGAATCTAGCATG	Negative
CTGTGGGAGTCACAGG	Negative
CTGTGGGAGTCCTGTA	Negative
CTGTGGGCACATGGTT	Negative
CTGTGGGCAGTTCCAA	Negative
CTGTGGGCATCATCTT	Negative
CTGTGGGGTGTTGAGG	Hashtag11
CTTACCGAGATAGTCA	Hashtag11
CTTACCGAGCCTGGAA	Hashtag11
CTTACCGCACGAGAAC	Negative
CTTACCGGTACGTTCA	Negative
CTTACCGGTCGACTTA	Negative
CTTACCGGTGAGTAGC	Negative
CTTACCGTCGCCAGAC	Negative
CTTAGGAAGACATCAA	Hashtag12
CTTAGGACATCGGCCA	Hashtag11
CTTAGGACATGGATCT	Hashtag11
CTTAGGAGTACCGGAA	Negative
CTTAGGAGTCTTCTAT	Hashtag11
CTTCAATAGCTCATAC	Hashtag11
CTTCAATGTAGCTGCC	Negative
CTTCAATGTCGTATGT	Hashtag11
CTTCAATGTTGAGAGC	Hashtag11
CTTCAATGTTTCCCAC	Negative
CTTCAATGTTTGTTGG	Hashtag11
CTTCAATTCATACGGT	Negative
CTTCCGAAGGTTCCAT	Negative
CTTCCGATCAACTGAC	Negative
CTTCCGATCATACGAC	Hashtag11
CTTCCGATCTGCCCTA	Negative
CTTCCTTAGAACGTGC	Hashtag11
CTTCCTTAGGGTATAT	Hashtag11
CTTCCTTCATGTGCTA	Negative
CTTCCTTGTCTTCATT	Hashtag11
CTTCCTTGTGCGTGCT	Negative
CTTCGGTCACAGCTTA	Hashtag12
CTTCTAAAGCCATATC	Hashtag11
CTTCTAAAGCTACGTT	Negative
CTTCTAAAGTGTTGAA	Hashtag12
CTTCTAACAGCTCGGT	Hashtag11
CTTCTAAGTTAAGCAA	Negative
CTTCTAAGTTAGGGTG	Hashtag11
CTTCTCTGTCATATGC	Hashtag11
CTTCTCTGTTTCACAG	Negative
CTTGAGACAGCCGTCA	Hashtag11
CTTGAGACAGTTTCAG	Negative
CTTGAGAGTACGTGAG	Hashtag11
CTTGATTCATACTTTC	Negative
CTTGATTGTACAAGTA	Hashtag12
CTTTCAAGTAGGTTTC	Hashtag11
CTTTCAATCGGCTGGT	Hashtag11
CTTTCAATCTATTTCG	Negative
CTTTCGGCACAGAGCA	Negative
CTTTCGGGTCGAATTC	Negative
CTTTCGGTCACCCATC	Negative
CTTTCGGTCGCCTAGG	Hashtag11
GAAACCTCATGTCTAG	Hashtag11
GAAACCTGTGGACCAA	Negative
GAAACCTGTTCAAAGA	Hashtag12
GAAACCTGTTGAGGAC	Negative
GAAACCTTCGGCATCG	Hashtag11
GAAACCTTCTGTGCGG	Negative
GAAATGAAGCCAACCC	Negative
GAAATGAGTAGACACG	Negative
GAAATGAGTCACTAGT	Hashtag11
GAAATGAGTTCCGCAG	Negative
GAAATGATCACAAGAA	Negative
GAACACTAGTGCCCGT	Hashtag11
GAACACTCATCCTTCG	Negative
GAACACTTCATTTCCA	Negative
GAACACTTCGAGGCAA	Hashtag11
GAACACTTCGCAGTCG	Hashtag11
GAACGTTAGACGGTCA	Hashtag11
GAACGTTGTGGACTAG	Negative
GAACGTTTCATTTACC	Negative
GAACGTTTCTAGTTCT	Negative
GAACTGTCACCATTCC	Negative
GAACTGTCATGCGTGC	Hashtag11
GAACTGTTCGTACCTC	Hashtag11
GAAGAATAGAGGGTCT	Hashtag11
GAAGAATCAGTCTCTC	Negative
GAAGAATGTCTGTAAC	Hashtag11
GAAGAATTCACCCATC	Negative
GAAGAATTCCATTGTT	Hashtag11
GAAGAATTCCTTATCA	Negative
GAAGAATTCGTTTACT	Hashtag11
GAAGCCCAGCAGTACG	Negative
GAAGCCCCACCAAATC	Hashtag11
GAAGCCCCAGCAGAAC	Negative
GAAGCCCGTAGAAACT	Hashtag11
GAAGCCCGTCAACACT	Hashtag11
GAAGCCCGTGGATTTC	Hashtag11
GAAGCGAGTGGACTGA	Negative
GAAGCGATCGGAATGG	Negative
GAAGCGATCTTGGATG	Hashtag11
GAAGGACAGGATCACG	Hashtag11
GAAGGACAGTGCTAGG	Hashtag11
GAAGGACCACCAAATC	Negative
GAAGGACCACCCTTGT	Hashtag11
GAAGGACGTCAGGAGT	Negative
GAAGGACTCACGGACC	Hashtag11
GAAGGGTCAAACGTGG	Hashtag11
GAAGGGTCATCTAACG	Negative
GAAGGGTGTATGGAAT	Hashtag11
GAAGGGTGTGAAGCGT	Negative
GAAGTAAAGTCGAGGT	Negative
GAAGTAACATGCAGGA	Negative
GAAGTAAGTCGCAGTC	Negative
GAAGTAATCAAGTGGG	Hashtag11
GAATAGAGTGCTGCAC	Negative
GAATAGATCACCTTAT	Hashtag11
GAATCACCAATTGCGT	Hashtag11
GAATCACTCGGAGCAA	Negative
GAATCGTAGCGAGTAC	Negative
GAATCGTAGTTCATGC	Hashtag11
GAATCGTAGTTCGCAT	Negative
GAATCGTCAACAAGTA	Negative
GAATCGTGTGACTCTA	Hashtag11
GAATCGTTCCACTGGG	Negative
GACACGCAGCATCAGG	Negative
GACACGCTCATCGACA	Negative
GACAGCCAGCATAGGC	Hashtag11
GACAGCCTCTTGGCTC	Hashtag11
GACATCACATCTATCT	Negative
GACATCATCCATCGTC	Negative
GACATCATCGGCTGAC	Hashtag11
GACATCATCTGATGGT	Hashtag11
GACCAATAGGCCCGTT	Hashtag11
GACCAATGTAGTCCTA	Negative
GACCAATGTGGTTTGT	Hashtag11
GACCAATTCCGTGTCT	Negative
GACCCAGCACACTTAG	Negative
GACCCAGCAGCAGATG	Negative
GACCCAGGTGCAATAA	Hashtag12
GACCCAGGTTCTCCCA	Hashtag11
GACCCAGTCCTATGGA	Hashtag12
GACCCAGTCGAGTACT	Hashtag12
GACCCAGTCTCCGCAT	Negative
GACCCTTAGTTCATGC	Negative
GACCCTTCACTCATAG	Hashtag11_Hashtag12
GACCCTTGTATACAGA	Hashtag11
GACCCTTGTCGCATCG	Negative
GACCCTTGTTAAGTCC	Hashtag11
GACCCTTTCTGCGGGT	Hashtag11
GACCGTGAGAGGCGGA	Hashtag11
GACCGTGAGGCTTAGG	Hashtag11
GACCGTGAGGGTTAGC	Hashtag11
GACCGTGCAAGCTCTA	Hashtag11
GACCGTGCAATGCTCA	Negative
GACCTTCAGACCAACG	Negative
GACCTTCCATGCCATA	Hashtag11
GACCTTCTCCGATGCG	Hashtag11
GACCTTCTCGCCACTT	Negative
GACGCTGAGAGGTTTA	Hashtag11
GACGCTGAGTGGTGAC	Negative
GACGCTGGTGAGAACC	Negative
GACGCTGGTGATTCTG	Hashtag11
GACGCTGGTTATAGCC	Negative
GACGCTGGTTCGGCCA	Negative
GACGCTGGTTTGGAAA	Hashtag11
GACGCTGTCGCTACAA	Negative
GACGCTGTCTCGTGGG	Hashtag11
GACGTTACACAAAGTA	Hashtag11
GACGTTAGTTGGATCT	Hashtag11
GACTATGAGACGTCCC	Negative
GACTATGAGGGTTAAT	Negative
GACTATGCAAATTAGG	Negative
GACTATGCACAAGCTT	Hashtag11
GACTATGCAGTAACGG	Negative
GACTATGGTACGATGG	Hashtag12
GACTCAAGTCCACAGC	Negative
GACTCAATCCTGTTGC	Negative
GACTCAATCGGCTTGG	Hashtag11
GACTCAATCTCGTCAC	Negative
GACTCTCAGGGCTTCC	Hashtag11
GACTCTCGTTTACGTG	Hashtag11
GACTGATAGTGAACAT	Hashtag11
GACTGATCACTGTCGG	Hashtag11
GACTTCCAGGTGCATG	Negative
GACTTCCGTACTCCCT	Negative
GACTTCCGTTACTCAG	Negative
GAGAAATCACTATGTG	Hashtag11
GAGAAATGTATGATCC	Hashtag11
GAGAAATGTCATCGCG	Hashtag11
GAGAAATGTCATGACT	Negative
GAGAAATTCCTTATGT	Negative
GAGAAATTCGCATTAG	Hashtag11
GAGACCCAGAGTACCG	Negative
GAGACCCAGCATTGAA	Negative
GAGACCCCAGAAGCTG	Negative
GAGACCCGTGAATATG	Negative
GAGACCCTCCATCAGA	Hashtag12
GAGACCCTCGCCGTGA	Hashtag11
GAGACCCTCGGCCTTT	Negative
GAGACCCTCTCTTAAC	Hashtag11
GAGACTTAGGGTATAT	Hashtag11
GAGACTTCAATGAACA	Hashtag11
GAGACTTCAGTGGGTA	Negative
GAGACTTCATCCGTGG	Negative
GAGACTTGTACTCGAT	Hashtag11
GAGAGGTAGTAAATGC	Hashtag11
GAGAGGTGTGTGATGG	Negative
GAGAGGTTCTCTAGGA	Hashtag11
GAGATGGAGATGCTTC	Hashtag11_Hashtag12
GAGATGGAGCATCAGG	Hashtag12
GAGATGGGTAATGCTC	Negative
GAGATGGGTAGCGTTT	Negative
GAGATGGTCCCTGGTT	Hashtag11
GAGCCTGCACTGCGTG	Hashtag12
GAGCCTGTCCATTTAC	Negative
GAGCCTGTCTCACCCA	Negative
GAGCTGCAGAGTGAAG	Hashtag12
GAGCTGCAGTGCTCGC	Negative
GAGCTGCAGTTGGCTT	Negative
GAGCTGCGTGTTCGTA	Negative
GAGCTGCTCATTCGGA	Negative
GAGGCAAAGAAACTGT	Hashtag11
GAGGCAAGTAGCTTAC	Negative
GAGGCAAGTCATCAGT	Negative
GAGGCAAGTGCCGTAC	Hashtag11
GAGGCCTGTGATCGTT	Hashtag11
GAGGCCTTCCCAAGCG	Negative
GAGGCCTTCGACGATT	Hashtag11
GAGGGATCATCCGAAT	Negative
GAGGGATGTGGGTATG	Negative
GAGGGTAAGACCATGG	Negative
GAGGGTAAGCGTGCCT	Hashtag11
GAGGGTAGTCTGTCCT	Hashtag11
GAGGGTAGTGTGCTTA	Negative
GAGGGTATCCGTAGGC	Hashtag11
GAGGGTATCCTCTTTC	Negative
GAGTCATAGGCGTCCT	Negative
GAGTCATCAGGTGACA	Negative
GAGTCATGTCGTGTTA	Negative
GAGTCATTCCTCACGT	Negative
GAGTCTAAGGCCACCT	Negative
GAGTCTATCACTCCGT	Hashtag11
GAGTCTATCCAAGCAT	Negative
GAGTCTATCTGAGGTT	Negative
GAGTGAGAGAACTTCC	Hashtag11
GAGTGAGAGGCACGAT	Hashtag11
GAGTGAGCAGAACGCA	Hashtag12
GAGTGAGTCACCTGGG	Negative
GAGTGAGTCATTTGCT	Negative
GAGTGAGTCTCTATGT	Hashtag11
GAGTGTTAGAGGCTGT	Hashtag11
GAGTGTTAGCTACTAC	Hashtag11
GAGTGTTCAACTCGTA	Negative
GAGTGTTGTTATAGAG	Hashtag11
GAGTGTTGTTGCTTGA	Hashtag11
GAGTTACAGGGTCAAC	Negative
GAGTTACAGTGGCCTC	Negative
GAGTTACGTTCCGTTC	Negative
GAGTTGTAGCTAAACA	Hashtag12
GAGTTGTAGGTACTGG	Negative
GAGTTGTAGTCTGCAT	Negative
GAGTTGTCACGCTGTG	Negative
GAGTTGTGTGATTAGA	Negative
GAGTTTGAGAGAGTTT	Hashtag11
GAGTTTGAGAGCTGCA	Negative
GAGTTTGAGCAGCCTC	Negative
GAGTTTGAGGCACGAT	Negative
GAGTTTGAGTGAGTGC	Hashtag11
GAGTTTGCACGCTTAA	Negative
GAGTTTGCACGTGTGC	Negative
GAGTTTGCATCAGTGT	Negative
GAGTTTGGTCAACCAT	Negative
GAGTTTGGTGGCAGAT	Negative
GATAGAAAGGTCATCT	Negative
GATAGAAAGTTTGGCT	Negative
GATAGAAGTCATCGGC	Hashtag11
GATAGCTAGCGAAACC	Negative
GATAGCTGTGTCATCA	Hashtag11
GATCACAAGGGTCACA	Hashtag11
GATCACATCTTAGCCC	Hashtag11
GATCAGTAGACCAAAT	Hashtag12
GATCAGTAGCACTTTG	Hashtag11
GATCAGTCATCCAACA	Negative
GATCAGTGTCATTCCC	Hashtag12
GATCAGTTCACTCGAA	Negative
GATCAGTTCCGTAGTA	Hashtag11
GATCAGTTCGTCTCAC	Negative
GATCATGAGGTCGTCC	Hashtag12
GATCATGCAGATTCGT	Hashtag11
GATCATGGTAGCGTCC	Negative
GATCATGGTCGCATTA	Negative
GATCATGTCAAATGAG	Hashtag11
GATCATGTCACCTTGC	Negative
GATCATGTCTGGTTGA	Hashtag11
GATCCCTCAAAGAACT	Hashtag12
GATCCCTCACATGTTG	Hashtag11
GATCCCTGTACGGGAT	Negative
GATCCCTGTAGAGACC	Hashtag12
GATCCCTTCTAAACGC	Hashtag11
GATCGTAAGCCTCTTC	Negative
GATCGTAAGGACAGTC	Negative
GATCGTAAGTCACTCA	Negative
GATCGTAAGTTTAGGA	Negative
GATCGTACAATGACCT	Negative
GATCGTACACCTAAAC	Hashtag11
GATCGTATCCGATAGT	Negative
GATGACTCAGGTGGAT	Negative
GATGACTGTGCCTAAT	Negative
GATGAGGCAAATGCTC	Negative
GATGAGGCAATTGTGC	Negative
GATGATCGTAACGATA	Negative
GATGATCGTCTCGGAC	Hashtag11
GATGATCTCCTAACAG	Hashtag11
GATGCTAAGACGGTTG	Negative
GATGCTAAGCCTTTGA	Negative
GATGCTACAACCCTCT	Negative
GATGCTACAATGTTGC	Negative
GATGCTACAGCTGTGC	Negative
GATGCTAGTATCGAGG	Negative
GATGCTAGTTTACGAC	Negative
GATGCTATCCATACTT	Negative
GATGGAGAGCAGCGAT	Negative
GATGGAGAGCGACCCT	Hashtag11
GATGGAGAGTAGGAAG	Hashtag12
GATGGAGAGTAGTCCT	Hashtag12
GATGGAGAGTGGTTGG	Hashtag11
GATGGAGCAAACTAGA	Negative
GATGGAGGTCGTCGGT	Negative
GATGGAGGTGGCTTAT	Hashtag11
GATGGAGGTGGGTCAA	Negative
GATGGAGGTGGTAATA	Negative
GATGGAGTCCATCCGT	Negative
GATGGAGTCGCTATTT	Negative
GATGTTGCACATAACC	Hashtag11
GATGTTGCAGGTTTAC	Hashtag11
GATGTTGCATGCTGCG	Negative
GATGTTGGTAATACCC	Negative
GATGTTGGTTGCCGCA	Negative
GATGTTGTCTATCGGA	Negative
GATTCGAAGGTAAACT	Negative
GATTCGACAATAGGAT	Hashtag11
GATTCGAGTAATGCGG	Hashtag11
GATTCGAGTCAAGCCC	Negative
GATTCGAGTCAAGCGA	Hashtag11
GATTCGAGTCGCATCG	Negative
GATTCGATCCCGAGGT	Negative
GATTCGATCCCTCGAT	Hashtag11
GATTCTTCACACACGC	Negative
GATTCTTCATGTCTAG	Hashtag12
GATTCTTGTGCAGGAT	Hashtag12
GATTCTTTCGCTCATC	Hashtag11
GATTCTTTCGCTGATA	Negative
GATTGGTCAACGGCTC	Hashtag11
GATTGGTCACTAGGCC	Negative
GATTGGTCACTCAGAT	Hashtag11
GATTGGTTCATGACAC	Negative
GATTTCTAGCCTATCA	Hashtag11
GATTTCTAGGATTTAG	Hashtag11
GATTTCTGTGAGATAT	Hashtag11
GATTTCTGTTCAACGT	Negative
GATTTCTTCAACACGT	Negative
GATTTCTTCGAACGGA	Negative
GATTTCTTCTGAATCG	Negative
GCAACATAGCATATGA	Negative
GCAACATAGTCCGTCG	Hashtag11
GCAACATCACCAACAT	Hashtag11
GCAACATGTATCACGT	Negative
GCAACATGTATCGAGG	Negative
GCAACATGTCATGCAT	Hashtag11
GCAACATGTGGTCTCG	Hashtag11
GCAACATGTTACTCAG	Hashtag11
GCAACCGAGCGACTTT	Negative
GCAACCGGTCTACATG	Hashtag11
GCAACCGGTGATTGGG	Negative
GCAACCGTCCTACGGG	Hashtag11
GCAACCGTCGTCCATC	Negative
GCACGGTAGGGTCACA	Negative
GCACGGTCAGTTAGGG	Hashtag11
GCACGGTGTTGCAAGG	Hashtag11
GCACGGTTCACCATAG	Hashtag11
GCACGGTTCGACATCA	Hashtag11
GCACGGTTCGACATTG	Hashtag11
GCACGTGCAACCGCTG	Negative
GCACGTGCAATTGAGA	Hashtag11
GCACGTGCAGCAGAAC	Hashtag11
GCACGTGGTAACCCTA	Hashtag11
GCACGTGGTCTACACA	Negative
GCACGTGGTGCGTTTA	Negative
GCACGTGTCATGAAAG	Hashtag11
GCACTAAAGCAAGGAA	Hashtag11
GCACTAAAGTAGTCCT	Negative
GCACTAACAGGAGGAG	Hashtag11
GCACTAACATGTCGTA	Negative
GCACTAAGTAATTAGG	Negative
GCACTAAGTACCTTCC	Negative
GCACTAAGTCCTGGGT	Hashtag11
GCACTAAGTTAGCGGA	Negative
GCACTAATCAGGTAAA	Negative
GCACTAATCGTAGGAG	Hashtag11
GCAGCCAAGTAGGATT	Negative
GCAGCTGCAATTCGTG	Hashtag11
GCAGCTGCATGTGGCC	Hashtag11
GCAGCTGGTTACAGCT	Hashtag11
GCAGCTGTCCCAAGTA	Hashtag11
GCAGGCTAGTTGGACG	Negative
GCAGGCTCACATTCTT	Negative
GCAGGCTCATTCAGGT	Negative
GCAGGCTGTACCTATG	Hashtag11
GCAGGCTGTACGACAG	Negative
GCAGTTAAGGTTTGAA	Negative
GCAGTTACAAGTATAG	Negative
GCAGTTACAATCTAGC	Hashtag12
GCAGTTAGTACACGCC	Negative
GCAGTTATCAGAACCT	Hashtag11
GCATCTCAGCTCCACG	Negative
GCATCTCAGGTGGCTA	Negative
GCATCTCCACGTAGAG	Hashtag11
GCATCTCGTCGCCACA	Negative
GCATCTCTCGGACTTA	Negative
GCATGATAGGTGATAT	Negative
GCATGATGTACCTAGT	Negative
GCATGATGTCTAGTGT	Negative
GCATGATTCATCGCTC	Hashtag11
GCATGATTCCATTTAC	Hashtag11
GCATGATTCGAGTGAG	Hashtag11
GCATTAGAGCACCAGA	Negative
GCATTAGCAAACACGG	Hashtag11
GCATTAGGTGTCATCA	Hashtag11
GCATTAGGTTGGGACA	Negative
GCATTAGTCTGATTCT	Hashtag11
GCCAACGAGCGCCATC	Negative
GCCAACGCAACTGCCG	Hashtag11
GCCAACGGTATCCTCC	Hashtag11
GCCAACGGTTGGGTTT	Hashtag12
GCCAGCAGTAACAGTA	Negative
GCCAGCAGTCCAGGTC	Hashtag11
GCCAGCAGTCCTGGGT	Negative
GCCAGCAGTGACTATC	Negative
GCCAGCATCGCAAGAG	Hashtag11
GCCAGTGAGCTGTGCC	Hashtag11
GCCAGTGTCTTACACT	Hashtag12
GCCATGGAGCACGTCC	Negative
GCCATGGGTGCCCTTT	Hashtag11
GCCATGGGTTGCTTGA	Negative
GCCATGGTCATGCCGG	Hashtag12
GCCATGGTCCATTCGC	Negative
GCCATTCAGGTGAGAA	Negative
GCCATTCCAGTGAGCA	Negative
GCCATTCGTCATAGTC	Negative
GCCATTCGTTCGCGTG	Negative
GCCATTCTCCGCACTT	Negative
GCCATTCTCGCGGTAC	Negative
GCCCAGACACTGCATA	Negative
GCCCAGAGTTGAATCC	Negative
GCCCAGATCCTGTTAT	Hashtag11
GCCCGAAAGAAGTATC	Hashtag11
GCCCGAACATCAGCTA	Negative
GCCCGAATCTAACGGT	Hashtag11
GCCGATGAGACCATAA	Negative
GCCGATGCAGAGATGC	Hashtag11
GCCGATGCATGGAGAC	Negative
GCCGATGGTGGATGAC	Hashtag12
GCCGTGAAGGTTAAAC	Hashtag12
GCCGTGACACCAGACC	Hashtag11
GCCGTGAGTGCCGAAA	Hashtag12
GCCGTGATCCTTCACG	Negative
GCCGTGATCTACCAGA	Hashtag11
GCCTGTTAGCAGTACG	Negative
GCCTGTTAGTTTGGCT	Negative
GCCTGTTGTATGTCCA	Negative
GCCTGTTTCACGACTA	Hashtag11
GCCTGTTTCAGTGTGT	Negative
GCCTGTTTCCCTGGTT	Hashtag11
GCCTGTTTCGCATTGA	Negative
GCCTGTTTCTACTGCC	Hashtag11
GCGAGAAAGATGTTAG	Negative
GCGAGAAAGGTTGCCC	Negative
GCGAGAAGTCACTTCC	Negative
GCGAGAAGTCATAGTC	Negative
GCGAGAAGTCCGTTTC	Negative
GCGAGAAGTCCTACGG	Hashtag11
GCGAGAATCCGGACTG	Negative
GCGAGAATCTTGGCTC	Negative
GCGATCGCACCTCAGG	Hashtag11
GCGATCGGTAACGCGA	Negative
GCGATCGTCACGGGAA	Hashtag11
GCGATCGTCCCTTTGG	Hashtag11
GCGGAAAGTCTCGGGT	Hashtag11
GCGGAAAGTTGCGGAA	Negative
GCGGAAATCGCGTGCA	Hashtag11
GCGGAAATCTGCTGAA	Negative
GCGGATCAGTTACGTC	Negative
GCGGATCCAAGACGAC	Negative
GCGGATCCAGAGAATT	Hashtag11
GCGGATCCAGCCATTA	Negative
GCGGATCGTCAGCGTC	Hashtag12
GCGGATCGTGAGACGT	Negative
GCGGATCTCCCTGGTT	Hashtag11
GCGGATCTCTATTCGT	Hashtag12
GCGTGCAAGCGATCGA	Negative
GCGTGCAAGTAATCCC	Negative
GCGTGCAAGTCGCGAA	Hashtag12
GCGTGCACAATTTCCT	Negative
GCGTGCACACAAAGTA	Negative
GCGTGCAGTTGGGAAC	Negative
GCGTTTCAGGAGGGTG	Negative
GCGTTTCCAAGGCAAC	Negative
GCGTTTCCAGCATACT	Hashtag11
GCGTTTCCATACCAGT	Hashtag11
GCTACAAAGAGTGACC	Hashtag11
GCTACAAAGCTGCCAC	Hashtag11_Hashtag12
GCTACAACATGGCCCA	Hashtag11
GCTACAATCAATCCAG	Negative
GCTACAATCCCATACC	Hashtag11
GCTACAATCGAAGTGG	Hashtag11
GCTACCTAGCCGTAAG	Negative
GCTACCTGTCCTGTCT	Hashtag11
GCTACCTGTGCGCTCA	Negative
GCTCAAACAGCTAACT	Hashtag11
GCTCAAAGTACACTCA	Negative
GCTCAAAGTATCACCA	Negative
GCTGAATAGGTGATCG	Negative
GCTGAATCAGGACATG	Hashtag12
GCTGAATCATCGTGCG	Hashtag11
GCTGAATGTCTTGTCC	Hashtag12
GCTGCAGAGCACCTGC	Negative
GCTGCAGAGGGTGAAA	Negative
GCTGCAGAGTCCCTAA	Negative
GCTGCAGGTCCACATA	Hashtag11
GCTGCAGGTGATCATC	Hashtag11
GCTGGGTCAACGGGTA	Hashtag11
GCTGGGTGTACGGGAT	Hashtag11
GCTGGGTGTCACTCGG	Hashtag11
GCTTCACCATACTGTG	Hashtag11
GCTTGGGAGGTCCTGC	Hashtag12
GCTTGGGGTCGGCTAC	Hashtag11
GCTTTCGAGAAGCTGC	Negative
GCTTTCGAGCTCAGAG	Negative
GCTTTCGCAGTCGAGA	Hashtag11
GCTTTCGGTTGGTACT	Hashtag11
GGAACCCAGAAGGGAT	Negative
GGAACCCCACAGCTTA	Hashtag11
GGAACCCGTACGTACT	Negative
GGAACCCTCTCCCAAC	Hashtag11
GGAAGTGCAATTGAAG	Hashtag11
GGAAGTGCACCTCAGG	Negative
GGAAGTGGTCGTCTCT	Negative
GGAAGTGGTTCGCGTG	Hashtag11
GGAATCTAGCACTCGC	Negative
GGAATCTTCGACACCG	Negative
GGAATGGAGGTCACCC	Negative
GGAATGGGTGAGACGT	Hashtag12
GGAATGGGTGCAGGAT	Negative
GGACGTCAGGACAAGA	Negative
GGACGTCAGGTATTGA	Hashtag11
GGAGAACCAGCTCTGG	Hashtag11
GGAGAACTCCCTGGTT	Hashtag11
GGAGATGGTAGTCGGA	Hashtag11
GGAGATGGTCAAGCGA	Hashtag11
GGAGATGGTCACTACA	Hashtag11
GGAGATGGTCCGGCAT	Hashtag11
GGAGATGGTTCAACGT	Negative
GGAGATGTCGGTGCAC	Negative
GGAGATGTCTGGGCAC	Hashtag11
GGAGCAAAGAACCGCA	Negative
GGAGCAAAGATGGCAC	Hashtag11_Hashtag12
GGAGCAAAGCGTTAGG	Negative
GGAGCAAGTAATGCGG	Negative
GGAGCAATCTGATTCT	Negative
GGAGGTACACAGTATC	Negative
GGAGGTACACGACGCT	Negative
GGAGGTACATTGGCAT	Hashtag11
GGATCTAAGACGGTTG	Hashtag11
GGATCTAAGTGTAGTA	Negative
GGATCTACACTCCGGA	Negative
GGATCTACAGAGAGGG	Negative
GGATCTAGTTTCACTT	Hashtag11
GGATCTATCAGACATC	Hashtag11
GGATCTATCAGCAGAG	Negative
GGATGTTCAATCGCAT	Negative
GGATGTTCAGGAACCA	Negative
GGCACGTAGTGGTTAA	Negative
GGCACGTCAAGTGGAC	Negative
GGCACGTTCAGGGTAG	Negative
GGCACGTTCGCCGAGT	Negative
GGCAGTCAGGGACACT	Hashtag11
GGCAGTCCAATTGCAC	Hashtag11
GGCAGTCCAGTTGGTT	Negative
GGCAGTCTCCGAAATC	Negative
GGCAGTCTCGCTAGCG	Hashtag11
GGCAGTCTCGTGCGAC	Hashtag11
GGCGTCAAGCTGACAG	Hashtag11
GGCGTCAAGGCCTAGA	Hashtag11
GGCGTCAAGTCGCCCA	Hashtag11
GGCGTCACAGACAATA	Hashtag12
GGCGTCACATAGATCC	Negative
GGCGTCAGTCCCAAAT	Hashtag11
GGCGTCATCCAGCCTT	Negative
GGCGTCATCCGATCTC	Hashtag12
GGCGTCATCTTGATTC	Negative
GGCTGTGAGATGCAGC	Hashtag11
GGCTGTGAGTTGGAGC	Negative
GGCTGTGTCCGATCTC	Hashtag11
GGCTTGGGTCTTTCAT	Hashtag11
GGCTTGGTCACGTCCT	Hashtag11
GGCTTGGTCCTCTAAT	Hashtag11
GGCTTTCCATAGATGA	Hashtag11
GGCTTTCGTCGACGCT	Negative
GGCTTTCGTGAATAAC	Negative
GGCTTTCTCAAGGACG	Negative
GGGAAGTAGATTAGTG	Hashtag12
GGGAAGTAGCGACTAG	Hashtag12
GGGAAGTAGGTATCTC	Hashtag11
GGGAAGTAGTTAGTGA	Hashtag11
GGGAAGTGTCGTGTTA	Negative
GGGAAGTTCCCTGGTT	Negative
GGGAAGTTCCGATGTA	Negative
GGGACAAAGTACGTCT	Negative
GGGACAAGTAGCTGAG	Negative
GGGACCTAGCATGATA	Hashtag11
GGGACCTAGCCTGTCG	Negative
GGGACCTAGGTCGTGA	Negative
GGGACCTGTACAGTCT	Negative
GGGACCTGTCGTGCCA	Hashtag11
GGGACCTTCCCGAGAC	Negative
GGGACCTTCTTGGAAC	Hashtag11
GGGACTCAGGGTTTCT	Negative
GGGACTCCAGGCTCTG	Hashtag11
GGGAGATCAAATCAAG	Hashtag12
GGGAGATGTACCGCGT	Negative
GGGAGTAAGGATTCAA	Negative
GGGAGTACACACGTGC	Hashtag11
GGGAGTACATGGCTAT	Hashtag12
GGGAGTAGTGGTCTGC	Negative
GGGAGTAGTTGAAGTA	Negative
GGGAGTATCGATCCCT	Hashtag11
GGGATCCAGAGTGACC	Hashtag11
GGGATCCCATCCGGTG	Hashtag11
GGGATCCGTCGAACAG	Negative
GGGATCCGTGACCGAA	Hashtag11
GGGATGAAGGGTACGT	Negative
GGGATGAAGGTAAGTT	Negative
GGGATGAAGTACAGAT	Negative
GGGATGACAAGGTCTT	Hashtag11
GGGATGATCGCTCTCA	Negative
GGGATGATCGGCCTTT	Negative
GGGCCATAGGTTGGAC	Hashtag11
GGGCCATCAGGGTTGA	Negative
GGGCGTTAGCGCTGCT	Negative
GGGCGTTAGGGTACAC	Negative
GGGCGTTAGTCAGAGC	Negative
GGGCGTTCACCTGTCT	Negative
GGGCGTTGTAGTTAGA	Negative
GGGCGTTGTGGTCTGC	Hashtag11
GGGCGTTTCGGAAGGT	Negative
GGGCGTTTCTCACTCG	Negative
GGGCGTTTCTGAGATC	Hashtag11
GGGCTACGTCATTCCC	Hashtag11
GGGCTACGTGATTCTG	Negative
GGGCTCAAGTTACGTC	Hashtag11
GGGCTCACAACGGCTC	Negative
GGGCTCATCAAAGAAC	Hashtag11
GGGCTCATCAGCAATC	Negative
GGGCTCATCGAAATCC	Negative
GGGCTCATCGCCTAGG	Hashtag11
GGGTAGACAGCTGAAG	Hashtag11
GGGTAGAGTATAGCTC	Hashtag11
GGGTAGAGTCTTGAGT	Hashtag12
GGGTATTAGTCTTCCC	Negative
GGGTATTCAAGCACCC	Negative
GGGTATTGTCAAGCGA	Negative
GGGTATTTCGATAACC	Negative
GGGTATTTCTGCATAG	Negative
GGGTATTTCTTCGATT	Negative
GGGTCACAGTTTCGAC	Hashtag11
GGGTCACCAGTCCGTG	Negative
GGGTCACTCATGGGAG	Negative
GGGTCTGAGATGGTAT	Hashtag11
GGGTCTGAGGAGTATT	Negative
GGGTCTGCAATGACCT	Negative
GGGTCTGGTCACGCTG	Hashtag11
GGGTCTGGTTAGAAGT	Negative
GGGTCTGGTTGGATCT	Hashtag11
GGGTGAAAGTAAACTG	Hashtag12
GGGTGAAAGTTGCCCG	Negative
GGGTGAATCCATAAGC	Negative
GGGTGAATCTCATGCC	Negative
GGGTGTCAGACCGCCT	Hashtag12
GGGTGTCAGAGAGTTT	Hashtag11
GGGTGTCCAGACCTAT	Hashtag11
GGGTGTCCAGGCGTTC	Hashtag11
GGGTGTCGTCGCTCGA	Negative
GGGTGTCTCCTCAGAA	Hashtag11
GGGTTATAGTTGCTGT	Negative
GGGTTATCATCGATCA	Hashtag11
GGGTTTAAGGTGGTTG	Hashtag11
GGGTTTACACAGCTTA	Negative
GGGTTTACATCGATGT	Hashtag11
GGGTTTAGTAGACGGT	Hashtag11
GGTAACTCAGGTGACA	Negative
GGTAATCAGCAGTAAT	Negative
GGTAATCTCAGGTAAA	Negative
GGTAATCTCCTAAGTG	Hashtag11
GGTAGAGCACTAGTAC	Hashtag11
GGTAGAGGTACGAAAT	Negative
GGTAGAGGTTTAGAGA	Negative
GGTCACGAGGCATTTC	Hashtag11
GGTCACGTCCATCCGT	Hashtag12
GGTCTGGAGGAACGAA	Negative
GGTCTGGAGGTGCCTC	Hashtag11
GGTCTGGGTCACGTGC	Negative
GGTCTGGGTTGGTAGG	Hashtag12
GGTGAAGCAGACCTAT	Negative
GGTGAAGCATCCTATT	Hashtag11
GGTGAAGGTCGTGTTA	Hashtag11
GGTGAAGGTTATGTGC	Hashtag11
GGTGAAGGTTTGCAGT	Negative
GGTGAAGTCTAGGCCG	Hashtag11
GGTGATTAGAATAGTC	Hashtag11
GGTGATTAGTATTCCG	Hashtag11
GGTGATTAGTTGCCTA	Hashtag11
GGTGATTCAAGTGGAC	Hashtag11
GGTGATTGTTCCCACT	Negative
GGTGATTTCAGTGTTG	Negative
GGTGGCTAGATTGATG	Hashtag11
GGTGGCTGTTAAGGGC	Negative
GGTGTCGAGGCCTGCT	Hashtag11
GGTGTCGCAGAATTCC	Hashtag12
GGTGTCGGTCTCCCTA	Negative
GGTGTCGTCCTCTAAT	Hashtag11
GGTGTCGTCGCACGGT	Negative
GGTGTTACAAATCAAG	Hashtag11
GGTGTTACATCCTGTC	Negative
GGTGTTAGTGGATGAC	Negative
GGTTAACCAAACTGCT	Negative
GGTTCTCGTAGCTGAG	Hashtag11
GGTTCTCTCCACGTAA	Negative
GGTTCTCTCTGGGCGT	Hashtag11
GGTTGTAGTAACACGG	Hashtag11
GGTTGTAGTGGTTCTA	Negative
GTAACACCAGTCGCAC	Hashtag11
GTAACACGTCTCAGAT	Negative
GTAACACTCCAGCTCT	Negative
GTAACCAAGGCACGAT	Hashtag11
GTAACCAAGGCTGAAC	Hashtag11
GTAACCACAGAGGTTG	Hashtag11
GTAACCACAGCGTATT	Negative
GTAACCAGTCTTGAAC	Negative
GTAACCATCAAGAGGC	Hashtag11
GTAAGTCAGTCTGCGC	Negative
GTAAGTCTCTTCGATT	Negative
GTAATCGAGTCACGCC	Hashtag11
GTAATCGCAAAGTATG	Negative
GTAATCGCACAATGTC	Hashtag11
GTAATCGCAGTCAGTT	Hashtag11
GTAATCGGTTACGTAC	Negative
GTAATCGTCACTGATG	Negative
GTAATCGTCTTGGAAC	Negative
GTAATGCAGAGAGTGA	Negative
GTAATGCAGTTGTACC	Negative
GTAATGCCAGGAAGTC	Negative
GTAATGCGTGAGTGAC	Hashtag12
GTAATGCGTGTGTGGA	Negative
GTAATGCTCTGATGGT	Negative
GTACAACAGGTTACAA	Hashtag11
GTACAACAGTAACGAT	Hashtag11
GTACAACAGTACCCTA	Hashtag11
GTACAACCATCGGCCA	Hashtag11
GTACAACGTCATCGCG	Negative
GTACAACGTGCCGTAC	Hashtag11
GTACAACGTGCGACAA	Negative
GTACAGTAGTAAACAC	Negative
GTACAGTAGTTACGAA	Hashtag11
GTACAGTGTCTGCATA	Hashtag11
GTACAGTGTGCGAGTA	Hashtag11
GTACAGTGTTCCCACT	Hashtag11
GTAGAAAAGATCGCTT	Negative
GTAGAAAAGGATACCG	Negative
GTAGAAACAATTTCTC	Hashtag11
GTAGAAACACCCTGTT	Hashtag11
GTAGAAATCGACCACG	Negative
GTAGAAATCGCAAGAG	Hashtag11
GTAGAAATCGTTGCCT	Negative
GTAGAAATCTTAAGGC	Negative
GTAGAGGAGTTGCTGT	Hashtag11
GTAGAGGGTAGTGATA	Hashtag11
GTAGAGGGTCCGGTCA	Negative
GTAGAGGTCTAACGCA	Hashtag11
GTAGATCGTCAGGCAA	Negative
GTAGATCGTTCTAACG	Hashtag11
GTAGATCTCCCTTGTG	Negative
GTAGCTAAGCTCTATG	Hashtag11
GTAGCTAAGGCATTTC	Negative
GTAGCTACACCTGTCT	Hashtag11
GTAGCTACAGTCCCGA	Hashtag11
GTAGCTACATGGGCAA	Negative
GTAGGAGAGCCGTCGT	Hashtag11
GTAGGAGCAGACCAGA	Negative
GTAGGAGGTCGCAACC	Negative
GTAGGAGGTGTGAGCA	Negative
GTAGGAGTCCACTTTA	Hashtag11
GTAGGAGTCGGCTGGT	Negative
GTAGGTTAGCTTTGTG	Negative
GTAGGTTCATCCCACT	Negative
GTAGGTTCATGGTACT	Negative
GTAGGTTCATGTCGTA	Negative
GTAGGTTGTATGAGCG	Negative
GTAGGTTGTGCGAGTA	Negative
GTAGTACAGCATTTCG	Hashtag11
GTAGTACAGGTAGCAC	Negative
GTAGTACCAAGCCCAC	Hashtag11
GTAGTACCATGCGTGC	Hashtag11
GTAGTACGTAGACGGT	Hashtag11
GTAGTACGTGCCGTTG	Hashtag11
GTAGTACTCTTTCCGG	Negative
GTATTGGCATACCATG	Negative
GTATTGGGTACGACTT	Negative
GTATTGGGTCCCTGAG	Negative
GTATTGGGTTGGGTTT	Negative
GTATTGGGTTGTCATG	Negative
GTATTGGTCAAGCGTT	Negative
GTATTGGTCATTTACC	Negative
GTATTGGTCGTCTACC	Negative
GTATTTCAGCTTCTAG	Negative
GTATTTCCAATCTGCA	Hashtag11
GTATTTCCACTTCTCG	Hashtag11
GTATTTCTCAGCTAGT	Hashtag11
GTCAAGTAGAAGCCAC	Hashtag12
GTCAAGTAGCCAAGTG	Hashtag11
GTCAAGTCAGATACCT	Negative
GTCAAGTCATTAAAGG	Hashtag11
GTCAAGTGTCACTGAT	Negative
GTCAAGTGTCAGGCAA	Hashtag12
GTCAAGTGTTGCCATA	Hashtag11
GTCACGGGTCGTGCCA	Hashtag11
GTCACTCAGGCATCAG	Negative
GTCACTCCAAATGGTA	Hashtag11
GTCACTCGTCATCCCT	Negative
GTCACTCGTCGCAGTC	Negative
GTCACTCTCAAATGAG	Negative
GTCACTCTCAGCTTCC	Negative
GTCACTCTCTCGGTAA	Hashtag11
GTCAGCGGTGGTATGG	Negative
GTCAGCGGTGTTAGCT	Negative
GTCAGCGTCAACTGGT	Hashtag11
GTCAGCGTCATGAAAG	Negative
GTCAGCGTCCATACAG	Negative
GTCAGCGTCCCACAGG	Negative
GTCATCCCAACGCATT	Hashtag12
GTCATCCCATGCGTGC	Negative
GTCATCCCATTACGGT	Negative
GTCATCCGTCCAGCGT	Hashtag11
GTCATCCGTGCCTAAT	Negative
GTCATCCTCATCGCCT	Hashtag12
GTCATGAAGTAAACAC	Hashtag11
GTCATGACAGCGACAA	Negative
GTCATGAGTACCATAC	Negative
GTCATGATCAAGTTGC	Hashtag11
GTCATTTAGCTGGTGA	Negative
GTCATTTAGTTTAGGA	Negative
GTCATTTCACACCGAC	Hashtag11
GTCATTTCAGACTCTA	Hashtag11
GTCATTTGTCCCTCAT	Negative
GTCATTTGTGACGTCC	Hashtag11
GTCATTTTCCACGTAA	Negative
GTCATTTTCGCACTCT	Hashtag12
GTCCACTAGCTGTACT	Negative
GTCCACTAGTGGAAAG	Negative
GTCCACTTCTCGTCAC	Hashtag11
GTCCCATCACTAACGT	Hashtag11
GTCCCATGTCGATGCC	Hashtag12
GTCCCATGTGTTCCTC	Negative
GTCCCATTCGGAGATG	Hashtag11
GTCCCATTCGGTTCAA	Hashtag11
GTCCTCACAAATGGTA	Negative
GTCCTCACAACAGATA	Negative
GTCCTCAGTCGCAGTC	Negative
GTCCTCAGTCTTCTAT	Negative
GTCCTCATCACCTCTG	Hashtag11
GTCGAATAGTTGAATG	Negative
GTCGAATGTTAGAAGT	Hashtag11
GTCGAATTCAGTGTGT	Hashtag11
GTCGCGAAGCACACAG	Hashtag11
GTCGCGACAGAAGTGC	Hashtag11
GTCGCGATCGGTTAGT	Hashtag11
GTCGTAATCAGTGGGA	Hashtag11
GTCGTAATCTAGCCTC	Negative
GTCGTTCAGCTCGACC	Hashtag11
GTCGTTCCATATGGCT	Hashtag11
GTCGTTCGTCTGATCA	Hashtag11
GTCGTTCTCGTCCATC	Hashtag11
GTCGTTCTCTACCCAC	Hashtag11
GTCTACCAGGCATGGT	Negative
GTCTACCCATTCGGGC	Negative
GTCTACCGTAGCGTTT	Hashtag11
GTCTACCGTATGCGTT	Hashtag11
GTCTACCGTCCGTACG	Hashtag11
GTCTACCTCGTTACCC	Negative
GTCTAGAAGCCATCCG	Negative
GTCTAGAGTTATGGTC	Hashtag11
GTCTCACAGAAAGTCT	Hashtag11
GTCTCACCAAACGAGC	Negative
GTCTCACGTCAACCAT	Negative
GTCTCACGTCATTGCA	Hashtag11
GTCTGTCAGAGGATGA	Negative
GTCTGTCAGTCTCGTA	Negative
GTCTGTCCACCCGTAG	Negative
GTCTGTCGTAGCCAGA	Hashtag12
GTCTGTCGTCGTTCAA	Negative
GTCTGTCGTGACGTCC	Hashtag11
GTCTGTCTCCAATGCA	Hashtag11
GTCTTTAAGCCAACCC	Negative
GTCTTTAGTACCTTCC	Negative
GTCTTTAGTAGAAACT	Hashtag11
GTCTTTAGTCCTTGTC	Negative
GTGACGCGTATCTTCT	Negative
GTGACGCGTTGCTAGT	Negative
GTGACGCTCAACCTTT	Negative
GTGACGCTCACGGAGA	Hashtag11
GTGACGCTCCGCGGAT	Hashtag11
GTGACGCTCTTCGATT	Negative
GTGAGCCAGTGTACAA	Negative
GTGAGCCGTTATGTCG	Negative
GTGAGCCGTTCTCTAT	Negative
GTGAGCCTCATTGCGA	Hashtag12
GTGAGGAAGGTGGTTG	Hashtag11
GTGAGGAAGTCCCAGC	Hashtag11
GTGAGGACAAGCGAGT	Negative
GTGAGGACACAACGCC	Hashtag12
GTGAGGACAGAAGTGC	Negative
GTGAGGACAGCAAGAC	Hashtag11
GTGAGGAGTATGGAGC	Hashtag12
GTGAGGAGTATGGTAA	Hashtag11_Hashtag12
GTGAGGATCTTAGTTC	Negative
GTGAGTTGTTGGGATG	Hashtag11
GTGAGTTTCACCGACG	Negative
GTGATGTAGGCATCTT	Negative
GTGATGTCACTTTAGG	Negative
GTGATGTGTCAGGCAA	Negative
GTGATGTGTCGCAACC	Hashtag11
GTGATGTGTCTAGTGT	Negative
GTGATGTGTGTCATTG	Negative
GTGATGTTCCATCCGT	Hashtag11
GTGATGTTCGACGTCG	Hashtag11
GTGATGTTCGTGCTCT	Hashtag11
GTGCACGAGAGGATCC	Negative
GTGCACGAGCTGGCCT	Negative
GTGCACGAGGATTTAG	Hashtag12
GTGCACGCAAGGAGTC	Hashtag12
GTGCACGGTACAGAAT	Negative
GTGCACGGTAGGGAGG	Negative
GTGCACGGTCCTCATC	Hashtag11
GTGCACGGTCTACTGA	Hashtag11
GTGCAGCAGAGCCGTA	Hashtag11
GTGCAGCCATGGACAG	Hashtag11
GTGCAGCGTTGCTAGT	Negative
GTGCAGCTCTCGAGTA	Negative
GTGCGTGGTGTATTGC	Negative
GTGCGTGTCAGTCCGG	Hashtag11
GTGCTGGAGGGCAAGG	Hashtag11
GTGCTGGTCGTGTTCC	Negative
GTGCTGGTCTGGAGAG	Negative
GTGCTTCAGGCCTTGC	Negative
GTGCTTCCATGCGGTC	Negative
GTGCTTCGTAGTCGGA	Hashtag12
GTGCTTCGTCCGTTTC	Negative
GTGGAAGAGTCGGCCT	Negative
GTGGAAGGTGTATTGC	Hashtag11
GTGGAAGGTGTTGACT	Negative
GTGGAAGGTTCCTAAG	Negative
GTGGAAGTCAGCTAGT	Negative
GTGGAGAAGCAACCAG	Negative
GTGGAGAAGTGAATAC	Hashtag11
GTGGAGACAGAAGCTG	Hashtag11
GTGGAGAGTACAAACA	Negative
GTGGAGAGTTTCGTAG	Hashtag11
GTGGCGTAGAAATTGC	Hashtag11
GTGGCGTAGCTCATAC	Negative
GTGGCGTCAAATGGCG	Hashtag11
GTGGCGTCACGACTAT	Hashtag11
GTGGCGTCACGCCAGT	Negative
GTGGCGTGTCTTAGTG	Negative
GTGGCGTTCTGCATAG	Hashtag11
GTGGGAACAATTGCAC	Negative
GTGGGAAGTCATCGGC	Hashtag12
GTGGGAAGTCATGCAT	Negative
GTGGGAATCTGGCCGA	Hashtag11
GTGGTTACAGAGCCCT	Negative
GTGGTTATCCATCTAT	Negative
GTGTAACCAAACGTGG	Hashtag11
GTGTAACCAATAGTCC	Negative
GTGTAACCACACTTAG	Hashtag11
GTGTAACCACAGTGTT	Negative
GTGTAACCATTCATCT	Negative
GTGTCCTAGATACGAT	Hashtag11
GTGTCCTAGCTACTAC	Negative
GTGTCCTAGGACAAGA	Hashtag11
GTGTCCTAGTTAGTAG	Hashtag11
GTGTCCTCAAGTATCC	Hashtag11
GTGTCCTCACGAGGTA	Hashtag11
GTGTCCTGTGTCTCCT	Negative
GTGTGATCACAACCGC	Hashtag11
GTGTGATGTGCACATT	Hashtag11
GTGTGATGTTTCGTAG	Negative
GTGTGATTCCTTATCA	Negative
GTGTGATTCGTCACCT	Hashtag11_Hashtag12
GTGTGGCAGAAACTCA	Hashtag11
GTGTGGCAGCCTAGGA	Hashtag11
GTGTGGCAGGGACAGG	Hashtag11
GTGTGGCCAACTGCTA	Hashtag11
GTGTGGCCACGGTAGA	Negative
GTGTGGCCATTGGGAG	Negative
GTGTGGCTCGGAGATG	Hashtag11
GTGTTAGCAACTACGT	Hashtag11_Hashtag12
GTGTTAGGTATCGCGC	Negative
GTGTTAGGTGAATGAT	Negative
GTGTTCCAGTGTTGTC	Hashtag11
GTGTTCCCAGACAAGC	Negative
GTGTTCCCATGGAACG	Negative
GTGTTCCGTATCCTTT	Hashtag11
GTTACAGAGTCGGCAA	Hashtag11
GTTACAGAGTCTAACC	Hashtag11
GTTACAGGTGGTCCCA	Negative
GTTACAGGTTAAGGAT	Negative
GTTACAGTCACGATAC	Hashtag11
GTTACAGTCGCGTCGA	Negative
GTTACCCCACCTGATA	Negative
GTTACCCCATCCTCAC	Negative
GTTACCCGTCCGGCAT	Negative
GTTACCCTCGGTCGGT	Negative
GTTACGAAGGCCACCT	Negative
GTTACGAGTAACAGTA	Hashtag12
GTTACGAGTAGAGTTA	Negative
GTTACGAGTCTGCCTT	Hashtag11
GTTACGAGTGCGGCTT	Hashtag11
GTTACGATCGATGGAG	Negative
GTTAGACAGAGCTGCA	Negative
GTTAGACAGTTCCTGA	Hashtag11
GTTAGACCAACAACAA	Hashtag11
GTTAGACCAAGAATAC	Negative
GTTAGACCATTAAGCC	Negative
GTTAGACCATTCTCCG	Negative
GTTAGACGTAGGACCA	Hashtag11
GTTAGACGTGTTGATC	Hashtag11
GTTAGACTCCAAGCTA	Hashtag11
GTTAGTGAGGTAGCAC	Negative
GTTAGTGAGTTTGGCT	Negative
GTTAGTGCATCACAGT	Negative
GTTAGTGGTAGGCTCC	Hashtag11
GTTAGTGGTTGGTGTT	Negative
GTTATGGAGACGCCAA	Negative
GTTATGGCAGTCAACT	Hashtag11
GTTATGGTCAGACTGT	Negative
GTTCATTAGCGTCAAG	Negative
GTTCATTAGTCACAGG	Hashtag11
GTTCATTCACCTGCTT	Negative
GTTCATTCATGACGTT	Hashtag11
GTTCATTGTATAATGG	Negative
GTTCATTGTGGCCCAT	Hashtag11
GTTCATTGTTAAACAG	Negative
GTTCATTTCCCTCGTA	Negative
GTTCCGTCAGCGTTGC	Negative
GTTCCGTTCAACGCTA	Hashtag11
GTTCCGTTCAGTAGGG	Negative
GTTCCGTTCGAGATAA	Negative
GTTCCGTTCTCAACCC	Negative
GTTCGCTAGGGAACAA	Hashtag11
GTTCGCTCATGAGATA	Hashtag11
GTTCGCTGTCGCTTGG	Negative
GTTCGCTGTGCTAGCC	Negative
GTTCTATCAACCGATT	Hashtag11
GTTCTATCACTTGACA	Negative
GTTGAACAGTCATGGG	Hashtag11
GTTGAACTCACGGAGA	Hashtag11
GTTGAACTCGACGCGT	Negative
GTTGCGGAGCCTTCTC	Hashtag11
GTTGCGGAGTGGCGAT	Negative
GTTGCGGGTCCTGTTC	Hashtag11
GTTGCGGTCATACAGC	Hashtag12
GTTGCTCGTCGCATTA	Negative
GTTGCTCTCCGCGATG	Negative
GTTGCTCTCGAGGCAA	Hashtag11
GTTGTAGCAAACCACT	Hashtag11
GTTGTAGCATCACGGC	Hashtag12
GTTGTAGGTGGAGAAA	Negative
GTTGTAGTCGCATGAT	Negative
GTTGTAGTCTCGGCTT	Negative
GTTGTCCCAGGGATAC	Negative
GTTGTCCCATTGCCTC	Negative
GTTGTCCTCGGTATGT	Negative
GTTGTGAAGACTTAAG	Negative
GTTGTGACACATGGTT	Hashtag11
GTTGTGACAGCACACC	Hashtag11
GTTGTGACAGGACAGT	Negative
GTTGTGAGTAAGGCCA	Hashtag11_Hashtag12
GTTGTGATCGCAGATT	Negative
GTTGTGATCTTCTAAC	Negative
GTTTACTAGACAGCTG	Negative
GTTTACTCAGCTGTCG	Negative
GTTTACTTCATCTATC	Hashtag11
GTTTGGAGTCACTGAT	Negative
GTTTGGATCCGATTAG	Hashtag11
GTTTGGATCTCAGGCG	Hashtag11
TAACACGCAGCGGTTC	Negative
TAACACGGTACCCGAC	Hashtag11
TAACACGGTATGATCC	Negative
TAACACGGTCATCGGC	Negative
TAACACGGTCGGAAAC	Hashtag11
TAACACGGTCGTCGGT	Negative
TAACACGTCTGAGGTT	Negative
TAACCAGAGATGCTGG	Negative
TAACCAGCAAGAAACT	Negative
TAACCAGCAAGCGCAA	Negative
TAACCAGGTATGATCC	Hashtag11
TAACCAGGTCCGGACT	Negative
TAACCAGTCAAGCCAT	Negative
TAACGACAGGGCGAGA	Hashtag11
TAACGACAGTTTCAGC	Hashtag11
TAACGACCATAGAAAC	Negative
TAACGACGTGGTAACG	Hashtag11
TAACGACTCAGGAAGC	Negative
TAACGACTCCACTGAA	Negative
TAACTTCGTAGTACGG	Hashtag11
TAACTTCGTCAACACT	Negative
TAACTTCGTCCACTCT	Negative
TAACTTCGTCTCACGG	Hashtag11
TAACTTCGTCTCGGGT	Hashtag11
TAACTTCTCAGACTGT	Hashtag11
TAACTTCTCGACTCCT	Negative
TAACTTCTCGGCTTGG	Negative
TAAGCACAGGGTACGT	Hashtag11
TAAGCACCACATGTTG	Negative
TAAGCACGTCTTGCGG	Hashtag11
TAAGCACGTTCATCGA	Negative
TAAGCACTCCGTGTCT	Hashtag11
TAAGCCAAGGGCCCTT	Hashtag11
TAAGCCATCACCGACG	Negative
TAAGCCATCCGTATGA	Negative
TAAGCCATCGCATTAG	Hashtag11
TAAGCGTAGAGTATAC	Hashtag11
TAAGCGTAGGTTCAGG	Negative
TAAGCGTCACAGAAGC	Hashtag11
TAAGCGTTCGAACACT	Negative
TAAGTCGCAGCGTATT	Hashtag11
TAAGTCGGTATGAAGT	Negative
TAAGTCGGTTTCACAG	Hashtag11
TAAGTCGTCGACGAGA	Negative
TAAGTCGTCGGATACT	Negative
TAAGTCGTCTAGGCCG	Hashtag11
TAATCTCCAAGAATAC	Negative
TAATCTCGTCTCGGGT	Negative
TAATCTCTCAGCTTCC	Hashtag11
TAATTCCAGTCGAGGT	Hashtag11
TAATTCCCATTACTCT	Negative
TAATTCCTCGTAGCTA	Hashtag11
TACAACGAGCTGGAGT	Negative
TACAACGCAGATTAAG	Hashtag11
TACAACGGTGACCTGC	Hashtag11
TACAACGGTGGGAGAG	Hashtag11
TACAACGTCTTCTGGC	Negative
TACACCCAGAAACTAC	Negative
TACACCCAGTCTTGGT	Negative
TACACCCCAGTGTGGA	Hashtag11_Hashtag12
TACACCCGTAGGATAT	Hashtag11
TACACCCTCGTTAGAC	Negative
TACAGGTAGAAGTATC	Negative
TACAGGTAGCGATGCA	Negative
TACAGGTAGTTGGCGA	Negative
TACAGGTCATCTGGGC	Hashtag11
TACAGGTGTCAGGTGA	Negative
TACAGGTTCTGAACGT	Negative
TACATTCCAGCGGTCT	Negative
TACATTCTCTTAATCC	Hashtag11_Hashtag12
TACCCACCATATCTGG	Hashtag11
TACCCACGTTGCATTG	Negative
TACCCACTCTCCTGAC	Negative
TACCCGTCACCTCAGG	Hashtag11
TACCCGTGTCCTTAAG	Negative
TACCCGTTCGAAGAAT	Negative
TACCCGTTCTGGACCG	Hashtag12
TACCGAAAGATTTGCC	Hashtag11
TACCGAACAAAGTGTA	Negative
TACCGAATCGCTGTTC	Hashtag11
TACCGGGCACTACACA	Negative
TACCTCGAGTTTGTCG	Negative
TACCTCGCAGAGTGAC	Negative
TACCTCGTCACATTGG	Hashtag11
TACCTCGTCCCTCTTT	Hashtag11
TACCTGCAGCAGTAAT	Negative
TACCTGCAGGTCCAGA	Negative
TACCTGCCAGGTACGA	Hashtag12
TACCTGCCATACCACA	Hashtag11
TACGCTCAGGATACGC	Negative
TACGCTCCAAGCAGGT	Hashtag11
TACGCTCGTAGCTCGC	Hashtag11_Hashtag12
TACGCTCGTCTCAAGT	Negative
TACGCTCGTCTCTCCA	Hashtag11
TACGCTCGTTGTGTTG	Negative
TACGCTCTCCGTAGTA	Negative
TACGCTCTCGTGGCGT	Hashtag11
TACGGGCGTGATGGCA	Hashtag11
TACGGGCTCACCTACC	Negative
TACGGTAAGGGACTGT	Hashtag11
TACGGTACAGGTCAAG	Negative
TACGGTAGTACGTACT	Hashtag11
TACGGTAGTCTACATG	Negative
TACGGTAGTGCGGCTT	Hashtag11
TACGTCCCAGTTGTCA	Negative
TACGTCCCAGTTTCAG	Negative
TACGTCCCATAACTCG	Negative
TACGTCCGTGACCGAA	Negative
TACTGCCAGAATTGTG	Hashtag12
TACTGCCAGGACAAGA	Negative
TACTGCCAGGTTGAGC	Hashtag11
TACTGCCCACAAGGTG	Negative
TACTGCCCACATACGT	Hashtag11
TACTGCCCATGCAGCC	Hashtag11
TACTGCCGTCGTATGT	Negative
TACTTACAGTCGGCCT	Hashtag12
TACTTACCAAGCGAGT	Negative
TACTTACCATGGAATA	Hashtag11
TACTTACGTCGTTGCG	Hashtag11_Hashtag12
TACTTACTCAGTGTTG	Negative
TACTTACTCGTGCAGC	Negative
TACTTCAAGGCCTGCT	Hashtag12
TACTTCAAGTCCTGCG	Hashtag11
TACTTCAGTGGAAGTC	Negative
TACTTCATCACATCAG	Hashtag11
TACTTCATCGACGCTG	Negative
TACTTGTAGGTAAGGA	Hashtag11
TACTTGTGTTCATCGA	Negative
TACTTGTTCTTCTGTA	Negative
TAGACCACAAGATGTA	Negative
TAGACCACACATACTG	Negative
TAGACCACACCCTATC	Negative
TAGACCATCAAGTCGT	Hashtag11
TAGACCATCAAGTCTG	Negative
TAGACTGAGAATTCAG	Hashtag11
TAGACTGAGACATCAA	Negative
TAGACTGAGCGACCCT	Hashtag11
TAGACTGCACTTACAG	Hashtag11
TAGACTGCACTTGAAC	Negative
TAGACTGTCATGAGGG	Hashtag11
TAGACTGTCCCTGGTT	Negative
TAGAGTCAGGAGACCT	Negative
TAGAGTCCAACCTAAC	Negative
TAGAGTCGTTAACCTG	Hashtag11
TAGATCGAGCTCCCTT	Negative
TAGATCGCAAACTCGT	Hashtag11
TAGATCGGTACTGACT	Negative
TAGATCGGTGCAACAG	Hashtag11
TAGCACAAGTCTAGAA	Hashtag12
TAGCACACATAGCACT	Negative
TAGGAGGCACGTCGGT	Negative
TAGGAGGCATCACAGT	Negative
TAGGAGGGTCTCAAGT	Hashtag11
TAGGAGGTCTCGTCAC	Negative
TAGGGTTAGGTCGTAG	Negative
TAGGGTTCAGGCTTGC	Hashtag11
TAGGTACAGCGCTTCG	Hashtag11
TAGGTACAGGCGTCCT	Hashtag11
TAGGTACTCAAATAGG	Negative
TAGGTTGAGGAAAGAC	Hashtag12
TAGGTTGAGTAGTCCT	Hashtag11
TAGGTTGAGTCTTGGT	Hashtag11
TAGGTTGCAGCCATTA	Negative
TAGGTTGTCGCGCCAA	Hashtag11
TAGTGCAGTCTCGGGT	Hashtag11
TAGTGCATCAAGCCAT	Negative
TAGTGCATCCATTTCA	Hashtag11
TAGTGCATCCGTCACT	Negative
TATACCTAGTTGTAAG	Hashtag11
TATACCTAGTTGTACC	Negative
TATATCCAGAAGCGGG	Hashtag11
TATATCCAGCAGCAGT	Negative
TATATCCAGGGAACAA	Hashtag11
TATATCCAGTGCACTT	Negative
TATATCCAGTTGTAAG	Negative
TATATCCCACGTACAT	Hashtag11
TATATCCGTCGCTTAA	Hashtag11
TATATCCGTTGTTGTG	Hashtag11
TATCAGGAGACATAAC	Negative
TATCAGGCAGGTCAGA	Negative
TATCAGGGTGACTCGC	Hashtag11
TATCAGGTCAAGAATG	Negative
TATCAGGTCATTATCC	Hashtag11
TATCAGGTCCCATACC	Negative
TATCCTACATCGGTTA	Hashtag12
TATCCTAGTAAGGAGA	Negative
TATCCTAGTACGCGTC	Negative
TATCCTATCAGACCGC	Negative
TATCGCCAGAGGATCC	Hashtag12
TATCGCCCAGTCGCAC	Hashtag11
TATCGCCGTTTGGAGG	Negative
TATCGCCTCCGATAGT	Hashtag11
TATCTGTCATAGGCGA	Hashtag11
TATCTGTCATCGAGCC	Negative
TATCTTGCAATATCCG	Hashtag11
TATCTTGCAGGTTCAT	Hashtag11
TATCTTGCATGACGGA	Hashtag11
TATCTTGGTAATGATG	Hashtag11
TATCTTGGTTGTTGCA	Hashtag12
TATGTTCCACTTTATC	Hashtag11
TATGTTCCATCTCAAG	Negative
TATGTTCTCGGTGCAC	Hashtag11
TATTCCAAGACTCCGC	Negative
TATTCCACAACGGGTA	Hashtag11
TATTCCACAATGACCT	Negative
TATTCCAGTTCTTGTT	Negative
TATTCCAGTTGTGGAG	Hashtag12
TATTCCATCTGAGAGG	Hashtag11
TATTGCTCACATACGT	Negative
TATTGCTCAGTGCGCT	Negative
TATTGCTGTATCAGGG	Negative
TATTGCTGTGCCTTCT	Negative
TATTGCTTCAGACAAA	Hashtag11
TATTGGGAGCGATTCT	Negative
TATTGGGCAACCTAAC	Hashtag11
TATTGGGGTTCATCTT	Hashtag11
TATTTCGAGGGTCTTT	Negative
TATTTCGCACCTTCGT	Hashtag11
TATTTCGCAGGGTCTC	Negative
TATTTCGCATCCCACT	Negative
TATTTCGGTTTGACAC	Hashtag11
TCAAGACTCCGGCAAC	Negative
TCAAGACTCCGTAGTA	Hashtag11
TCAAGCAAGTGTACAA	Negative
TCAAGCACAAGAGAGA	Hashtag11
TCAAGCAGTACTCCCT	Hashtag11
TCAAGCATCGCGTGAC	Hashtag11
TCAAGTGAGGGCAATC	Negative
TCAAGTGCAGCTATAC	Hashtag11
TCAAGTGCAGTCAGCC	Negative
TCAAGTGGTGAGCAGT	Hashtag11
TCAAGTGGTTGTTGAC	Hashtag11
TCAATCTAGCCGATAG	Hashtag11
TCAATCTAGCTCCACG	Hashtag11
TCAATCTCAAATGCGG	Hashtag11
TCAATCTTCTTGTGCC	Hashtag12
TCAATTCAGGATACAT	Hashtag11
TCAATTCGTGTCCCTT	Negative
TCACAAGAGCGCCCAT	Negative
TCACAAGAGCTACAAA	Negative
TCACAAGCACAGCCAC	Hashtag11
TCACAAGCACTCCTGT	Negative
TCACAAGCATTGACAC	Hashtag12
TCACAAGGTCATAAAG	Negative
TCACAAGGTGCGTGCT	Negative
TCACAAGTCAGCAATC	Hashtag11
TCACAAGTCCACACCT	Negative
TCACAAGTCCAGTACA	Negative
TCACAAGTCTAGTGAC	Negative
TCACACCGTATGCTAC	Hashtag11
TCACACCGTTGAGGAC	Hashtag11
TCACACCTCCCATTTA	Hashtag11
TCACATTAGGAACGCT	Negative
TCACATTTCATTGCTT	Negative
TCACATTTCCGAGATT	Negative
TCACGCTAGGGAGTGG	Negative
TCACGCTAGTTGCGCC	Negative
TCACGCTCAGGCTTGC	Negative
TCACGCTCATTAAGCC	Negative
TCACGGGAGATCCTAC	Hashtag11
TCACGGGCAGACTCTA	Hashtag12
TCACGGGGTAATTAGG	Negative
TCACGGGGTCACCGCA	Hashtag11
TCACGGGGTTCCATTT	Hashtag11
TCACTATAGACATAAC	Hashtag11
TCACTATAGCACAAAT	Negative
TCACTATAGTCACAGG	Negative
TCACTATGTCGCACAC	Negative
TCACTATGTGCACAAG	Negative
TCACTATGTGGTCTAT	Negative
TCACTATTCTCATGCC	Hashtag11
TCACTCGGTGTCGCTG	Negative
TCAGCAACAAATAGCA	Negative
TCAGCAACAAGTGTCT	Negative
TCAGCAAGTAGATCGG	Hashtag11
TCAGCAAGTTGTGCCG	Negative
TCAGCAATCACCTCTG	Hashtag11
TCAGCAATCGGCACTG	Hashtag11
TCAGCCTAGTCATCCA	Hashtag11
TCAGCCTCAGAAACCG	Negative
TCAGCCTCAGCCCAGT	Hashtag11
TCAGCCTGTAGCGTAG	Negative
TCAGCCTGTGCGAACA	Negative
TCAGCCTTCGTAGGAG	Negative
TCAGGGCAGCCTCACG	Negative
TCAGGGCGTAATGCTC	Hashtag11
TCAGGGCGTTCCGTTC	Hashtag11
TCAGGGCTCCGTGTAA	Hashtag11
TCAGGGCTCCTAAGTG	Negative
TCAGGGCTCGACACTA	Negative
TCAGGTAAGGCAGCTA	Hashtag11
TCAGGTACAAAGACTA	Hashtag12
TCAGGTAGTAGAGATT	Hashtag11
TCAGGTAGTAGTTCCA	Negative
TCAGGTAGTCATTCCC	Negative
TCAGGTAGTTTCACTT	Negative
TCAGGTATCAAGTGGG	Negative
TCAGGTATCAATCTCT	Hashtag11
TCAGGTATCGAGCACC	Negative
TCAGTCCAGAGCATCG	Hashtag11
TCAGTCCAGTCCGCGT	Hashtag12
TCAGTCCCATTCAGGT	Negative
TCAGTCCGTTGAGGAC	Hashtag11
TCAGTCCGTTGGCTAT	Negative
TCAGTGAAGGACTGGT	Hashtag11
TCAGTGACACCGGTCA	Negative
TCAGTGAGTCCTGAAT	Negative
TCAGTGATCATTTCGT	Hashtag11
TCAGTTTGTAGCTGCC	Hashtag11
TCATACTCAAATCGTC	Negative
TCATACTCAGTAGGAC	Hashtag11
TCATACTTCAAGAATG	Hashtag11
TCATATCGTGAAGCTG	Hashtag11
TCATATCTCTTTGCAT	Negative
TCATCATGTCCAGGTC	Negative
TCATCATGTCTTAGTG	Hashtag11
TCATCATGTGGCTACC	Negative
TCATCATTCACAACCA	Hashtag12
TCATCATTCATACAGC	Negative
TCATCATTCCTACCAC	Negative
TCATCCGCATAAGATG	Hashtag11
TCATCCGTCAAGCCAT	Negative
TCATCCGTCCTCAGAA	Hashtag11
TCATCCGTCTAGAGCT	Negative
TCATGAGGTACGCTTA	Hashtag11_Hashtag12
TCATGAGGTGTCATTG	Negative
TCATGAGTCCGCCTAT	Hashtag11
TCATGCCAGACATAGT	Hashtag11
TCATGCCGTTGGACCC	Hashtag12
TCATGCCTCATTTGCT	Hashtag11
TCATGCCTCGCGTGAC	Hashtag11
TCATGCCTCTCTAGGA	Negative
TCATGCCTCTGGTCAA	Negative
TCATGGAAGGACAAGA	Hashtag11
TCATGTTAGAGTTGAT	Negative
TCATGTTAGCGCACAA	Negative
TCATGTTCAAGCGATG	Negative
TCATGTTCATACAGGG	Hashtag11
TCATGTTCATCTGGGC	Negative
TCATGTTGTTCTCACC	Negative
TCATTACAGGAATTAC	Negative
TCATTACAGGATTTGA	Hashtag11
TCATTACGTACTCCCT	Hashtag12
TCATTACGTGTTGAGG	Hashtag12
TCATTCACACGGAAGT	Hashtag11
TCATTGTCACCGAATT	Hashtag11
TCATTGTGTACCTATG	Hashtag11
TCATTGTGTGTACGCC	Negative
TCATTGTTCATAAGGA	Hashtag11
TCATTTGAGACGGTTG	Negative
TCATTTGAGCGATGAC	Negative
TCATTTGCAACAACAA	Hashtag11
TCCACCAGTCTGCGCA	Negative
TCCACCAGTTTAGTCG	Hashtag11
TCCACGTAGTTATGGA	Negative
TCCACGTGTACCGTCG	Hashtag11
TCCACGTTCAGCACCG	Hashtag11
TCCACGTTCGTTGTAG	Negative
TCCAGAAGTCATCAGT	Negative
TCCAGAAGTTCCGTTC	Hashtag11
TCCATCGCAGTGTACT	Negative
TCCATCGTCTCAAAGC	Hashtag11
TCCATGCAGGCGAAGG	Negative
TCCATGCAGTCCCGAC	Negative
TCCATGCCAAAGGATT	Hashtag11
TCCATGCGTCCGTTTC	Hashtag11
TCCATGCGTGATACAA	Negative
TCCCACAAGACCATGG	Hashtag11
TCCCACAAGTAGCCAG	Negative
TCCCACACACATGTTG	Hashtag11
TCCCACACACGACCTG	Hashtag11
TCCCACACATTGGATC	Hashtag11
TCCCACAGTTAGGACG	Negative
TCCCACATCGATTTCT	Hashtag11
TCCCAGTAGCGATTCT	Negative
TCCCAGTGTTACCTTT	Negative
TCCCATGGTTTGGAAA	Negative
TCCCATGTCGTTCAGA	Negative
TCCGAAAAGAGACAAG	Negative
TCCGAAAAGGGCGAGA	Negative
TCCGAAACAATACGCT	Hashtag11
TCCGAAAGTTTCTATC	Hashtag11
TCCGAAATCCAAGCCG	Hashtag11
TCCGATCTCACACCCT	Negative
TCCGGGACAAGTTCGT	Negative
TCCGGGACAGCTCGGT	Negative
TCCGTGTCAACCACAT	Hashtag11
TCCTAATAGATAGTGT	Hashtag11
TCCTAATCATTCTCCG	Negative
TCCTAATGTCTGATCA	Hashtag11
TCCTAATTCTCCCTAG	Negative
TCCTCCCGTAGTACGG	Hashtag11
TCCTCCCGTATTGGCT	Negative
TCCTCCCGTGATGTAA	Negative
TCCTCCCGTTGCCGCA	Negative
TCCTCCCTCAGTGCGC	Hashtag11
TCCTCCCTCGTGCATA	Negative
TCCTCCCTCTCGGCTT	Hashtag11
TCCTCGACATTGCCTC	Negative
TCCTCGAGTCGATTCA	Negative
TCCTCGAGTGCCTGCA	Hashtag11
TCCTCGATCGGAATTC	Negative
TCCTCTTCAACTGCTA	Negative
TCCTCTTCATTCTGTT	Negative
TCCTCTTGTGGATTTC	Hashtag11
TCCTCTTGTTACACAC	Negative
TCCTCTTTCATACAGC	Negative
TCCTGCAGTCATGACT	Negative
TCCTGCATCATGAGTC	Hashtag11
TCCTTCTAGGTACAAT	Hashtag11
TCCTTCTAGTCTGGTT	Hashtag11
TCCTTCTAGTGTAGTA	Hashtag11
TCCTTCTCAGCACCCA	Hashtag11
TCCTTCTGTAAGATCA	Hashtag11
TCCTTCTGTCTCTCTG	Negative
TCCTTTCCACATGTTG	Negative
TCCTTTCCAGTCCCGA	Negative
TCCTTTCGTCGCACAC	Hashtag12
TCCTTTCGTTATTCCT	Hashtag11
TCGAACACATGACACT	Hashtag11
TCGAACAGTAACGCGA	Hashtag11
TCGAACAGTCGCAACC	Negative
TCGAACATCTTCACAT	Negative
TCGAACATCTTTCAGT	Negative
TCGAAGTGTGCATCTA	Hashtag11
TCGAAGTTCCAGGACC	Hashtag11
TCGACCTAGCCTGAGA	Hashtag11
TCGACCTGTGTGTCGC	Negative
TCGACGGAGACCAAGC	Hashtag12
TCGACGGGTCCACATA	Hashtag12
TCGATTTCAGGATGAC	Hashtag11
TCGATTTCAGTCAGCC	Negative
TCGATTTGTCAGCGTC	Hashtag11
TCGATTTGTTATCTGG	Negative
TCGCACTCACGGCTAC	Negative
TCGCACTGTATGAGGC	Hashtag11
TCGCACTGTCCGGTGT	Negative
TCGCACTTCCACCCTA	Negative
TCGCAGGAGGCGAAGG	Negative
TCGCAGGAGGTCCTGC	Negative
TCGCAGGCAGCCTTCT	Negative
TCGCAGGGTAGTCTGT	Hashtag11
TCGCAGGTCATGCTAG	Hashtag11
TCGCTCAAGCAGCCTC	Hashtag11
TCGCTCACATGTAACC	Hashtag11
TCGCTCAGTAACGTTC	Negative
TCGCTCATCAACACCA	Hashtag11
TCGCTCATCTATTTCG	Negative
TCGCTTGAGAGTTGTA	Hashtag11_Hashtag12
TCGCTTGAGTAGTCAA	Hashtag12
TCGCTTGCAAACTAGA	Hashtag11
TCGCTTGCACACTTAG	Hashtag11
TCGCTTGCATACAGAA	Hashtag11
TCGCTTGTCTGGCCGA	Hashtag11
TCGCTTGTCTGGGCAC	Hashtag11
TCGGATAAGGATACCG	Hashtag11
TCGGATACAATAGGGC	Hashtag11
TCGGATACACAAGTTC	Negative
TCGGATACAGCAGTCC	Negative
TCGGATAGTCTCCCTA	Negative
TCGGATAGTGGACTAG	Negative
TCGGATAGTTAGTTCG	Negative
TCGGATATCTCACGAA	Hashtag12
TCGGGACAGCCGAACA	Hashtag11
TCGGGCACACAGCCAC	Negative
TCGGGCAGTAGGACTG	Hashtag11
TCGGGCAGTTTGGGTT	Hashtag11
TCGGGCATCCCAGTGG	Hashtag11
TCGGGCATCCCGTGTT	Hashtag11
TCGGGTGTCTCCAATT	Hashtag11
TCGGTCTGTTACGGAG	Negative
TCGTAGACATTGACAC	Hashtag12
TCGTAGAGTCAGGAGT	Hashtag11
TCGTAGATCTTGGAAC	Negative
TCGTAGATCTTTACAC	Hashtag11_Hashtag12
TCGTCCAAGACTCAAA	Hashtag11
TCGTCCACAAAGGTTA	Hashtag11
TCGTCCACAATCGCAT	Negative
TCGTCCAGTACTCGAT	Negative
TCGTCCAGTCTCTCAC	Hashtag11
TCGTCCATCACGTCCT	Negative
TCGTCCATCCACAGCG	Hashtag11
TCGTCCATCGGAGATG	Hashtag11
TCGTCCATCTAAGGAA	Hashtag11
TCGTGCTAGTCAACAA	Hashtag12
TCGTGCTCACTATCCC	Hashtag12
TCGTGCTCAGTTGCGC	Negative
TCGTGCTCATCACGGC	Hashtag11
TCGTGCTGTTCAAACC	Hashtag12
TCGTGCTTCCGAGGCT	Hashtag11
TCGTGCTTCCTCAGAA	Negative
TCGTGGGAGAGGACTC	Negative
TCGTGGGGTCTTAGTG	Hashtag12
TCTAACTAGCGTGTCC	Hashtag12
TCTAACTAGGTACATA	Negative
TCTAACTCAAATCGGG	Hashtag12
TCTAACTCATCAGCAT	Hashtag12
TCTAACTGTATTGACC	Hashtag12
TCTAACTTCGTGGACC	Hashtag11
TCTACATAGAACTCCT	Negative
TCTACATCAATAACGA	Negative
TCTACATGTCGCACGT	Negative
TCTACATTCAAGATAG	Hashtag11
TCTACCGAGAGAGTTT	Hashtag11
TCTACCGAGTTGCGCC	Negative
TCTACCGCAACGCATT	Hashtag11
TCTACCGCATCTCGTC	Negative
TCTACCGTCATGCGGC	Negative
TCTACCGTCTCGTGGG	Hashtag11
TCTATACCAAAGCGTG	Negative
TCTATACCATACCGTA	Hashtag12
TCTATACCATTGAAAG	Hashtag12
TCTATACGTCCGGATC	Hashtag11
TCTATACTCAATCTTC	Negative
TCTATCAAGTCCCAGC	Negative
TCTATCAGTTAGAGTA	Negative
TCTCACGAGGAGCAAA	Negative
TCTCACGCATATGAAG	Negative
TCTCACGGTTAGTCGT	Hashtag11
TCTCAGCAGACCGCCT	Negative
TCTCAGCGTGAGATTA	Negative
TCTCAGCTCAGCGGAA	Negative
TCTCAGCTCGTGCTCT	Negative
TCTCCGAAGCGATCGA	Hashtag12
TCTCCGAAGTTGGAGC	Negative
TCTCCGACAGGAAGTC	Hashtag11
TCTCCGAGTTATGACC	Negative
TCTCCGATCCATGATG	Negative
TCTCCGATCCTCTCTT	Negative
TCTCTGGAGTGATCGG	Hashtag11
TCTCTGGCAGGCACAA	Hashtag11
TCTGCCACAAATACGA	Negative
TCTGCCACATTCGATG	Hashtag11
TCTGCCAGTAATTGGA	Hashtag11
TCTGCCAGTCTGTGTA	Negative
TCTGCCAGTGTCCTAA	Hashtag11
TCTGGCTCACCAACAT	Hashtag11
TCTGGCTCATCGTGCG	Hashtag11
TCTGGCTCATGTCGTA	Negative
TCTGGCTGTGCCGTAC	Hashtag11
TCTGTCGCACTGAATC	Negative
TCTGTCGTCCTAGCGG	Negative
TCTTAGTAGCAGGTCA	Negative
TCTTAGTAGCTAAATG	Hashtag11
TCTTAGTCACATATGC	Hashtag11
TCTTAGTCAGGGTCTC	Hashtag12
TCTTAGTGTCATCCCT	Negative
TCTTAGTTCTCTCTTC	Hashtag11
TCTTCCTGTAGCGCTC	Hashtag11
TCTTGCGAGCTAAATG	Negative
TCTTGCGCAGAAATCA	Hashtag11
TCTTGCGTCTGTCAGA	Negative
TCTTTGAAGCCTGAAG	Negative
TCTTTGAAGGGCAGAG	Negative
TCTTTGAAGTAAACGT	Hashtag11
TGAACGTAGCGCTGAA	Negative
TGAACGTAGTGTTGTC	Negative
TGAACGTCATGGCGCT	Negative
TGAACGTGTACCACGC	Negative
TGAACGTGTGCCGTTG	Hashtag11
TGAACGTGTGCGTTTA	Negative
TGAACGTGTTGCCGAC	Hashtag11
TGAACGTTCTTTGGAG	Negative
TGAATCGAGGAGTATT	Negative
TGAATCGCACACCGCA	Negative
TGAATCGCATAGCACT	Negative
TGAATCGCATTGCCTC	Negative
TGAATGCAGGCGATAC	Hashtag11
TGAATGCCACGACGCT	Negative
TGAATGCGTTGAGTCT	Hashtag11
TGACAGTCAAGGAGTC	Hashtag11
TGACAGTTCGCATGAT	Negative
TGACAGTTCTTTGGAG	Hashtag11
TGACCCTAGCACCGTC	Hashtag12
TGACCCTAGTTTGGCT	Negative
TGACCCTCATAACAGA	Hashtag11
TGACCCTGTAACCAGG	Hashtag11
TGACCCTGTAGCGTAG	Hashtag12
TGACCCTTCGATCCAA	Negative
TGACCCTTCTCGTTTA	Hashtag12
TGACGCGAGGTAGGCT	Negative
TGACGCGGTCTTTCTA	Negative
TGACTCCAGTTGAATG	Hashtag12
TGACTCCCAGTATGAA	Hashtag12
TGACTCCCAGTTAGGG	Hashtag11
TGACTCCGTTGCATGT	Hashtag11
TGACTCCTCCGTGACG	Negative
TGAGACTAGACCATAA	Hashtag12
TGAGACTCAATACCTG	Negative
TGAGACTGTGAGCGAT	Hashtag12
TGAGCATCAGCCTATA	Hashtag11
TGAGCATGTACCACGC	Hashtag11
TGAGCATGTACCGGCT	Hashtag11
TGAGCATGTGCAACGA	Hashtag11
TGAGCATGTTCGTGCG	Hashtag11
TGAGCATTCTTGGTCC	Negative
TGAGCGCTCTACTCAT	Negative
TGAGGAGAGCCGAACA	Negative
TGAGGAGGTTAAGAAC	Hashtag11
TGAGGAGTCGTCAGAT	Hashtag11
TGAGGGAAGTTACTCG	Negative
TGAGGGACACCGGTCA	Hashtag12
TGAGGGAGTATATGGA	Negative
TGAGGGAGTTGTTGTG	Hashtag11
TGAGGGATCGAAACAA	Hashtag11
TGAGGGATCGAGAAGC	Hashtag11
TGAGGGATCTTTACAC	Hashtag12
TGAGGTTAGAGTCAAT	Negative
TGAGGTTCATTCGATG	Hashtag11
TGAGTCAGTCGTGGTC	Negative
TGAGTCATCGGCTCTT	Negative
TGATCAGAGTCGTTAC	Negative
TGATCAGCAACCGATT	Negative
TGATCAGCAGAGAAAG	Negative
TGATCAGCATAGAATG	Hashtag11
TGATCAGTCCGCAGTG	Negative
TGATCAGTCGCCTAGG	Negative
TGATCTTAGAGCATCG	Negative
TGATCTTGTATCGGTT	Hashtag11
TGATGCAAGCAACTCT	Negative
TGATGCACAGACAAGC	Hashtag11
TGATGCACAGAGGCTA	Negative
TGATGCACAGCAGATG	Negative
TGATGCAGTATCGAGG	Hashtag11
TGATGCAGTTCGTGCG	Hashtag11
TGATGGTCAGCTGCCA	Negative
TGATGGTGTAACTGCT	Negative
TGATGGTGTTGCTGAT	Hashtag11
TGATGGTTCCGTACGG	Negative
TGATTCTAGAGCCTGA	Hashtag11
TGATTCTCACAAGTGG	Negative
TGATTCTCACCTCTAC	Hashtag11
TGATTCTCATGACGGA	Hashtag11
TGATTCTGTGGTCTGC	Negative
TGATTCTGTTTATGCG	Hashtag11
TGATTCTTCACGGGAA	Hashtag11
TGATTCTTCGATCCCT	Hashtag11
TGATTTCAGAGTGAAG	Negative
TGATTTCCAATACCTG	Negative
TGATTTCCAGAGGCTA	Negative
TGATTTCGTGATCGTT	Hashtag11
TGATTTCTCAACCTCC	Negative
TGATTTCTCAACTGGT	Hashtag11
TGATTTCTCATGCGGC	Hashtag11
TGATTTCTCGCGGACT	Hashtag11
TGCACGGAGCGTGAAC	Negative
TGCACGGAGCTCTTCC	Negative
TGCACGGAGTGAGTTA	Hashtag11
TGCACGGCACCATATG	Hashtag11
TGCACGGCAGCTGTAT	Negative
TGCACGGGTATCGTAC	Hashtag11
TGCACGGGTCATACCA	Hashtag11
TGCACGGTCACCACAA	Hashtag11
TGCACGGTCATACCAA	Negative
TGCAGATAGCCATGCC	Hashtag12
TGCAGATCATGTTACG	Negative
TGCAGATGTAGGAGGG	Negative
TGCAGATGTTCGATTG	Negative
TGCAGATTCGGACAAG	Hashtag12
TGCAGGCAGGCGTCCT	Hashtag11
TGCAGGCAGGTCGACA	Hashtag11
TGCAGGCGTCGCTTAA	Hashtag11
TGCAGGCGTGACTAAA	Negative
TGCAGGCTCCGTGGTG	Hashtag11
TGCAGGCTCGACGTCG	Hashtag11
TGCAGGCTCGGCATAT	Hashtag11
TGCAGTAAGCTGACTT	Hashtag11
TGCAGTAAGGTCATAA	Hashtag12
TGCAGTACACAGTGAG	Hashtag12
TGCAGTACAGTAGGAC	Negative
TGCAGTAGTCGATTTG	Negative
TGCAGTAGTTCTAAGC	Negative
TGCAGTATCCGCTAGG	Negative
TGCAGTATCGACCATA	Hashtag11
TGCATCCAGCTGACAG	Hashtag11
TGCATCCCACGGATCC	Negative
TGCATCCGTCCGTACG	Negative
TGCATCCGTTTCACTT	Negative
TGCATCCTCTTCTGTA	Negative
TGCATGAAGCTATCCA	Negative
TGCATGAAGTATAACG	Negative
TGCATGACAACCGCTG	Hashtag11
TGCATGACAGTCTTCC	Hashtag11
TGCATGAGTTTCGGCG	Negative
TGCATGATCGTGAGAG	Hashtag12
TGCCGAGAGACCTTTG	Hashtag12
TGCCGAGAGCCGATTT	Hashtag11
TGCCGAGCACCGCTGA	Hashtag11
TGCCGAGCAGCACAGA	Hashtag11
TGCGACGAGCAAGTCG	Hashtag12
TGCGACGTCCGCATAA	Negative
TGCGATAAGAGCCCAA	Negative
TGCGATAAGCTACGTT	Negative
TGCGATAAGGTGCGAT	Negative
TGCGGCAAGAGGCCAT	Negative
TGCGGCAAGTTAGAAC	Hashtag11
TGCGGCACAGAGTCAG	Negative
TGCGGCATCATTCACT	Negative
TGCGGCATCTGAGCAT	Hashtag11
TGCGGGTAGTGATGGC	Negative
TGCGGGTCAATATCCG	Hashtag11
TGCGGGTGTCAACCAT	Hashtag11
TGCTCCACAAGACAAT	Hashtag11
TGCTCCACACCAGGTC	Hashtag11
TGCTCCAGTATCCCTC	Hashtag12
TGCTCCAGTCGGAAAC	Hashtag12
TGCTCGTAGAGCTGAC	Hashtag11
TGCTCGTTCACTGCTC	Hashtag11
TGCTCGTTCCCGAGAC	Negative
TGCTGAAAGGAGAATG	Negative
TGCTGAAAGGTAGTCG	Hashtag11
TGCTGAACAGACCATT	Hashtag11
TGCTGAAGTCAAGCGA	Negative
TGCTGAAGTCGCATTA	Negative
TGCTGAAGTGAACGGT	Hashtag11
TGCTTCGAGACGCCAA	Negative
TGCTTGCGTAACTTCG	Negative
TGCTTGCTCTAGGAAA	Hashtag11
TGGAACTAGAGAGCAA	Hashtag11
TGGAACTAGGATACGC	Hashtag11
TGGAACTCATCCTAAG	Hashtag11
TGGAACTCATTAGGCT	Hashtag11
TGGAGAGAGAAGTGTT	Hashtag11
TGGAGAGAGTAAATGC	Hashtag11
TGGAGAGAGTAGTCTC	Negative
TGGAGAGAGTCACTCA	Hashtag12
TGGAGAGCAAAGGCGT	Negative
TGGAGAGGTCTAATCG	Negative
TGGAGAGTCCCGAATA	Hashtag12
TGGAGGAAGGTGCGAT	Negative
TGGAGGAAGTTGCGAG	Hashtag11
TGGAGGACAGTCGCAC	Hashtag11
TGGAGGACAGTTGCGC	Hashtag11
TGGAGGAGTGCTGATT	Hashtag12
TGGATCATCCAAGCTA	Hashtag11
TGGATCATCCAGCTCT	Hashtag11
TGGATCATCTCATTTG	Negative
TGGATGTAGTCACTAC	Negative
TGGATGTAGTCCGTCG	Negative
TGGATGTCACCGAATT	Hashtag11
TGGATGTCATGACACT	Hashtag11
TGGATGTGTCGTCTCT	Hashtag11
TGGATGTTCTGGTCAA	Hashtag11
TGGCGTGAGTAGTGCG	Hashtag11
TGGCGTGCACACCGAC	Negative
TGGCGTGGTAAGTAGT	Hashtag11
TGGCGTGGTTAAGAAC	Negative
TGGCGTGTCTGCTGAA	Negative
TGGGAAGAGACAGCTG	Hashtag11_Hashtag12
TGGGAAGAGCAAGCCA	Negative
TGGGAAGTCCAATGCA	Hashtag11
TGGGAAGTCGTCGATA	Negative
TGGGAAGTCGTGGGTC	Negative
TGGGAAGTCTCTCCGA	Hashtag12
TGGGAGAAGGAGTATT	Hashtag12
TGGGAGAAGTCCCAGC	Negative
TGGGAGACAATTTCCT	Negative
TGGGAGAGTTCCTTGC	Hashtag11
TGGGAGATCGTGACTA	Hashtag11
TGGGAGATCTCCCAAC	Hashtag11
TGGGATTAGGGCAACT	Negative
TGGGATTAGGGCAGTT	Negative
TGGGATTAGGTAACTA	Hashtag12
TGGGATTAGTGGAATT	Hashtag11
TGGGATTCATAACAGA	Hashtag11
TGGGATTCATCAGTCA	Negative
TGGGATTGTCGCGTTG	Hashtag11
TGGGATTTCGCACGGT	Hashtag11
TGGGCGTAGAACTGAT	Negative
TGGGCGTAGGCATCGA	Hashtag11
TGGGCGTCATGATAGA	Negative
TGGGCGTGTGGTATGG	Negative
TGGGCGTTCCGGGACT	Negative
TGGGCTGAGAAACTGT	Hashtag11
TGGGCTGAGCCGATCC	Negative
TGGGCTGCACGCCACA	Hashtag11
TGGGCTGGTCGCTTAA	Negative
TGGGCTGGTGGAGAAA	Negative
TGGGCTGGTTTGACAC	Hashtag11
TGGGCTGTCCATTGGA	Negative
TGGGTTAAGTGTAGAT	Hashtag11
TGGGTTAGTAGGATAT	Hashtag12
TGGTACACACGAAGAC	Hashtag11
TGGTAGTAGCATCCTA	Hashtag11
TGGTAGTCACTAACCA	Negative
TGGTAGTCAGAGGACT	Negative
TGGTAGTGTCAGTTTG	Negative
TGGTAGTTCGCCGAGT	Hashtag11
TGGTGATAGGTGATCG	Hashtag12
TGGTGATCAATAGTCC	Negative
TGGTGATGTGGCCTCA	Hashtag11
TGGTGATTCTCGACCT	Hashtag11
TGGTGATTCTGGAAGG	Negative
TGGTTAGAGATTGAGT	Negative
TGGTTAGGTCAGCGTC	Negative
TGGTTAGTCCTACCAC	Hashtag11
TGTAACGCACTGTGAT	Hashtag11
TGTAACGCACTTGTGA	Negative
TGTAACGCAGAGGAAA	Hashtag12
TGTAACGGTCACTACA	Hashtag11
TGTAACGGTTTACGTG	Hashtag11
TGTAAGCCACATATCG	Negative
TGTAAGCCACTATCCC	Negative
TGTAAGCCACTTGACA	Negative
TGTAAGCGTATGAAAC	Negative
TGTAAGCGTTCTCTAT	Hashtag11
TGTAAGCTCATTGCCC	Negative
TGTACAGAGTGCAACG	Hashtag12
TGTACAGCAAGACTGG	Hashtag11
TGTACAGCATTGTAGC	Negative
TGTAGACAGAATAGTC	Hashtag11
TGTAGACCAGAGTCTT	Hashtag11
TGTAGACCATTGCTTT	Hashtag12
TGTAGACGTGGACTAG	Negative
TGTAGACGTGTCATGT	Hashtag11
TGTAGACGTTTGGCTA	Negative
TGTAGACTCCTACCAC	Negative
TGTAGACTCGCGCCAA	Hashtag11
TGTAGACTCTGTCCGT	Hashtag11
TGTCAGATCCTCACGT	Hashtag11
TGTCCACAGTTGAATG	Negative
TGTCCACTCACAAGAA	Hashtag11
TGTCCACTCACGATAC	Hashtag11
TGTCCCAGTGACACGA	Negative
TGTCCCATCCGCAGTG	Hashtag11
TGTCCCATCGAGAAGC	Hashtag12
TGTCCTGCAGTCGCAC	Hashtag11
TGTCCTGCATAGGCGA	Negative
TGTCCTGCATGACACT	Negative
TGTCCTGGTGAACGGT	Hashtag11
TGTCCTGGTGAGACCA	Hashtag11
TGTCCTGGTTCGATTG	Hashtag11
TGTCCTGTCACTGCTC	Hashtag11
TGTGAGTAGCTAATCC	Hashtag12
TGTGAGTCAGCAGACA	Hashtag12
TGTGAGTCAGGCGATA	Hashtag11
TGTGAGTGTGCTCTTC	Negative
TGTGATGAGAGAGAAC	Hashtag11
TGTGATGCAGATCATC	Hashtag11
TGTGATGGTGATTCAC	Hashtag11
TGTGATGTCATGAGGG	Hashtag11
TGTGATGTCTGTGTGA	Negative
TGTGCGGAGAGACAAG	Negative
TGTGCGGAGTCTACCA	Hashtag11
TGTGCGGAGTGGTGAC	Hashtag12
TGTGCGGCAAGCGATG	Hashtag11
TGTGCGGCAATCTAGC	Negative
TGTGCGGCAGCAGAAC	Negative
TGTGCGGGTTCTTGCC	Hashtag11
TGTGCGGTCGTGTCAA	Negative
TGTGGCGGTAGCTGTT	Hashtag11
TGTGGCGGTCCACACG	Negative
TGTGGCGGTGACTAAA	Negative
TGTGTGAAGGATAATC	Negative
TGTGTGAAGGTCGCCT	Negative
TGTGTGACAAGGTCAG	Negative
TGTGTGACATGAGGGT	Negative
TGTGTGACATGGGTTT	Hashtag12
TGTGTGATCCTGGGAC	Negative
TGTTACTAGTCATACC	Hashtag11
TGTTACTCACAACATC	Hashtag11
TGTTACTCATTAGGCT	Hashtag11
TGTTACTGTTCTTGCC	Negative
TGTTCATAGACATCCT	Negative
TGTTCATAGGGCTAAC	Negative
TGTTCATGTGCGGATA	Hashtag12
TGTTCATTCTAAGGAA	Hashtag11
TGTTCCGAGCAGAAAG	Negative
TGTTCCGAGCGGTATG	Hashtag11
TGTTCCGCAACTGATC	Hashtag12
TGTTCTAGTGCACGCT	Negative
TGTTCTATCAAGAATG	Negative
TGTTCTATCTTGTGCC	Negative
TGTTGAGAGTTAACGA	Negative
TGTTGAGCAGTTAAAG	Hashtag11
TGTTGAGTCAGTGTGT	Hashtag11
TGTTGGAAGGCGACAT	Hashtag11
TGTTGGAAGGGCCCTT	Negative
TGTTGGACAAAGACTA	Hashtag11
TGTTGGACACGAAGAC	Hashtag11
TGTTGGATCCCATTCG	Negative
TGTTGGATCGTCAGAT	Hashtag11
TGTTGGATCTTCCGTG	Negative
TGTTTGTAGCATCCCG	Negative
TGTTTGTCAATTCACG	Negative
TGTTTGTCATTGCTTT	Hashtag11
TGTTTGTGTCAGGTAG	Hashtag11
TGTTTGTGTCGTCTCT	Negative
TTAATCCAGCTAAATG	Hashtag11
TTAATCCCACACCGCA	Hashtag11
TTAATCCGTGAGTTGG	Hashtag11
TTAATCCTCAGGCGAA	Negative
TTAATCCTCATCTATC	Hashtag11
TTACAGGCAAACACGG	Negative
TTACAGGGTATGCTTG	Negative
TTACCATAGGCCCGTT	Negative
TTACCATAGGGTCTTT	Negative
TTACCATGTTAGGACG	Hashtag11
TTACCATGTTGGGAAC	Hashtag11
TTACCATTCCACAGGC	Negative
TTACCATTCGCACGAC	Negative
TTACCGCCAGAGGGTT	Negative
TTACCGCCAGATCACT	Negative
TTACCGCGTGATTCTG	Hashtag11
TTACGCCGTGGAAGTC	Hashtag11
TTACGCCTCCCGTTGT	Hashtag11
TTACGTTAGCATGGGT	Hashtag11
TTACGTTGTAACCCTA	Negative
TTACGTTGTACCTTCC	Hashtag11
TTACGTTGTGAATTAG	Hashtag11
TTACGTTTCTTCGATT	Hashtag11
TTACTGTAGTCACTAC	Negative
TTACTGTCAACTAGAA	Hashtag11
TTACTGTCAGATCACT	Hashtag11
TTACTGTGTCCTATAG	Hashtag11
TTAGGCAGTACCCACG	Negative
TTAGGCAGTGAGACCA	Hashtag11
TTAGGCATCTCCGCAT	Hashtag11
TTAGGGTCACTCCACT	Hashtag11
TTAGGGTGTCAGTTTG	Hashtag11
TTAGGGTGTGCTTCAA	Hashtag11
TTAGGGTTCAGGACAG	Hashtag12
TTAGTCTCAAATACGA	Negative
TTAGTCTCAATAGAGT	Negative
TTAGTCTGTAGGCTGA	Hashtag11
TTAGTCTTCAGTCCGG	Negative
TTAGTCTTCCTTGGAA	Hashtag11
TTAGTCTTCTGTCGCT	Negative
TTATTGCCAGAGTGTG	Negative
TTATTGCCAGCGTGAA	Hashtag11
TTATTGCCAGGTGGAT	Hashtag11
TTATTGCTCGAACGGA	Negative
TTCAATCGTCAGTCTA	Hashtag11
TTCAATCTCTAGAGCT	Negative
TTCACCGAGATACAGT	Hashtag11
TTCACCGTCATTATCC	Negative
TTCACCGTCTGTTCAT	Negative
TTCACGCAGGCCCGTT	Hashtag11
TTCACGCAGGTCCCGT	Negative
TTCACGCAGTCTTCCC	Negative
TTCACGCGTACGACTT	Hashtag11
TTCACGCGTCCCGTGA	Hashtag11
TTCACGCTCAAGAAAC	Hashtag11
TTCACGCTCAAGAATG	Hashtag12
TTCACGCTCCTCGCAT	Hashtag11
TTCAGGAAGTCATGAA	Hashtag11
TTCATGTAGATCACCT	Negative
TTCATGTGTCTGTGTA	Negative
TTCATGTGTGACTGTT	Negative
TTCATGTGTTGCTCAA	Hashtag11
TTCATGTTCAGTGCGC	Negative
TTCATGTTCGTGGCGT	Negative
TTCATTGAGTCGCCAC	Negative
TTCATTGAGTCTCTGA	Negative
TTCATTGGTGTGCCTG	Hashtag11
TTCATTGTCACTGTCC	Hashtag11
TTCATTGTCCAGCCTT	Hashtag11
TTCATTGTCTTAGCCC	Negative
TTCCAATAGTGATAGT	Negative
TTCCAATCAGCGTACC	Hashtag11
TTCCAATGTAATGTGA	Hashtag11
TTCCAATGTTAGAGAT	Negative
TTCCAATTCACGATCA	Negative
TTCCACGAGCTTGTGT	Hashtag11
TTCCACGCAAGATGGC	Negative
TTCCACGGTATGTCTG	Negative
TTCCACGGTGTCCTAA	Hashtag11
TTCCACGTCGACGCTG	Hashtag11
TTCCACGTCTGAGCAT	Negative
TTCCGGTAGTTCATCG	Negative
TTCCGGTCAACTAGAA	Hashtag11
TTCCGGTTCAGCGCGT	Negative
TTCCGTGAGGTGCATG	Hashtag11
TTCCGTGCAAGGCGTA	Hashtag11
TTCCGTGTCGATTTCT	Negative
TTCCGTGTCTTCACGC	Negative
TTCCTAAAGCTGGTGA	Negative
TTCCTAACAATCACGT	Negative
TTCCTAAGTGGTTTAC	Hashtag11
TTCCTAATCGGCAGTC	Negative
TTCCTCTCAGACCTGC	Negative
TTCCTCTCAGGCTCTG	Negative
TTCCTCTGTCCGGTGT	Negative
TTCCTCTTCATAGCAC	Hashtag11
TTCCTCTTCATAGGCT	Negative
TTCCTCTTCCATAGAC	Hashtag11_Hashtag12
TTCCTTCAGATGCAGC	Hashtag11
TTCCTTCAGGGATCGT	Negative
TTCCTTCCACAGCATT	Negative
TTCCTTCCAGATCATC	Negative
TTCCTTCTCATACGAC	Negative
TTCCTTCTCTTTGCAT	Negative
TTCGATTCACCAGCTG	Negative
TTCGATTCACGTTGGC	Hashtag11
TTCGATTCAGTATTCG	Hashtag11
TTCGATTTCTGTAACG	Hashtag11
TTCGCTGAGTAGGTTA	Negative
TTCGCTGGTCTGTCCT	Negative
TTCGCTGTCAAAGAAC	Negative
TTCGCTGTCACAAGAA	Negative
TTCGGTCAGGTATAGT	Hashtag11
TTCGGTCCAAAGACGC	Negative
TTCGGTCCAAGAGTGC	Negative
TTCGGTCGTGACCGTC	Hashtag11
TTCTAACGTACCTGTA	Negative
TTCTAACTCCTACGGG	Negative
TTCTAACTCGAACGGA	Negative
TTCTAACTCGTAGGAG	Hashtag11
TTCTAACTCTAACGCA	Hashtag11
TTCTAGTAGCGATGCA	Negative
TTCTAGTCAAGAGGCT	Negative
TTCTAGTCAAGTATAG	Negative
TTCTAGTCACTCTGCT	Negative
TTCTAGTCAGAGATGC	Negative
TTCTAGTGTGCACGCT	Hashtag11
TTCTAGTGTGTGACCC	Negative
TTCTAGTTCTAGGCCG	Negative
TTCTAGTTCTCCGAGG	Negative
TTCTCTCAGAGTCAGC	Negative
TTCTCTCAGCGATGGT	Negative
TTCTCTCAGTGAGGTC	Hashtag11
TTCTCTCGTCCAGCCA	Hashtag11
TTCTCTCTCACTGGGC	Hashtag11
TTCTGTAGTACTGAGG	Negative
TTCTGTATCTGGACTA	Negative
TTCTTCCAGATGGCAC	Negative
TTCTTGATCCTTCTAA	Hashtag11
TTCTTGATCGGAGTGA	Negative
TTGAACGCAAGACGAC	Hashtag11
TTGAACGCATGACTAC	Negative
TTGAACGGTCAAAGAT	Hashtag11
TTGAACGTCCTCGCAT	Negative
TTGACCCAGGCCTGAA	Negative
TTGACCCAGGTAGTAT	Negative
TTGACCCCAGCACCCA	Negative
TTGACCCGTGACTGTT	Hashtag12
TTGAGTGAGCCTAACT	Hashtag12
TTGAGTGAGCTGGCTC	Hashtag12
TTGAGTGAGGTCCAGA	Negative
TTGAGTGAGGTTGACG	Hashtag11
TTGAGTGCACATTCGA	Hashtag11
TTGAGTGGTGGAACCA	Negative
TTGATGGAGAGGGCGA	Negative
TTGATGGAGCGCCATC	Negative
TTGATGGAGTGGTGGT	Negative
TTGATGGCATGCAGCC	Negative
TTGATGGGTGAATGAT	Hashtag11
TTGATGGGTGCACATT	Hashtag11
TTGCATTCAAGCTGTT	Hashtag12
TTGCCTGGTACAACGG	Hashtag11
TTGCCTGTCACAAGGG	Negative
TTGCCTGTCCGTATGA	Hashtag11
TTGCGTCCAACCGCCA	Negative
TTGCTGCAGCTGCGAA	Hashtag11_Hashtag12
TTGGATGCACATTCTT	Hashtag11
TTGGATGCACTTCAGA	Hashtag11
TTGGATGGTGTGGTCC	Hashtag11
TTGGATGTCAGGACGA	Hashtag11
TTGGATGTCCGTGTCT	Hashtag11
TTGGATGTCCTGTTAT	Negative
TTGGGATAGATTGCGG	Hashtag12
TTGGGATAGGCGTTAG	Hashtag12
TTGGGATGTAGCGCTC	Negative
TTGGGCGAGAAGATCT	Hashtag11_Hashtag12
TTGGGCGAGCGATTCT	Negative
TTGGGCGGTACCCAGC	Negative
TTGGGCGGTACTGCGC	Negative
TTGGGTACATGCAGGA	Hashtag11
TTGGGTAGTACGGATG	Negative
TTGGGTATCTGAACGT	Hashtag11
TTGGGTATCTTAAGGC	Negative
TTGGTTTAGGACAGTC	Hashtag11
TTGGTTTAGGCTAACG	Negative
TTGGTTTCACAATGAA	Negative
TTGGTTTGTCTATGAC	Negative
TTGGTTTGTTAGGCTT	Negative
TTGGTTTTCACGGGAA	Hashtag11
TTGGTTTTCCTCCACA	Hashtag11
TTGTGGACAACTACGT	Hashtag11
TTGTGGACACATTGTG	Negative
TTGTGGACATTCATCT	Negative
TTGTGGAGTTCGAAGG	Hashtag11
TTGTGTTCATGTGACT	Negative
TTGTGTTGTGAGAGGG	Hashtag11_Hashtag12
TTGTGTTTCAGCGGAA	Negative
TTGTTCAAGACATAGT	Hashtag11
TTGTTCAAGGGATGTC	Negative
TTGTTCAAGGGTTAAT	Negative
TTGTTCACACTAGGCC	Hashtag11
TTGTTCAGTCGAACGA	Negative
TTGTTCAGTCGAGTGA	Hashtag11
TTGTTCATCGACGTCG	Hashtag12
TTGTTCATCTCAAAGC	Negative
TTGTTGTCACAATGTC	Hashtag11
TTGTTGTTCGTAATGC	Hashtag11
TTGTTTGAGACGCCAA	Negative
TTGTTTGAGCATGATA	Hashtag11
TTGTTTGAGCCGTTGC	Hashtag12
TTGTTTGCAGTCGGAA	Hashtag11
TTGTTTGTCACTACGA	Negative
TTGTTTGTCTAACACG	Negative
TTTACCAAGAATCGTA	Negative
TTTACCAAGCTAATCC	Hashtag11
TTTACCAAGTGTTGTC	Negative
TTTACGTCAGGCATGA	Negative
TTTACGTTCGTTGCCT	Hashtag11
TTTACTGCAATACCCA	Hashtag11
TTTACTGCACCCATAA	Hashtag11
TTTACTGCACCTCTAC	Hashtag12
TTTACTGTCCTTCTTC	Hashtag11
TTTAGTCCAACGATTC	Hashtag11
TTTAGTCCACCATTCC	Negative
TTTAGTCCACCGGTCA	Negative
TTTAGTCCAGTATTCG	Negative
TTTAGTCTCATCGCCT	Hashtag11
TTTAGTCTCGCTCATC	Negative
TTTATGCAGAGCATTA	Negative
TTTATGCAGTATTGCC	Hashtag11
TTTATGCCAGGCATGA	Negative
TTTATGCGTCGCGGTT	Hashtag11
TTTATGCTCCCGAGTG	Negative
TTTCACAGTAAGATAC	Hashtag11
TTTCAGTCAAGAGGTC	Negative
TTTCAGTCAATTGAGA	Hashtag11
TTTCAGTGTCCTGTCT	Negative
TTTCAGTGTGAGGAAA	Hashtag11
TTTCAGTGTGCTTATG	Hashtag11
TTTCAGTGTGTGTGGA	Negative
TTTCCTCAGACTCTAC	Negative
TTTCCTCAGCGGGTAT	Hashtag11
TTTCCTCAGCTCCACG	Hashtag11
TTTCCTCTCCTTATAC	Hashtag11
TTTCGATAGAAACACT	Negative
TTTCGATAGGCCACCT	Negative
TTTCGATCAATCCAGT	Hashtag11
TTTCGATCATACCACA	Hashtag12
TTTCGATCATCATTGG	Hashtag12
TTTGACTAGACCAGAC	Hashtag11
TTTGACTAGGACATCG	Hashtag12
TTTGACTCACAAGCCC	Negative
TTTGACTTCAAGAATG	Hashtag11
TTTGACTTCGCGAAGA	Hashtag11
TTTGATCAGTCATAGA	Hashtag11
TTTGATCCAATGTCAC	Negative
TTTGATCCACAGCCTG	Hashtag11
TTTGATCCATGACACT	Hashtag11
TTTGATCGTATGTGTC	Hashtag11
TTTGATCGTGAGGATC	Hashtag11
TTTGATCTCCTTGGAA	Negative
TTTGATCTCTTACTGT	Negative
TTTGGAGCAATTGAGA	Hashtag11
TTTGGTTCATGGGATG	Negative
TTTGGTTGTAGAATGT	Hashtag11
TTTGGTTTCCTACGAA	Negative
TTTGGTTTCGCCTCTA	Hashtag11
TTTGTTGAGCACGTCC	Negative
TTTGTTGCATTGTCGA	Negative
TTTGTTGGTTGCATTG	Negative
TTTGTTGTCAGTGTGT	Hashtag11
TTTGTTGTCGTTCCTG	Negative
TTTGTTGTCTACTGAG	Hashtag11
