cells	sample
AAACCCAAGGCAGCTA	Hashtag9
AAACCCACAACCCTAA	Hashtag9
AAACCCACAGAGAATT	Negative
AAACCCACAGTCGCAC	Negative
AAACCCACAGTGTGGA	Negative
AAACCCAGTGAACGGT	Hashtag9
AAACCCAGTTGCGGCT	Hashtag9
AAACCCATCACTGAAC	Negative
AAACGAACAGCTGAGA	Hashtag9
AAACGAACAGGGTCTC	Negative
AAACGAACAGTCGGAA	Negative
AAACGAACATGAGAAT	Negative
AAACGAAGTCACTAGT	Hashtag9
AAACGAAGTCCCGTGA	Hashtag9
AAACGAATCGGTCGGT	Hashtag9
AAACGCTAGATCCCAT	Negative
AAACGCTCAACTCCAA	Negative
AAACGCTGTGGCCACT	Hashtag9
AAACGCTGTTAGGCCC	Negative
AAACGCTTCTAGTTCT	Negative
AAACGCTTCTGAACGT	Hashtag9
AAAGAACAGGCATTTC	Negative
AAAGAACAGGGCGAGA	Hashtag9
AAAGAACCACGCAAAG	Hashtag9
AAAGAACGTCTCGGGT	Negative
AAAGAACGTGGCCCAT	Negative
AAAGAACTCATTGCGA	Hashtag9
AAAGAACTCCTCCACA	Hashtag9
AAAGGATAGAAACACT	Negative
AAAGGATAGACCCTTA	Negative
AAAGGATCATGGAATA	Hashtag9
AAAGGATGTGTCCAAT	Hashtag9
AAAGGATGTTGCATAC	Negative
AAAGGATGTTTCTATC	Hashtag9
AAAGGATTCCAAAGGG	Hashtag9
AAAGGATTCGGCTTCT	Negative
AAAGGATTCTCCGAAA	Hashtag9
AAAGGGCAGGGATCAC	Hashtag9
AAAGGGCCAAGCGAGT	Hashtag9
AAAGGGCGTCAGTCTA	Negative
AAAGGGCTCACAGTGT	Negative
AAAGGGCTCGCCATAA	Hashtag9
AAAGGGCTCTGAGCAT	Negative
AAAGGTAAGCTGACAG	Hashtag10
AAAGGTACAACCCTCT	Negative
AAAGGTACACGGTGTC	Negative
AAAGGTACAGCAGAAC	Hashtag9
AAAGGTACAGCGTGAA	Hashtag9
AAAGGTAGTCTACGTA	Hashtag9
AAAGGTAGTTGCCTAA	Hashtag9
AAAGGTATCACGTAGT	Hashtag9
AAAGGTATCGCGTCGA	Hashtag9
AAAGGTATCTACCTTA	Hashtag9
AAAGTCCAGCGTATGG	Hashtag9
AAAGTCCCACTGTGTA	Hashtag9
AAAGTCCCAGACCTAT	Negative
AAAGTCCTCAATGCAC	Hashtag9
AAAGTGACACTCGATA	Hashtag10
AAAGTGAGTCATCGGC	Negative
AAAGTGATCATCTATC	Negative
AAAGTGATCCCTGGTT	Negative
AAATGGAAGATTCGCT	Hashtag9
AAATGGAAGCACTCCG	Hashtag9
AAATGGAAGGCAGTCA	Negative
AAATGGACATTGCCTC	Negative
AAATGGAGTACGGATG	Hashtag9
AAATGGAGTTGGAGAC	Negative
AAATGGATCTAACACG	Hashtag9
AAATGGATCTTGCGCT	Negative
AACAAAGCACATGAAA	Negative
AACAAAGCAGGTGGAT	Hashtag9
AACAAAGGTATGTCAC	Negative
AACAAAGGTTAGGCCC	Hashtag9
AACAAAGTCACGAACT	Negative
AACAAAGTCGATTGGT	Negative
AACAAAGTCGTAGAGG	Negative
AACAAAGTCGTCTAAG	Hashtag9
AACAAAGTCTCTATGT	Negative
AACAACCAGATCCCAT	Negative
AACAACCGTACCTGTA	Negative
AACAACCGTGACGCCT	Negative
AACAACCGTGCCTAAT	Negative
AACAACCTCAAGCCAT	Hashtag9
AACAACCTCAGTGGGA	Negative
AACAACCTCATTCACT	Negative
AACAACCTCCGTCACT	Negative
AACAAGAAGCTCGTGC	Negative
AACAAGACAACTTGCA	Negative
AACAAGAGTCAACCTA	Hashtag9
AACAAGAGTGGACTGA	Negative
AACAAGATCCCGTGTT	Hashtag10
AACACACAGTCGAGGT	Negative
AACACACCAAATAGCA	Hashtag10_Hashtag9
AACACACCAGAACTCT	Negative
AACACACGTGAACCGA	Hashtag9
AACACACGTGGTTCTA	Hashtag9
AACACACTCACGACTA	Negative
AACACACTCAGGGTAG	Hashtag9
AACACACTCGTGCTCT	Negative
AACACACTCGTGGGAA	Hashtag9
AACACACTCTACGCAA	Negative
AACAGGGAGACTAAGT	Hashtag9
AACAGGGAGCGAGGAG	Hashtag9
AACAGGGCACAAGCCC	Hashtag9
AACAGGGCATTAAAGG	Hashtag9
AACAGGGGTAGTACGG	Negative
AACAGGGGTGCGTCGT	Negative
AACAGGGTCTTACCAT	Negative
AACCAACAGCGACCCT	Negative
AACCAACCAATCTAGC	Hashtag10
AACCAACCATGCGGTC	Negative
AACCAACGTAGTTCCA	Hashtag9
AACCAACGTCAAACGG	Hashtag9
AACCAACTCCTCTCGA	Negative
AACCAACTCTGCTCTG	Hashtag9
AACCACAAGACTCTAC	Negative
AACCACACACGCTGTG	Negative
AACCACACACTCCTTG	Negative
AACCACAGTAGTGCGA	Negative
AACCACAGTGGTTTAC	Negative
AACCACAGTGTTGACT	Hashtag9
AACCACATCAACACGT	Hashtag9
AACCATGAGGTTTGAA	Hashtag9
AACCATGGTGGATGAC	Negative
AACCATGTCGAGTACT	Negative
AACCATGTCGCCTCTA	Negative
AACCCAAAGGATTCCT	Negative
AACCCAAGTCGAATGG	Negative
AACCCAAGTGCTCTCT	Hashtag9
AACCCAAGTGTTGCCG	Hashtag9
AACCCAAGTTTCGGCG	Negative
AACCCAATCGTCGACG	Hashtag10
AACCCAATCGTTAGTG	Negative
AACCTGACAAGTAGTA	Negative
AACCTGATCCACCCTA	Negative
AACCTTTAGCTAATCC	Negative
AACCTTTAGGTATAGT	Negative
AACCTTTAGGTCCCGT	Hashtag9
AACCTTTCAACTCGAT	Negative
AACCTTTCACCACATA	Negative
AACCTTTGTCGTTTCC	Negative
AACCTTTGTGACTGAG	Negative
AACCTTTGTTAAACCC	Negative
AACGAAAAGTACGAGC	Hashtag9
AACGAAAAGTGACCTT	Negative
AACGAAAAGTTCCAGT	Negative
AACGAAACAATTGCGT	Negative
AACGAAACAGCACAAG	Negative
AACGAAACAGGGATAC	Negative
AACGAAACATAGGAGC	Hashtag9
AACGAAACATGCCATA	Negative
AACGAAACATTGCTTT	Negative
AACGAAAGTACTCGCG	Negative
AACGAAAGTATGTCTG	Hashtag9
AACGAAAGTGTCATGT	Negative
AACGAAATCCGATTAG	Hashtag9
AACGGGAAGCAGCGAT	Negative
AACGGGAAGCTGTGCC	Negative
AACGGGACAGACCATT	Hashtag9
AACGGGACAGCTGTCG	Hashtag9
AACGGGACAGTGTGGA	Negative
AACGGGACATCCGAGC	Negative
AACGGGAGTAGATCCT	Negative
AACGGGAGTGACACGA	Negative
AACGGGATCATACGGT	Hashtag9
AACGGGATCGTAGGGA	Negative
AACGGGATCTTTCTAG	Hashtag9
AACGTCAAGACTCTTG	Negative
AACGTCAAGGAATTAC	Negative
AACGTCAAGTATGAAC	Negative
AACGTCAGTTTGGGAG	Hashtag9
AACGTCATCAGTGTCA	Negative
AACGTCATCAGTGTGT	Negative
AACGTCATCCATCACC	Negative
AACTTCTAGTAGGTTA	Negative
AACTTCTCAACAGATA	Hashtag9
AACTTCTCAATTGCGT	Hashtag9
AACTTCTCACGGCGTT	Negative
AACTTCTCAGTTACCA	Hashtag9
AACTTCTGTATCGCAT	Hashtag9
AACTTCTTCGAACCTA	Hashtag9
AAGAACAGTGCGCTCA	Negative
AAGAACATCTTAGCAG	Hashtag9
AAGAACATCTTCACAT	Hashtag9
AAGAACATCTTGATTC	Hashtag9
AAGACAAAGTTCCGGC	Hashtag9
AAGACAACAGAGATGC	Negative
AAGACAAGTTCCACAA	Hashtag9
AAGACAATCGTCCTTG	Hashtag9
AAGACTCCAACGACAG	Hashtag9
AAGACTCCACGCGCAT	Negative
AAGACTCCAGCGAACA	Negative
AAGACTCCAGGTGAGT	Negative
AAGACTCGTGGCTGCT	Negative
AAGACTCTCATCACAG	Hashtag9
AAGATAGAGCCTCAAT	Negative
AAGATAGGTCGTCATA	Negative
AAGATAGGTGAACCGA	Hashtag9
AAGATAGGTGATACAA	Negative
AAGATAGGTTCAATCG	Hashtag9
AAGATAGTCATAGGCT	Hashtag9
AAGCATCAGTTTCGGT	Negative
AAGCATCCAACCAACT	Negative
AAGCATCGTTCACCGG	Negative
AAGCATCTCCGCTTAC	Hashtag9
AAGCCATAGTGCCAGA	Negative
AAGCCATCAACGGGTA	Negative
AAGCCATCATGCCGCA	Hashtag10
AAGCCATGTGCGAACA	Negative
AAGCGAGAGTGGCAGT	Hashtag9
AAGCGAGGTAGGTTTC	Hashtag9
AAGCGAGGTGACATCT	Hashtag9
AAGCGAGTCCGCTTAC	Negative
AAGCGAGTCGCAGAGA	Negative
AAGCGTTAGGCCTTGC	Hashtag9
AAGCGTTAGGTTATAG	Negative
AAGCGTTCACGGTCTG	Negative
AAGCGTTCAGAGAATT	Negative
AAGCGTTCATCGGTTA	Negative
AAGCGTTTCCGATGTA	Negative
AAGCGTTTCCGTTTCG	Negative
AAGCGTTTCGCCAGAC	Hashtag9
AAGGAATAGAAGTCAT	Hashtag10_Hashtag9
AAGGAATAGCGAGTAC	Hashtag9
AAGGAATAGGTTGTTC	Hashtag9
AAGGAATCATCGGCCA	Negative
AAGGAATGTATCGGTT	Negative
AAGGAATGTTTGTTGG	Hashtag9
AAGGAATTCCAAGGGA	Negative
AAGGAATTCCGTATGA	Hashtag9
AAGGAATTCGTGTCAA	Negative
AAGGTAAAGCACTGGA	Negative
AAGGTAAAGCCTATCA	Negative
AAGGTAAAGGGCAATC	Negative
AAGGTAACAGCTTTGA	Negative
AAGGTAAGTCTCACGG	Negative
AAGGTAAGTTACAGCT	Hashtag9
AAGGTAATCCGGCAGT	Negative
AAGTACCAGCACGTCC	Negative
AAGTACCAGCTGGAGT	Negative
AAGTACCTCCTTATAC	Hashtag9
AAGTACCTCTTTGCTA	Negative
AAGTCGTAGATGGTAT	Hashtag10
AAGTCGTCACAGCTGC	Hashtag9
AAGTCGTGTCACTGAT	Negative
AAGTCGTGTCCTTAAG	Hashtag10
AAGTCGTGTCTACGAT	Negative
AAGTCGTGTCTCACAA	Hashtag9
AAGTGAACAAACTGCT	Negative
AAGTGAACAGAATGTA	Negative
AAGTGAACAGCATACT	Hashtag9
AAGTGAAGTACGACAG	Negative
AAGTGAAGTGAGATAT	Negative
AAGTGAATCTTGCAAG	Negative
AAGTTCGAGACATAGT	Hashtag9
AAGTTCGAGGATACGC	Hashtag9
AAGTTCGCACCTAAAC	Negative
AAGTTCGTCATAAGGA	Negative
AAGTTCGTCCGTGGCA	Negative
AATAGAGAGAGCGACT	Hashtag10
AATAGAGAGATACTGA	Negative
AATAGAGAGTAGACAT	Hashtag9
AATAGAGCAGAACTAA	Hashtag9
AATAGAGGTAAGCAAT	Negative
AATAGAGGTGTGAGCA	Negative
AATAGAGGTGTGTGTT	Hashtag9
AATAGAGTCCATCCGT	Hashtag9
AATCACGAGGAACGCT	Hashtag9
AATCACGTCTTAATCC	Hashtag9
AATCGACAGGAGAATG	Hashtag9
AATCGACAGTGCCCGT	Negative
AATCGACCAAGAGGCT	Negative
AATCGACCAATACAGA	Negative
AATCGACCATGACAGG	Negative
AATCGACGTAAGATTG	Hashtag9
AATCGACGTTTCGATG	Hashtag9
AATCGACTCCGTAATG	Negative
AATCGTGAGAGTGTTA	Hashtag9
AATCGTGAGTAGACCG	Hashtag9
AATCGTGCAATTGGTC	Negative
AATCGTGGTAGCGCTC	Negative
AATCGTGGTCTACAGT	Negative
AATCGTGGTTCCGCAG	Hashtag9
AATGAAGCAACTGCTA	Negative
AATGAAGCACGTTCGG	Negative
AATGAAGCATATGAAG	Hashtag10
AATGAAGTCCTAACAG	Negative
AATGAAGTCTAGCCTC	Hashtag9
AATGACCAGAGCCGTA	Hashtag9
AATGACCAGCACTCTA	Negative
AATGACCCACAATGAA	Negative
AATGACCCACCGTGGT	Negative
AATGACCCACGCCAGT	Negative
AATGACCGTCGAGCTC	Negative
AATGACCTCCGACATA	Negative
AATGACCTCGCCACTT	Negative
AATGACCTCTTCTCAA	Negative
AATGACCTCTTCTGGC	Hashtag9
AATGCCACAAACGGCA	Negative
AATGCCAGTTATCTGG	Negative
AATGCCATCTGCCCTA	Hashtag9
AATGGAAAGATGTTCC	Hashtag9
AATGGAACAACCACAT	Negative
AATGGAACAACCACGC	Negative
AATGGAACAGCTGAAG	Negative
AATGGAACATACTGTG	Negative
AATGGAAGTAAGTAGT	Hashtag9
AATGGAATCATGCTAG	Negative
AATGGAATCCAATGCA	Hashtag9
AATGGAATCCCATTCG	Negative
AATGGAATCGTTAGTG	Hashtag9
AATGGAATCTAGCCTC	Negative
AATGGCTAGTCATTGC	Hashtag9
AATGGCTCACGACGTC	Hashtag9
AATGGCTGTAGACTGG	Negative
AATGGCTGTTGCCGAC	Hashtag10
AATGGCTTCAGTCACA	Hashtag9
AATGGCTTCCCTGGTT	Negative
AATGGCTTCGGTGAAG	Negative
AATTCCTAGACTTGTC	Negative
AATTCCTCAGTTTGGT	Hashtag9
AATTCCTGTAGCTCGC	Negative
AATTCCTGTGAGATAT	Negative
AATTCCTGTGGCTTGC	Hashtag9
AATTCCTTCACTCCGT	Negative
AATTCCTTCATTATCC	Negative
AATTCCTTCCCATAAG	Negative
AATTCCTTCGCAACAT	Negative
AATTCCTTCGGCTCTT	Hashtag9
AATTTCCAGGTGCATG	Negative
AATTTCCCAGTTTCGA	Hashtag9
AATTTCCGTCTTGAGT	Hashtag9
AATTTCCGTGCGTTTA	Negative
AATTTCCGTGTTATCG	Hashtag9
AATTTCCGTTGACTAC	Negative
AATTTCCTCACGGGAA	Hashtag10_Hashtag9
ACAAAGAAGGTGATAT	Negative
ACAAAGAAGTGATTCC	Negative
ACAAAGACAATAACCC	Negative
ACAAAGACAGGACGAT	Hashtag9
ACAAAGAGTGACAGGT	Negative
ACAAAGAGTGCAACGA	Negative
ACAAAGAGTTCCGCTT	Negative
ACAAAGAGTTGTGCAT	Negative
ACAAAGATCCAGTGTA	Negative
ACAAAGATCCGTGTAA	Hashtag9
ACAAAGATCGAAATCC	Negative
ACAAAGATCGGTCAGC	Negative
ACAAAGATCGTAGCTA	Hashtag9
ACAACCAAGAATCGAT	Negative
ACAACCAAGTCGGCCT	Negative
ACAACCAAGTGTACAA	Hashtag9
ACAACCAGTTCACCGG	Negative
ACAACCATCCGTGCGA	Negative
ACAAGCTAGGCAGCTA	Negative
ACAAGCTCACAAATGA	Negative
ACAAGCTTCATGAGAA	Negative
ACACAGTAGTGTAGTA	Hashtag10
ACACAGTCACAAATAG	Negative
ACACAGTGTGGCCACT	Negative
ACACAGTTCAGAGTTC	Negative
ACACAGTTCATAGCAC	Hashtag9
ACACCAACAATTGCTG	Negative
ACACCAACATAACGGG	Hashtag9
ACACCAATCCCAAGTA	Hashtag9
ACACCAATCCCGAGAC	Negative
ACACGCGAGAGTCTGG	Negative
ACACGCGAGATCGGTG	Negative
ACACGCGAGCGAGGAG	Hashtag9
ACACGCGAGCGGACAT	Negative
ACACGCGAGTAGACCG	Negative
ACACGCGCAAGGGCAT	Negative
ACACGCGGTCCTCAGG	Negative
ACACGCGGTTACAGCT	Negative
ACACGCGTCATTGAGC	Negative
ACACGCGTCGCCGAAC	Hashtag9
ACACTGAAGCACGGAT	Negative
ACACTGAAGCTGAGCA	Negative
ACACTGATCAGGAAGC	Hashtag9
ACACTGATCCATTCGC	Hashtag9
ACAGAAAAGAAGGGAT	Negative
ACAGAAAAGAATCGTA	Negative
ACAGAAAAGCGTGCCT	Negative
ACAGAAACAGGTAGTG	Negative
ACAGAAAGTCTGATAC	Negative
ACAGAAATCACCGCTT	Negative
ACAGAAATCATCGCAA	Negative
ACAGCCGAGAGTTGCG	Negative
ACAGCCGCAGGACAGT	Negative
ACAGCCGCAGGTTTAC	Negative
ACAGCCGGTGTCCACG	Negative
ACAGCCGTCGTCAAAC	Negative
ACAGCCGTCGTTAGAC	Hashtag10_Hashtag9
ACAGGGAAGAGGTATT	Negative
ACAGGGAAGGCCTGAA	Negative
ACAGGGACAATCGAAA	Negative
ACAGGGACACAGTACT	Hashtag9
ACAGGGAGTACCGGCT	Hashtag9
ACAGGGAGTCATAGTC	Negative
ACAGGGAGTCCTTTGC	Hashtag10
ACATCCCCACAGAGCA	Negative
ACATCCCGTCCAGAAG	Negative
ACATCCCTCAAAGGTA	Negative
ACATCCCTCCCTTCCC	Negative
ACATCCCTCGGATTAC	Negative
ACATCGAAGACGACTG	Negative
ACATCGAAGTGAGTTA	Hashtag9
ACATCGACAAATGCTC	Hashtag9
ACATCGACAAGTCCAT	Hashtag9
ACATCGAGTGATAGAT	Negative
ACATGCAAGAAGCGAA	Hashtag9
ACATGCAAGAGATCGC	Negative
ACATGCAAGCCGATTT	Negative
ACATGCACAATTGTGC	Negative
ACATGCACACCTTCGT	Hashtag9
ACATGCACAGGACGAT	Negative
ACATGCACAGTGCGCT	Hashtag9
ACATGCACATGTGTCA	Negative
ACATGCAGTATGGGAC	Hashtag9
ACATGCATCAGCCTCT	Hashtag9
ACATTTCAGTTCCAGT	Hashtag9
ACATTTCGTAAGACCG	Negative
ACATTTCGTAGGGAGG	Negative
ACATTTCGTCTTAGTG	Negative
ACATTTCGTCTTGGTA	Hashtag9
ACATTTCGTGCCTAAT	Hashtag9
ACATTTCTCCTCACCA	Hashtag9
ACATTTCTCTCAGGCG	Negative
ACCAAACAGGCTATCT	Negative
ACCAAACCAACTGAAA	Hashtag9
ACCAAACCACAAGGTG	Negative
ACCAAACGTGCTCTCT	Hashtag9
ACCAAACGTGGGTTGA	Negative
ACCAAACGTTAGTTCG	Negative
ACCAAACTCCGATAAC	Negative
ACCAAACTCGGATTAC	Hashtag9
ACCAAACTCGTTCTCG	Negative
ACCAACAAGCACAAAT	Negative
ACCAACAAGCATCCTA	Hashtag9
ACCAACACAACTGCTA	Negative
ACCAACACAAGCCATT	Hashtag9
ACCAACACATTGACTG	Negative
ACCAACAGTAAGATTG	Hashtag9
ACCAACAGTAAGGCTG	Negative
ACCAACAGTATCAGGG	Negative
ACCACAAAGGTACAGC	Hashtag9
ACCACAAAGTTAGTAG	Negative
ACCACAAGTCTAGGCC	Negative
ACCACAATCATCCCGT	Negative
ACCACAATCCACGTCT	Negative
ACCACAATCCTTCTAA	Negative
ACCATTTAGCTTTCCC	Negative
ACCATTTAGGGTATAT	Negative
ACCATTTCAAATCAAG	Hashtag9
ACCATTTGTGTACGCC	Hashtag9
ACCATTTGTTTACCTT	Negative
ACCATTTTCAAAGACA	Hashtag10
ACCATTTTCTACTGAG	Negative
ACCATTTTCTCGCTCA	Negative
ACCCAAAAGATAACAC	Negative
ACCCAAAAGTAGGCCA	Negative
ACCCAAACAGAAGTTA	Hashtag9
ACCCAAACATGGCTGC	Negative
ACCCAAAGTCATAGTC	Hashtag10
ACCCAAAGTGTAAACA	Hashtag9
ACCCAAATCCGGTTCT	Negative
ACCCAAATCTCGCTCA	Negative
ACCCTCACACAACGTT	Hashtag10
ACCCTCACATGGCGCT	Negative
ACCCTCAGTGATTAGA	Negative
ACCCTCATCAGCCCAG	Negative
ACCCTCATCAGTAGGG	Hashtag9
ACCCTCATCATTCCTA	Hashtag9
ACCCTCATCCTTTGAT	Negative
ACCCTTGAGCCAACCC	Negative
ACCCTTGAGGGAGAAT	Negative
ACCCTTGCACACAGCC	Hashtag9
ACCCTTGCACCATAAC	Hashtag9
ACCCTTGCATGTTACG	Negative
ACCCTTGGTGTTACTG	Negative
ACCCTTGTCATGGAGG	Hashtag9
ACCGTTCAGAAACCCG	Negative
ACCGTTCAGGAAGTGA	Negative
ACCGTTCAGGGTCACA	Hashtag9
ACCGTTCCACGAGAAC	Hashtag10
ACCGTTCCACTGTGTA	Negative
ACCGTTCCATGACTGT	Hashtag10
ACCGTTCGTACAGTTC	Hashtag9
ACCGTTCGTTCCACGG	Hashtag9
ACCGTTCGTTGACGGA	Hashtag9
ACCGTTCTCCCAATAG	Negative
ACCTACCAGTCGCCCA	Negative
ACCTACCTCGATGCTA	Negative
ACCTGAAAGGACAAGA	Hashtag9
ACCTGAACAACTTGCA	Hashtag9
ACCTGAACACCGTGCA	Negative
ACCTGAAGTGAGCGAT	Hashtag9
ACCTGAAGTTTCTTAC	Hashtag9
ACCTGAATCAGTGGGA	Negative
ACCTGTCAGTAAACTG	Hashtag9
ACCTGTCGTACAGTCT	Negative
ACCTGTCGTACCAATC	Negative
ACCTGTCTCACTGGGC	Hashtag9
ACGATCAAGACCAGCA	Negative
ACGATCAAGCATGATA	Negative
ACGATCAAGTGTTCAC	Negative
ACGATCACAAGTGCAG	Negative
ACGATCACACCATATG	Negative
ACGATCATCATGCCCT	Negative
ACGATGTCAGCGACCT	Negative
ACGATGTCAGGCGATA	Negative
ACGATGTGTAGCGTCC	Negative
ACGATGTGTGTTAACC	Negative
ACGCACGAGATTGTGA	Negative
ACGCACGCAACTGCTA	Negative
ACGCACGGTCAAGTTC	Negative
ACGCACGGTCACCCTT	Negative
ACGCACGGTCCTGTCT	Hashtag10
ACGCACGGTGCATACT	Negative
ACGCACGGTGTGTGGA	Negative
ACGCACGTCATTGCGA	Negative
ACGCACGTCCAGCTCT	Negative
ACGCACGTCGTGGACC	Negative
ACGGAAGAGGGAGAAT	Hashtag9
ACGGAAGAGTCTTCGA	Negative
ACGGAAGCAAAGGGTC	Negative
ACGGAAGTCAATCAGC	Negative
ACGGAAGTCGATTTCT	Negative
ACGGAAGTCTCATTAC	Negative
ACGGAAGTCTGTTCAT	Negative
ACGGGTCAGGACATCG	Hashtag9
ACGGGTCGTAACTGCT	Negative
ACGGGTCGTTGGTAGG	Negative
ACGGGTCTCTCGGTAA	Negative
ACGGTCGAGGCCTTGC	Negative
ACGGTCGCATAACAGA	Negative
ACGGTCGGTAGATCGG	Negative
ACGGTCGGTATCCCAA	Negative
ACGGTCGTCAGTCAGT	Hashtag9
ACGGTTAAGAATAGTC	Hashtag10
ACGGTTAAGCAGCGAT	Hashtag9
ACGGTTAAGTGTTGAA	Negative
ACGGTTACACTGATTG	Negative
ACGGTTAGTAGAGATT	Negative
ACGGTTAGTATGGGAC	Hashtag9
ACGGTTAGTCAGTCGC	Hashtag10
ACGGTTAGTGACCTGC	Negative
ACGGTTATCAAAGAAC	Hashtag9
ACGGTTATCCGCAACG	Negative
ACGGTTATCTTCCCGA	Negative
ACGTAACAGACTGGGT	Negative
ACGTAACAGCCGGATA	Negative
ACGTAACCAGCACACC	Negative
ACGTAACGTGCTGCAC	Negative
ACGTAACTCCACTTCG	Negative
ACGTACAGTACATACC	Negative
ACGTACAGTCTAATCG	Negative
ACGTACATCCGTCACT	Negative
ACGTAGTAGGAACGCT	Negative
ACGTAGTCAGTTTCAG	Negative
ACGTAGTGTTATGGTC	Negative
ACGTAGTGTTGGTAGG	Hashtag9
ACGTAGTGTTGTTTGG	Negative
ACGTAGTTCTGAATCG	Negative
ACGTCCTAGCCAAGGT	Negative
ACGTCCTAGGTAGCAC	Hashtag9
ACGTCCTAGGTCGACA	Negative
ACGTCCTAGGTTAGTA	Hashtag9
ACGTCCTAGTTGCCCG	Negative
ACGTCCTCACATGGTT	Hashtag9
ACGTCCTCATCCTCAC	Negative
ACGTCCTGTTCGGTTA	Negative
ACGTCCTGTTGACTAC	Negative
ACGTCCTTCGCCGAAC	Hashtag9
ACGTTCCGTAAGAACT	Negative
ACGTTCCGTGATTCTG	Negative
ACGTTCCTCAGCTTGA	Hashtag10
ACGTTCCTCTTGAGCA	Negative
ACTACGAAGGATACGC	Negative
ACTACGAAGGGCATGT	Hashtag9
ACTACGAGTCCACATA	Negative
ACTACGAGTGACAACG	Hashtag10_Hashtag9
ACTACGAGTGTCCGGT	Hashtag9
ACTACGATCAATCTCT	Negative
ACTACGATCCGAGATT	Negative
ACTACGATCTAACACG	Hashtag9
ACTACGATCTGAATGC	Negative
ACTATCTCAACAACAA	Negative
ACTATCTCATCCTAAG	Hashtag9
ACTATCTGTACCTAGT	Negative
ACTATCTGTGTCCACG	Hashtag9
ACTATCTGTGTGTGGA	Hashtag9
ACTATGGAGTGCTAGG	Negative
ACTATGGCAGAGTAAT	Negative
ACTATGGCATCCGCGA	Negative
ACTATGGCATGTGGCC	Negative
ACTATGGGTCTCCCTA	Negative
ACTATGGTCGAATGCT	Negative
ACTATGGTCGTGGGTC	Hashtag9
ACTATTCAGATGATTG	Negative
ACTATTCAGCTACTAC	Negative
ACTATTCAGGATGTTA	Negative
ACTATTCGTAGACACG	Negative
ACTATTCGTCATGACT	Negative
ACTATTCGTCCGTTTC	Hashtag9
ACTATTCGTGGCCCAT	Negative
ACTCCCAAGAAGTCAT	Negative
ACTCCCAAGGCAGGGA	Hashtag9
ACTCCCAGTAATGATG	Negative
ACTCCCAGTAGTCGTT	Hashtag10
ACTCCCAGTTACGCCG	Hashtag9
ACTCCCATCCGACGGT	Hashtag9
ACTCCCATCCGTTGAA	Hashtag9
ACTCTCGAGACTCATC	Negative
ACTCTCGAGCAGCCTC	Hashtag9
ACTCTCGAGTCCTGCG	Negative
ACTCTCGCAAAGTGTA	Negative
ACTCTCGGTCGGCCTA	Negative
ACTCTCGTCGTAGGGA	Hashtag9
ACTGATGGTAAGCTCT	Hashtag9
ACTGATGGTCGCATGC	Negative
ACTGATGGTTCGCGTG	Negative
ACTGATGTCACTCACC	Negative
ACTGATGTCATTGCCC	Negative
ACTGCAAAGATACCAA	Hashtag9
ACTGCAACAATCCTAG	Hashtag9
ACTGCAACACGCGGTT	Negative
ACTGCAAGTGTAGCAG	Hashtag9
ACTGCAATCCCGAACG	Hashtag9
ACTGTCCCAATAGGAT	Hashtag9
ACTGTCCCATGAAGCG	Negative
ACTGTCCGTCTAACGT	Hashtag9
ACTGTCCGTCTACGAT	Hashtag9
ACTGTCCGTTACCTGA	Negative
ACTGTCCTCCTGTAAG	Negative
ACTGTGAAGACTTCCA	Negative
ACTGTGAGTCCGCAGT	Hashtag9
ACTGTGAGTCTCACGG	Negative
ACTGTGATCGAAATCC	Hashtag9
ACTGTGATCGGTTGTA	Hashtag9
ACTTAGGAGAGTCACG	Negative
ACTTAGGAGCAATAAC	Negative
ACTTAGGAGTTAGAAC	Negative
ACTTAGGCAGTAACAA	Negative
ACTTAGGGTAACATCC	Hashtag9
ACTTAGGGTTCGTACA	Hashtag9
ACTTAGGGTTGCGGCT	Hashtag9
ACTTAGGTCCTGGGAC	Negative
ACTTAGGTCTAGAGCT	Hashtag9
ACTTAGGTCTTGGTCC	Negative
ACTTATCCAGCTACCG	Negative
ACTTATCGTTCTGAGT	Negative
ACTTATCGTTTACTGG	Negative
ACTTATCTCAAACCTG	Negative
ACTTATCTCCCGAGTG	Hashtag9
ACTTCCGCACGACAAG	Negative
ACTTCCGGTCAAAGCG	Hashtag9
ACTTCCGGTGAGAACC	Hashtag9
ACTTCGCAGAGAACCC	Negative
ACTTCGCAGGATACGC	Hashtag9
ACTTCGCAGGATTCCT	Negative
ACTTCGCCAGCTGAAG	Hashtag9
ACTTCGCCATGACTAC	Negative
ACTTCGCGTTGTCTAG	Hashtag10
ACTTCGCTCGAGTACT	Negative
ACTTTCAAGGGCAACT	Hashtag9
ACTTTCAGTGCTCCGA	Negative
ACTTTCATCTCCGAAA	Hashtag9
ACTTTCATCTCGACCT	Hashtag10_Hashtag9
ACTTTCATCTTACCAT	Negative
ACTTTGTAGTCGAATA	Negative
ACTTTGTGTCCCACGA	Negative
ACTTTGTGTTTAGAGA	Hashtag9
ACTTTGTTCATAAGGA	Negative
ACTTTGTTCCATCACC	Negative
ACTTTGTTCGCATTAG	Negative
AGAAATGAGTACAGAT	Negative
AGAAATGCACCAGTAT	Negative
AGAAATGCATTGCCGG	Hashtag9
AGAAATGGTACACGCC	Hashtag10
AGAAATGGTGATGGCA	Hashtag9
AGAAATGGTTGCGGAA	Hashtag10
AGAACAACAGATAAAC	Hashtag9
AGAACAAGTAAGTAGT	Hashtag9
AGAACCTAGACCAGCA	Negative
AGAACCTAGATTGCGG	Hashtag9
AGAACCTAGCGCCTTG	Negative
AGAACCTCAAGCACAG	Negative
AGAACCTCATAGCACT	Negative
AGAACCTGTAGTATAG	Hashtag9
AGAACCTGTGGATCGA	Negative
AGAACCTTCCTTCTGG	Hashtag9
AGAAGCGCACTTCCTG	Negative
AGAAGCGCATCTTAGG	Negative
AGAAGCGGTGCGAACA	Hashtag9
AGAAGCGTCTCGGTCT	Hashtag9
AGAAGTACACAGCCAC	Hashtag9
AGAAGTACACTCCTGT	Negative
AGAAGTACATGGACAG	Hashtag9
AGAAGTAGTGAGATCG	Hashtag9
AGAAGTATCAAATAGG	Negative
AGAAGTATCCCTAGGG	Negative
AGACAAAAGTGGGAAA	Negative
AGACAAAGTCGAAACG	Negative
AGACAAATCAGAGTGG	Negative
AGACAAATCTATTTCG	Negative
AGACACTCAACACGAG	Hashtag9
AGACACTCATCGGTTA	Negative
AGACACTTCGATCCAA	Hashtag9
AGACACTTCTGCCTCA	Negative
AGACAGGAGAAATCCA	Negative
AGACAGGAGAGTAACT	Hashtag9
AGACAGGAGGTATCTC	Negative
AGACAGGGTAGCGTCC	Negative
AGACAGGGTATCCCTC	Negative
AGACAGGGTATCCTTT	Hashtag9
AGACAGGGTGTTTGCA	Negative
AGACAGGTCCACGGAC	Negative
AGACAGGTCCAGCACG	Hashtag9
AGACAGGTCCGGGACT	Hashtag9
AGACCATCAAGACCTT	Hashtag9
AGACCATCAGACACAG	Negative
AGACCATTCGCCTATC	Hashtag9
AGACCCGAGCTTAAGA	Hashtag9
AGACCCGCAACCGCTG	Negative
AGACCCGCACCATTCC	Hashtag9
AGACCCGGTATACAGA	Hashtag9
AGACCCGGTCACGCTG	Negative
AGACCCGGTTGCTGAT	Negative
AGACCCGTCTGTAACG	Negative
AGACTCAGTCGAGCTC	Negative
AGACTCATCGTTAGAC	Negative
AGAGAATAGTCAATCC	Hashtag9
AGAGAATCAGAACTAA	Negative
AGAGAATGTGTATTGC	Negative
AGAGAATTCACTTTGT	Negative
AGAGAATTCAGAGCGA	Hashtag10_Hashtag9
AGAGAATTCAGCCTCT	Hashtag9
AGAGAATTCATTTGTC	Negative
AGAGAATTCCGTGACG	Hashtag9
AGAGAATTCGTAGGGA	Negative
AGAGAGCAGAGTTGCG	Hashtag9
AGAGAGCAGATTGACA	Hashtag9
AGAGAGCAGCCTATTG	Negative
AGAGAGCCAAAGGCGT	Negative
AGAGAGCCAGAGCCCT	Negative
AGAGAGCGTGATTCAC	Negative
AGAGAGCGTTTGCCGG	Hashtag9
AGAGAGCTCGTCTACC	Hashtag9
AGAGAGCTCTGCGAGC	Hashtag9
AGAGCAGAGAGTGTTA	Hashtag9
AGAGCAGAGCGGCTCT	Negative
AGAGCAGAGTAGCAAT	Negative
AGAGCAGCATAATCCG	Hashtag9
AGAGCAGGTCTATGAC	Negative
AGAGCAGTCCTAAACG	Hashtag9
AGAGCAGTCGGTGCAC	Negative
AGAGCAGTCTAGCAAC	Negative
AGAGCAGTCTAGTGAC	Negative
AGAGCCCAGGGTAATT	Hashtag9
AGAGCCCCATAACTCG	Negative
AGAGCCCGTAGCTGAG	Negative
AGAGCCCGTTCAATCG	Hashtag10
AGAGCCCTCACTGTCC	Hashtag9
AGATAGAAGTTGCGAG	Negative
AGATAGACACCTGCGA	Negative
AGATAGAGTAAGCGGT	Negative
AGATAGAGTCCGACGT	Negative
AGATAGAGTGTTCGTA	Negative
AGATAGAGTTGCTTGA	Negative
AGATAGATCTTCCAGC	Negative
AGATCCAAGTTTGTCG	Negative
AGATCCACACCTGCGA	Negative
AGATCCACACGTTCGG	Hashtag9
AGATCCACAGCTTCGG	Negative
AGATCCACAGGCTCTG	Negative
AGATCCACATTGAGCT	Negative
AGATCCAGTCTAGATC	Negative
AGATCCAGTGGAGAAA	Negative
AGATCCATCAACCCGG	Hashtag9
AGATCGTCAAATGAGT	Hashtag9
AGATCGTCACACGGTC	Hashtag9
AGATCGTCATGCCGAC	Negative
AGATCGTGTACCGGAA	Negative
AGATGAAGTAACCAGG	Negative
AGATGAAGTATCGCGC	Negative
AGATGAAGTCGAATTC	Hashtag9
AGATGAATCAAAGAAC	Hashtag9
AGATGCTAGAGAGCAA	Negative
AGATGCTAGTAGGTTA	Negative
AGATGCTGTGGAACAC	Negative
AGATGCTGTGGCCTCA	Negative
AGCATCAAGCTTAAGA	Hashtag10
AGCATCACAGCAGTAG	Hashtag9
AGCATCACAGCGTAGA	Negative
AGCATCATCATCAGTG	Negative
AGCATCATCCTCGATC	Negative
AGCATCATCCTTGAAG	Negative
AGCCAATAGACCGTTT	Negative
AGCCAATAGAGAGTTT	Negative
AGCCAATCAGCATCTA	Negative
AGCCAATGTAAGTTAG	Negative
AGCCAATGTACGGTTT	Negative
AGCCAATGTATGAGAT	Negative
AGCCAATGTCTCAGAT	Hashtag9
AGCCAATTCACACGAT	Hashtag9
AGCCAATTCTGCCTGT	Hashtag9
AGCCACGAGACCTCAT	Negative
AGCCACGAGGTGTGAC	Negative
AGCCACGCAGCGGTCT	Negative
AGCCACGTCATGCCCT	Negative
AGCCAGCCAATCGCAT	Negative
AGCCAGCGTATACAGA	Negative
AGCCAGCTCCATAAGC	Hashtag9
AGCCAGCTCGAGTACT	Negative
AGCGATTGTTAGAGAT	Negative
AGCGATTTCCCATTCG	Hashtag9
AGCGATTTCGCGTGCA	Hashtag9
AGCGATTTCTGTCCGT	Hashtag9
AGCGCCAAGCGTTCAT	Hashtag9
AGCGCCAAGTTGCATC	Hashtag10
AGCGCCAGTAACGTTC	Negative
AGCGCCAGTGTTAGCT	Hashtag9
AGCGCCAGTTACCTGA	Hashtag9
AGCGCCATCAAGTCGT	Hashtag10
AGCGCCATCCATCACC	Negative
AGCGCTGCACCTGCGA	Negative
AGCGCTGGTAAGGTCG	Negative
AGCGCTGTCAGCAGAG	Negative
AGCGCTGTCCTTCTTC	Negative
AGCGCTGTCGCTTACC	Hashtag10_Hashtag9
AGCGTATAGACATGCG	Negative
AGCGTATAGACTGGGT	Negative
AGCGTATCACACACTA	Hashtag9
AGCGTATTCAAATGAG	Negative
AGCGTATTCCTAGCCT	Negative
AGCGTCGAGCTGTTCA	Hashtag9
AGCGTCGAGGAGTATT	Negative
AGCGTCGGTGCTTATG	Negative
AGCTACACACATTCGA	Negative
AGCTACACAGTCTTCC	Negative
AGCTACACATTGCAAC	Negative
AGCTACAGTATTAAGG	Negative
AGCTACAGTCAATGGG	Negative
AGCTACATCCATACAG	Hashtag9
AGCTACATCGGTATGT	Negative
AGCTCAAAGAAATTGC	Negative
AGCTCAAAGGACTAAT	Negative
AGCTCAACAGGGCTTC	Negative
AGCTCAACAGTGCGCT	Negative
AGCTCAAGTACCAATC	Negative
AGCTCAAGTCTCTCTG	Negative
AGCTCAATCTCTTCAA	Negative
AGCTTCCAGAACGTGC	Negative
AGCTTCCAGACAACAT	Negative
AGCTTCCAGCTTAGTC	Negative
AGCTTCCGTACCCAGC	Negative
AGCTTCCGTGCGAACA	Negative
AGCTTCCGTTATCTGG	Hashtag9
AGGAAATAGAAGCGGG	Negative
AGGAAATAGAGAGTTT	Negative
AGGAAATAGAGCATTA	Hashtag10_Hashtag9
AGGAAATAGGTACAAT	Hashtag9
AGGAAATCATCCGAAT	Negative
AGGAAATGTAGGACCA	Hashtag9
AGGAAATTCCGAACGC	Negative
AGGAATACAGCAAGAC	Negative
AGGAATAGTTCGTGCG	Hashtag10
AGGAATATCTGGGATT	Hashtag9
AGGAATATCTTCGTAT	Negative
AGGACGAAGAAGGATG	Negative
AGGACGACACAGACGA	Negative
AGGACGAGTAGGACTG	Negative
AGGACGAGTGTGAGCA	Negative
AGGACGATCCGGTTCT	Hashtag9
AGGACTTAGCTGTGCC	Negative
AGGACTTCATCCGTTC	Hashtag9
AGGACTTCATGTACGT	Negative
AGGACTTGTCCAACGC	Hashtag9
AGGACTTGTGTTACAC	Negative
AGGAGGTAGCGAAACC	Negative
AGGAGGTAGTAGTCAA	Negative
AGGAGGTCAAGTGGAC	Negative
AGGAGGTCAATAGAGT	Negative
AGGAGGTCACAAAGCG	Negative
AGGAGGTGTTATTCCT	Negative
AGGAGGTGTTCGGCGT	Negative
AGGAGGTTCGTAGAGG	Negative
AGGATAAAGACTACCT	Hashtag9
AGGATAAAGATTCGAA	Hashtag10
AGGATAAAGGGTGGGA	Negative
AGGATAAGTACGTAGG	Negative
AGGATAAGTCCTGTTC	Negative
AGGATAAGTGGGTATG	Hashtag10
AGGATCTAGCGGTAGT	Hashtag9
AGGATCTCAAGAATAC	Hashtag9
AGGATCTCAAGAGGTC	Hashtag9
AGGATCTTCTAATTCC	Negative
AGGATCTTCTCGAGTA	Negative
AGGCATTAGAGCCTGA	Negative
AGGCATTCAAGATGTA	Negative
AGGCATTCAGAGGTAC	Negative
AGGCATTGTAGTCTGT	Negative
AGGCATTGTATCATGC	Hashtag9
AGGCATTGTCTGCCTT	Hashtag9
AGGCATTTCCGATCTC	Negative
AGGCATTTCTACCAGA	Hashtag9
AGGCATTTCTCAAAGC	Hashtag10
AGGCCACCACAAGCCC	Negative
AGGCCACTCGACCCAG	Negative
AGGCTGCCACGACGCT	Negative
AGGCTGCCACGGTGTC	Hashtag9
AGGCTGCCATACCACA	Negative
AGGCTGCCATGGGCAA	Hashtag9
AGGCTGCGTTACCTGA	Negative
AGGGAGTAGTAATACG	Negative
AGGGAGTGTGCTTCAA	Negative
AGGGAGTTCCCGAGGT	Negative
AGGGAGTTCCTTATCA	Negative
AGGGAGTTCTGCACCT	Negative
AGGGCCTCACCAGCTG	Negative
AGGGCCTCAGTTTCGA	Hashtag9
AGGGCCTCATCATCTT	Negative
AGGGCCTGTAACCCGC	Hashtag9
AGGGCCTGTCTACGTA	Hashtag9
AGGGCCTTCGATGCAT	Hashtag9
AGGGCTCCAATTTCGG	Negative
AGGGCTCCAGACACAG	Negative
AGGGCTCGTGGAACCA	Negative
AGGGCTCTCGACTCCT	Hashtag9
AGGGCTCTCTAGTGTG	Hashtag9
AGGGCTCTCTGTGCTC	Negative
AGGGTCCGTTGTTTGG	Hashtag10
AGGGTCCTCCTTGACC	Negative
AGGGTCCTCGTTGTTT	Negative
AGGGTCCTCTGCTAGA	Negative
AGGGTGAAGCCGTAAG	Hashtag9
AGGGTGACACTGCGTG	Negative
AGGGTGAGTAAGTCAA	Negative
AGGGTGAGTAGAGATT	Negative
AGGGTGAGTAGCGTCC	Negative
AGGGTGAGTCTAATCG	Negative
AGGGTGAGTGGCGCTT	Hashtag9
AGGGTGAGTGTGTCCG	Negative
AGGGTTTAGAAGTGTT	Hashtag9
AGGGTTTAGTGCGTCC	Hashtag9
AGGGTTTCAACACAAA	Hashtag9
AGGGTTTCACCCTGAG	Hashtag9
AGGGTTTGTGGCAACA	Negative
AGGGTTTGTTACGCCG	Negative
AGGGTTTTCTGGGTCG	Negative
AGGTAGGAGACGTCGA	Negative
AGGTAGGCAACCGGAA	Negative
AGGTAGGTCCATATGG	Negative
AGGTAGGTCTTAAGGC	Hashtag10
AGGTCATAGCTCATAC	Negative
AGGTCATAGGGTGAAA	Negative
AGGTCATCACCTGCAG	Negative
AGGTCATGTGAATGAT	Negative
AGGTCATTCAACCTTT	Negative
AGGTCATTCGGTCGGT	Negative
AGGTCTAAGCGTCAAG	Negative
AGGTCTAGTAACAGGC	Negative
AGGTCTAGTACCTATG	Negative
AGGTCTAGTCAATCTG	Hashtag9
AGGTCTAGTCTTACTT	Negative
AGGTCTAGTGTTCATG	Negative
AGGTGTTCATCTGGGC	Hashtag9
AGGTGTTGTATTGCCA	Hashtag9
AGGTGTTGTCAGTTTG	Hashtag9
AGGTGTTGTGAGTCAG	Hashtag9
AGGTGTTGTTCCTAGA	Negative
AGGTTACAGAGGTTTA	Hashtag9
AGGTTACAGGCCTGCT	Negative
AGGTTACCAATGGGTG	Negative
AGGTTGTAGACTGTTC	Negative
AGGTTGTCACAAGCAG	Negative
AGGTTGTCATGACAAA	Negative
AGGTTGTGTATCACGT	Negative
AGGTTGTGTCGAATGG	Negative
AGGTTGTTCACCTGTC	Negative
AGGTTGTTCTATCACT	Hashtag9
AGGTTGTTCTGCTAGA	Negative
AGTAACCAGTAACCGG	Negative
AGTAACCCAATCTCTT	Hashtag9
AGTAACCCATGGAACG	Negative
AGTAACCCATGTCAGT	Negative
AGTAACCGTAGCGAGT	Negative
AGTAACCTCTCTGACC	Negative
AGTACCAAGCTACTGT	Hashtag9
AGTACCAAGGGAGGTG	Hashtag9
AGTACCAAGTTCATGC	Negative
AGTACCACAGTCAACT	Hashtag9
AGTACCAGTATCACGT	Hashtag10
AGTACTGGTAACCCGC	Hashtag10
AGTACTGGTACCTTCC	Hashtag9
AGTACTGGTGGCACTC	Hashtag9
AGTACTGTCCCTCGTA	Negative
AGTACTGTCGGTAGGA	Hashtag9
AGTACTGTCGTCGACG	Hashtag9
AGTACTGTCTAAGAAG	Negative
AGTAGCTAGGAGAATG	Negative
AGTAGCTAGTCGAAGC	Negative
AGTAGCTGTACCGCGT	Hashtag9
AGTAGCTGTCTGTAAC	Negative
AGTAGCTGTGGCTAGA	Hashtag9
AGTAGCTGTTTCGTAG	Negative
AGTAGCTTCGAACGGA	Negative
AGTAGCTTCGACACCG	Hashtag9
AGTAGCTTCTTACCGC	Negative
AGTAGTCCACGATTCA	Hashtag9
AGTAGTCCAGTCGAGA	Hashtag9
AGTAGTCCATTCTCCG	Hashtag9
AGTAGTCGTGTCCCTT	Hashtag9
AGTAGTCTCTAGCCTC	Hashtag9
AGTAGTCTCTGGCTGG	Hashtag10
AGTCAACAGCTAAGTA	Hashtag9
AGTCAACGTCACCCTT	Negative
AGTCAACGTTCCTTGC	Negative
AGTCAACTCGAACGGA	Negative
AGTCACAAGGCTGAAC	Hashtag9
AGTCACACAAATTGCC	Hashtag9
AGTCACACAACAACAA	Negative
AGTCACACATAATGAG	Negative
AGTCACAGTATGAGCG	Negative
AGTCACAGTCGGTGAA	Hashtag9
AGTCACAGTTGCGTAT	Negative
AGTCACAGTTTGGCTA	Hashtag10
AGTCACATCGACCATA	Hashtag9
AGTCACATCGCTCTAC	Negative
AGTCATGAGCTATCTG	Negative
AGTCATGAGTGCCTCG	Hashtag9
AGTCATGAGTTGCTCA	Negative
AGTCATGCAACTCCCT	Negative
AGTCATGGTGTTAGCT	Hashtag9
AGTCATGGTTATGACC	Hashtag9
AGTCATGTCCTCGATC	Negative
AGTCATGTCTTAGTTC	Negative
AGTCTCCAGGCCTAAG	Negative
AGTCTCCCAAGAGATT	Negative
AGTCTCCCAGTTAGGG	Hashtag9
AGTCTCCGTAATGTGA	Hashtag9
AGTCTCCGTATGCGTT	Negative
AGTCTCCGTTGACGGA	Negative
AGTCTCCTCCTAAGTG	Hashtag9
AGTCTCCTCTGAGGTT	Negative
AGTGACTAGAGTGTTA	Negative
AGTGACTAGCATACTC	Hashtag9
AGTGACTCAAATGAAC	Hashtag9
AGTGACTCACATACTG	Negative
AGTGACTCACGCGCAT	Negative
AGTGACTCACTAGAGG	Negative
AGTGACTGTATCGTGT	Hashtag9
AGTGATCAGCACCCAC	Negative
AGTGATCCATCCCACT	Negative
AGTGATCGTAGGACCA	Hashtag9
AGTGATCTCTAGTACG	Negative
AGTGCCGGTCTCAGAT	Negative
AGTGCCGGTGATGGCA	Negative
AGTGCCGGTTAGCTAC	Negative
AGTGCCGTCCGTGTCT	Negative
AGTGTTGAGAGTTGTA	Negative
AGTGTTGAGTTGCCTA	Hashtag9
AGTGTTGCAGCTCATA	Hashtag9
AGTGTTGCAGCTGAGA	Negative
AGTGTTGGTAGTTCCA	Negative
AGTGTTGGTCGGTGAA	Negative
AGTGTTGTCGGACAAG	Negative
AGTTAGCAGCCATTTG	Hashtag9
AGTTAGCCAAAGACGC	Negative
AGTTAGCCACCAGGTC	Negative
AGTTAGCGTCAGTCCG	Negative
AGTTAGCGTGGAATGC	Negative
AGTTAGCTCCCGTGAG	Negative
AGTTCCCAGACATGCG	Negative
AGTTCCCAGCATCGAG	Negative
AGTTCCCAGGTAGACC	Negative
AGTTCCCCAAGAGGTC	Negative
AGTTCCCCATTGGATC	Hashtag9
AGTTCCCGTTGCCAAT	Hashtag9
AGTTCCCTCACAAGAA	Hashtag9
AGTTCCCTCAGGACGA	Negative
AGTTCCCTCGCTGATA	Negative
AGTTCCCTCGGTAGAG	Negative
AGTTCCCTCTATACGG	Negative
AGTTCGAAGCCTGAAG	Hashtag9
AGTTCGAAGTAACGTA	Hashtag9
AGTTCGACAATCGCCG	Hashtag10
AGTTCGAGTATACGGG	Hashtag10
AGTTCGATCAAACGAA	Hashtag9
ATACCGACATTACTCT	Negative
ATACCGAGTCAACCAT	Hashtag10_Hashtag9
ATACCGAGTGAGAGGG	Negative
ATACCGATCCTATTGT	Negative
ATACCGATCTTCCTAA	Negative
ATACCTTAGAGATTCA	Hashtag9
ATACCTTAGATGCTGG	Hashtag9
ATACCTTAGGTAGTCG	Hashtag9
ATACCTTGTCAGTCCG	Negative
ATACCTTGTCGAGCTC	Negative
ATACCTTGTGCCTACG	Negative
ATACCTTGTGGCACTC	Hashtag10
ATACCTTGTTAGGCTT	Negative
ATACCTTTCCGCTGTT	Hashtag10
ATACCTTTCGGTGTTA	Negative
ATACTTCAGAACCGCA	Negative
ATACTTCAGTAGGTTA	Negative
ATACTTCAGTGTTGAA	Hashtag9
ATACTTCCAACCCTCT	Hashtag9
ATACTTCGTGCAACAG	Negative
ATACTTCGTGCGGCTT	Hashtag9
ATACTTCGTTTGGCTA	Negative
ATACTTCTCAAATGAG	Negative
ATACTTCTCATTGAGC	Negative
ATACTTCTCGCCTATC	Negative
ATACTTCTCTGCTTTA	Hashtag9
ATAGACCAGACCTCCG	Negative
ATAGACCAGCATGCGA	Hashtag9
ATAGACCAGTGGATTA	Hashtag9
ATAGACCAGTTTGAGA	Negative
ATAGACCCAAGAGCTG	Negative
ATAGACCCACCCTTGT	Hashtag9
ATAGACCCACTCTAGA	Negative
ATAGACCGTTAGAAAC	Negative
ATAGACCTCTCCCATG	Negative
ATAGAGAAGAGATGCC	Negative
ATAGAGACAGGAGGTT	Negative
ATAGAGAGTAATTAGG	Negative
ATAGAGAGTCCATCTC	Negative
ATAGGCTAGCAACTTC	Hashtag10
ATAGGCTCAGAACCGA	Hashtag9
ATAGGCTCATTACTCT	Hashtag9
ATAGGCTTCACCCTTG	Hashtag9
ATAGGCTTCACTGAAC	Hashtag9
ATAGGCTTCCTGCTAC	Hashtag9
ATAGGCTTCTGCCTCA	Hashtag9
ATAGGCTTCTTCTGGC	Hashtag9
ATATCCTAGACTTCCA	Hashtag9
ATATCCTCAAAGGAGA	Hashtag10
ATATCCTCATTCACAG	Hashtag9
ATCACAGAGATCACTC	Negative
ATCACAGCACGATTCA	Negative
ATCACAGCATCTCATT	Hashtag10
ATCACAGCATGCCGGT	Negative
ATCACAGGTGCGAACA	Negative
ATCACAGGTGTAGTGG	Negative
ATCACAGTCCAAGCAT	Negative
ATCACAGTCGGTTAGT	Negative
ATCACGAAGTTCACTG	Negative
ATCACGACACACCTTC	Hashtag9
ATCACGACAGGCGAAT	Negative
ATCACGACATACCAGT	Hashtag9
ATCACGAGTTCAACGT	Hashtag9
ATCACGATCGGAACTT	Negative
ATCACTTAGGCCCACT	Hashtag9
ATCACTTAGGCGTTAG	Negative
ATCACTTCAAATTGCC	Negative
ATCACTTGTATCAGCT	Negative
ATCACTTGTTGCTCGG	Hashtag9
ATCACTTTCACCCTTG	Negative
ATCACTTTCCAATCTT	Hashtag9
ATCACTTTCTGCGATA	Hashtag9
ATCAGGTAGAGTGACC	Hashtag9
ATCAGGTAGTTCCGGC	Negative
ATCAGGTCATAAGCGG	Hashtag9
ATCAGGTCATCTCAAG	Negative
ATCAGGTCATGTAACC	Hashtag9
ATCAGGTTCCAATGCA	Negative
ATCAGGTTCGACGCTG	Hashtag9
ATCAGGTTCGTCGGGT	Negative
ATCATTCAGCCGATTT	Hashtag10
ATCATTCCACTTGTCC	Hashtag9
ATCATTCCAGAGAAAG	Hashtag9
ATCATTCCAGTCAGTT	Negative
ATCATTCCATTCAGGT	Hashtag9
ATCATTCGTGGACCAA	Negative
ATCATTCTCGCACGGT	Negative
ATCATTCTCGGCTGTG	Negative
ATCCACCAGGACTAAT	Negative
ATCCACCCAATTTCCT	Negative
ATCCACCCAGTGCGCT	Negative
ATCCACCGTAACATGA	Hashtag9
ATCCACCGTCTCCTGT	Negative
ATCCACCGTGGAAGTC	Hashtag9
ATCCACCTCCATGAGT	Negative
ATCCATTAGAAGCTGC	Hashtag10
ATCCATTAGAGATCGC	Negative
ATCCATTAGTGTAGTA	Negative
ATCCATTCACTGGATT	Negative
ATCCATTGTTCCGCTT	Negative
ATCCATTGTTGTCATG	Negative
ATCCCTGAGAATAGTC	Negative
ATCCCTGAGCGTACAG	Negative
ATCCCTGAGTGTTCAC	Hashtag9
ATCCCTGCAACGTTAC	Negative
ATCCCTGCATCCGAAT	Hashtag9
ATCCCTGGTATTGCCA	Negative
ATCCCTGGTCTTCCGT	Hashtag9
ATCCCTGGTGATATAG	Hashtag9
ATCCCTGGTGGTTTGT	Negative
ATCCCTGGTTAAGACA	Negative
ATCCCTGTCCGAGTGC	Negative
ATCCCTGTCCTGTTAT	Hashtag9
ATCCGTCAGCTCAGAG	Negative
ATCCGTCCAATACGCT	Negative
ATCCGTCCACTATGTG	Hashtag9
ATCCGTCCAGTCGCTG	Negative
ATCCGTCGTTGCACGC	Hashtag10
ATCCTATAGCTGACAG	Hashtag9
ATCCTATCAAGTACCT	Negative
ATCCTATCAGCGGTCT	Negative
ATCCTATCAGCTTCCT	Negative
ATCCTATCATACTTTC	Negative
ATCCTATCATGAATAG	Negative
ATCCTATCATGAGTAA	Hashtag9
ATCCTATGTCTGCGCA	Negative
ATCCTATGTGATGAAT	Hashtag10
ATCCTATGTGGAACAC	Negative
ATCCTATGTTTACCAG	Hashtag9
ATCCTATGTTTGTTCT	Negative
ATCGATGAGAAACTAC	Negative
ATCGATGCAAGCAATA	Negative
ATCGATGCATAGAGGC	Negative
ATCGATGGTAACGTTC	Hashtag9
ATCGATGGTTGTTGAC	Hashtag9
ATCGCCTAGGACTATA	Hashtag9
ATCGCCTCACGGATCC	Negative
ATCGCCTGTTGTACGT	Negative
ATCGCCTTCCTCTCGA	Hashtag9
ATCGCCTTCCTTCTGG	Negative
ATCGGATAGCGTTAGG	Hashtag9
ATCGGATGTGGCTGCT	Negative
ATCGGATGTGTTTCTT	Negative
ATCGGATTCAAGAATG	Negative
ATCGGATTCGGAGTAG	Negative
ATCGGCGAGAGATCGC	Negative
ATCGGCGAGCTGCCTG	Negative
ATCGGCGGTAAGACCG	Negative
ATCGTAGGTCGGTAAG	Negative
ATCGTAGGTTACACTG	Negative
ATCGTAGTCGCTATTT	Negative
ATCGTAGTCTTGGTGA	Hashtag9
ATCGTCCAGACGCCAA	Hashtag9
ATCGTCCAGCATAGGC	Hashtag9
ATCGTCCAGCCATATC	Negative
ATCGTCCAGGAAAGTG	Negative
ATCGTCCAGGGCATGT	Negative
ATCGTCCCAAACTGCT	Negative
ATCGTCCGTGCCTAAT	Hashtag9
ATCGTCCGTTAGTTCG	Negative
ATCGTCCTCGAACCTA	Negative
ATCGTGAAGCGCTGAA	Negative
ATCGTGACAAGCAGGT	Hashtag9
ATCGTGAGTCATCGGC	Negative
ATCGTGATCGAACGCC	Hashtag9
ATCGTGATCTAGCAAC	Negative
ATCTCTAAGCCGTAAG	Hashtag9
ATCTCTAGTATCACCA	Hashtag10
ATCTCTAGTTCGGTTA	Negative
ATCTCTATCCATCTGC	Hashtag10
ATCTTCAAGGCCTAGA	Negative
ATCTTCACAACAAGAT	Hashtag9
ATCTTCACAATACAGA	Hashtag9
ATCTTCAGTAAGAACT	Negative
ATCTTCAGTACGATGG	Hashtag9
ATCTTCATCGATTGGT	Hashtag10
ATGAAAGAGTCTACCA	Negative
ATGAAAGCAATTAGGA	Negative
ATGAAAGCAGAGGCTA	Negative
ATGAAAGCAGCTACCG	Negative
ATGAAAGGTAGTCGGA	Negative
ATGAAAGGTTAAAGTG	Negative
ATGAAAGTCTCCGAAA	Negative
ATGACCAAGGCTTAGG	Hashtag9
ATGACCACAGAGTGAC	Negative
ATGACCAGTTATGGTC	Hashtag9
ATGACCATCACTGAAC	Hashtag10
ATGACCATCCAAGCAT	Hashtag9
ATGAGGGAGACTCGAG	Hashtag9
ATGAGGGAGATTGCGG	Hashtag9
ATGAGGGCAACGGCCT	Negative
ATGAGGGCAAGCGATG	Hashtag9
ATGAGGGGTCACAGTT	Negative
ATGAGGGGTGGCGTAA	Hashtag9
ATGAGGGTCATGCTAG	Hashtag9
ATGAGGGTCATTACTC	Hashtag9
ATGAGGGTCCCTCAAC	Hashtag9
ATGAGGGTCGAGCTGC	Hashtag9
ATGAGGGTCTGAGTCA	Hashtag9
ATGAGGGTCTGGCCGA	Hashtag10
ATGAGTCAGACCTCAT	Hashtag10
ATGAGTCCACGTATAC	Hashtag9
ATGAGTCGTAGGGTAC	Negative
ATGAGTCGTCGATTAC	Negative
ATGAGTCGTGAGCGAT	Negative
ATGAGTCTCGTTGTGA	Hashtag9
ATGAGTCTCTCTTCAA	Hashtag9
ATGAGTCTCTGACAGT	Negative
ATGATCGAGCTCACTA	Hashtag9
ATGATCGAGGGCTGAT	Hashtag9
ATGATCGAGTGAATAC	Negative
ATGATCGCACACAGAG	Negative
ATGATCGCACCACATA	Negative
ATGATCGCAGGTGTGA	Negative
ATGATCGCATGTCTAG	Hashtag9
ATGATCGGTCGTTATG	Negative
ATGATCGGTCTAGTGT	Negative
ATGATCGGTGGGTCAA	Negative
ATGATCGGTTCCTTGC	Hashtag10
ATGATCGTCTCAGTCC	Hashtag9
ATGCATGAGCCGGAAT	Negative
ATGCATGAGGCGAACT	Negative
ATGCATGCAGCGAACA	Negative
ATGCATGCATGAGAAT	Negative
ATGCATGGTGGGACAT	Negative
ATGCATGGTTACCTGA	Negative
ATGCATGTCATGAAAG	Negative
ATGCATGTCCTTCACG	Negative
ATGCATGTCTTAGCAG	Negative
ATGCCTCAGCTGAGTG	Hashtag9
ATGCCTCTCAAGCCAT	Negative
ATGCCTCTCGCTGATA	Negative
ATGCCTCTCGGAATTC	Negative
ATGCGATAGAAACCCG	Negative
ATGCGATGTATCCCAA	Negative
ATGCGATGTCGGAACA	Negative
ATGCGATGTTCGTACA	Negative
ATGCGATTCGCCTATC	Hashtag9
ATGCGATTCGGAATTC	Negative
ATGGAGGAGCTATCCA	Negative
ATGGAGGAGTTCGGTT	Negative
ATGGAGGCATTGCTTT	Negative
ATGGAGGTCCACTGAA	Negative
ATGGATCAGATCGCCC	Negative
ATGGATCAGCACTCGC	Hashtag9
ATGGATCAGGAATTAC	Hashtag10_Hashtag9
ATGGATCGTAGTGATA	Negative
ATGGATCGTGCTAGCC	Hashtag9
ATGGATCTCCATGCAA	Negative
ATGGATCTCGTCGACG	Negative
ATGGATCTCGTCTACC	Negative
ATGGATCTCGTGTGGC	Hashtag9
ATGGGAGCAACAAAGT	Negative
ATGGGAGGTAAGACCG	Hashtag9
ATGGGAGGTGTCCGGT	Negative
ATGGGAGTCACTGCTC	Negative
ATGGGTTCACGACGCT	Hashtag9
ATGGGTTGTATCACCA	Hashtag9
ATGGGTTTCTTACGGA	Hashtag10
ATGGGTTTCTTAGCAG	Negative
ATGGTTGCAAGGACAC	Hashtag9
ATGGTTGGTCAAGCGA	Hashtag9
ATGGTTGGTCACTACA	Negative
ATGGTTGGTGGATCAG	Hashtag9
ATGGTTGTCAGCGGAA	Negative
ATGGTTGTCATCGTAG	Negative
ATGGTTGTCGACGTCG	Negative
ATGGTTGTCTATCCAT	Hashtag9
ATGTCCCAGTGCAACG	Negative
ATGTCCCCAGGAGACT	Hashtag10
ATGTCCCGTACAGAGC	Negative
ATGTCCCGTAGTTACC	Negative
ATGTCCCTCATGGGAG	Negative
ATGTCCCTCCATTTAC	Hashtag9
ATGTCTTGTCGCGGTT	Negative
ATGTCTTGTGATTCAC	Negative
ATGTCTTGTTTCACAG	Negative
ATTACCTAGAATTTGG	Hashtag9
ATTACCTAGAGGCGTT	Negative
ATTACCTAGCCTTCTC	Hashtag9
ATTACCTAGCTCCGAC	Negative
ATTACCTAGTCCTGCG	Hashtag9
ATTACCTCAAAGAGTT	Hashtag10
ATTACCTGTGAGATAT	Hashtag10_Hashtag9
ATTACCTTCATGAAAG	Negative
ATTACCTTCGTCCATC	Negative
ATTACTCAGGTGCTTT	Hashtag9
ATTACTCCACACAGAG	Negative
ATTACTCGTAGATCGG	Hashtag9
ATTACTCGTTCGAAGG	Hashtag9
ATTACTCGTTGCTGAT	Hashtag9
ATTATCCCAGGAATAT	Negative
ATTATCCGTAGAAACT	Hashtag9
ATTATCCGTAGCACAG	Negative
ATTATCCGTGTAGTGG	Negative
ATTATCCTCAGTCTTT	Negative
ATTATCCTCCACAGGC	Negative
ATTATCCTCGGCAGTC	Negative
ATTATCCTCGTGGGTC	Negative
ATTATCCTCGTTGCCT	Negative
ATTATCCTCTCGAGTA	Negative
ATTCACTAGTTGAAAC	Negative
ATTCACTGTAGCGTAG	Hashtag9
ATTCACTGTGAGGATC	Hashtag9
ATTCACTGTGGTCTAT	Negative
ATTCACTTCCACACAA	Negative
ATTCACTTCTGTCCCA	Hashtag9
ATTCAGGAGGACTTCT	Negative
ATTCAGGAGTCGCCAC	Negative
ATTCAGGCAGTTGGTT	Hashtag9
ATTCAGGGTTAAACCC	Hashtag9
ATTCAGGTCAAGATAG	Hashtag9
ATTCAGGTCAGCTGAT	Negative
ATTCATCCAACTCATG	Hashtag9
ATTCATCGTACTCGTA	Hashtag9
ATTCATCGTGTGCTTA	Negative
ATTCATCTCGTCCTCA	Negative
ATTCCATAGCTACTGT	Hashtag9
ATTCCATAGTTAGTGA	Hashtag9
ATTCCATGTGAAGCGT	Negative
ATTCCATTCTGGCTGG	Negative
ATTCCCGAGACCATTC	Negative
ATTCCCGAGCTAAGTA	Negative
ATTCCCGAGGAACGAA	Hashtag9
ATTCCCGCACACAGAG	Hashtag9
ATTCCCGCACGTATAC	Negative
ATTCCCGGTATCCTCC	Negative
ATTCCCGGTCTTGAAC	Negative
ATTCCTAAGCCACTCG	Hashtag9
ATTCCTAGTAGGCAGT	Hashtag9
ATTCCTAGTTACAGCT	Negative
ATTCCTATCCGTAGTA	Negative
ATTCCTATCGGTAGAG	Negative
ATTCGTTCAACAAGTA	Hashtag9
ATTCGTTCACTCAGAT	Hashtag10
ATTCGTTCAGGCTTGC	Negative
ATTCGTTGTTCATCTT	Hashtag9
ATTCGTTTCGAGAACG	Negative
ATTCGTTTCTAGGCAT	Negative
ATTCTACCAAATGAAC	Negative
ATTCTACCATTGACAC	Hashtag9
ATTCTACGTACCCGAC	Hashtag9
ATTCTACGTAGATCGG	Negative
ATTCTACTCCATTTGT	Hashtag9
ATTCTACTCCGTTGGG	Negative
ATTCTTGCAACAGTGG	Hashtag9
ATTCTTGCAACTGAAA	Hashtag9
ATTCTTGCATGGGTCC	Negative
ATTCTTGGTAGCGTAG	Negative
ATTCTTGGTCTACACA	Negative
ATTCTTGGTGCAGTGA	Negative
ATTCTTGGTTCAATCG	Hashtag9
ATTCTTGTCGATACAC	Negative
ATTGGGTGTAACTGCT	Negative
ATTGGGTGTCGCTCGA	Negative
ATTGGGTGTGTTGACT	Negative
ATTGGGTGTTATCCAG	Hashtag9
ATTGGGTGTTGCAACT	Negative
ATTGGGTTCCTCTAGC	Negative
ATTGGGTTCGCCTAGG	Hashtag9
ATTGGGTTCTCACTCG	Hashtag9
ATTGTTCCAGGACGAT	Hashtag9
ATTGTTCCATACTGAC	Negative
ATTGTTCGTGTTGATC	Negative
ATTGTTCGTTGGCCTG	Negative
ATTTACCAGCGACATG	Hashtag9
ATTTACCCAACAGTGG	Hashtag9
ATTTACCGTATGGTTC	Negative
ATTTACCGTTAGAGTA	Negative
ATTTACCTCGCCGATG	Negative
ATTTCACAGAGAGGTA	Negative
ATTTCACAGGTCATAA	Negative
ATTTCACAGTCCTGCG	Negative
ATTTCACAGTGCAGGT	Hashtag9
ATTTCACGTAGAATAC	Hashtag9
ATTTCACGTCTCACGG	Hashtag9
ATTTCACTCAACCGAT	Hashtag9
ATTTCACTCGTTGTAG	Negative
ATTTCTGAGAAGCTCG	Hashtag9
ATTTCTGAGGCGTTGA	Negative
ATTTCTGAGTGCGTCC	Hashtag9
ATTTCTGGTAGTCACT	Negative
ATTTCTGGTCGCATCG	Hashtag9
ATTTCTGGTGAGATTA	Negative
ATTTCTGTCAGGAAGC	Negative
ATTTCTGTCCCTCAAC	Hashtag9
ATTTCTGTCGACGAGA	Negative
CAAAGAAAGCCGAATG	Hashtag10
CAAAGAACACTCAAGT	Hashtag9
CAAAGAACAGAGCCCT	Negative
CAAAGAACAGGACTTT	Hashtag10_Hashtag9
CAAAGAAGTTGGGTTT	Negative
CAAAGAATCCTCCACA	Negative
CAAAGAATCGTTCTCG	Negative
CAACAACGTAGGACCA	Hashtag9
CAACAACGTCAGCGTC	Negative
CAACAACTCTGGCTGG	Hashtag9
CAACAGTGTCCTCCAT	Negative
CAACAGTTCAGTGTGT	Negative
CAACAGTTCCATACAG	Negative
CAACCAAAGTGGTTCT	Hashtag9
CAACCAAAGTTACGAA	Negative
CAACCAACAAAGGCTG	Negative
CAACCAACAACCGACC	Hashtag9
CAACCAACACCCGTAG	Hashtag10_Hashtag9
CAACCAACAGACCTAT	Hashtag9
CAACCAAGTACGTTCA	Hashtag10_Hashtag9
CAACCAAGTTGTTTGG	Hashtag9
CAACCTCCAACACGAG	Negative
CAACCTCCACGGTGAA	Negative
CAACCTCCAGCTCTGG	Negative
CAACCTCTCACTACGA	Negative
CAACGATAGACTTGTC	Hashtag9
CAACGATAGGCCTGCT	Negative
CAACGATCACTAACGT	Hashtag9
CAACGATCAGAGTGTG	Negative
CAACGATGTCGTATTG	Hashtag9
CAACGATGTGTTCAGT	Negative
CAACGATTCGTGGGTC	Negative
CAACGGCCAAGTCATC	Negative
CAACGGCCAGCCTTCT	Negative
CAACGGCGTAACATCC	Negative
CAACGGCTCCTGGGTG	Negative
CAAGACTAGAATGTTG	Negative
CAAGACTCAATGAACA	Negative
CAAGACTCAGTATGAA	Negative
CAAGACTGTGGCTCTG	Negative
CAAGACTTCGTCCTTG	Negative
CAAGACTTCTAGACCA	Negative
CAAGACTTCTCATTAC	Negative
CAAGAGGAGAGTTGCG	Negative
CAAGAGGAGGAAAGTG	Negative
CAAGAGGCAACTAGAA	Hashtag10
CAAGAGGCAATGCAGG	Hashtag9
CAAGAGGCATATGGCT	Negative
CAAGAGGGTAGCGCCT	Negative
CAAGAGGGTCCACGCA	Negative
CAAGAGGGTCGTATTG	Hashtag10
CAAGAGGGTTGACTAC	Negative
CAAGAGGTCCGAAGGA	Negative
CAAGAGGTCGATAACC	Negative
CAAGAGGTCGGCTATA	Hashtag9
CAAGCTAAGCTGCCTG	Hashtag9
CAAGCTAGTAAGGCTG	Negative
CAAGCTAGTACCCGAC	Negative
CAAGCTAGTTCGCGTG	Negative
CAAGCTATCCTTGAAG	Hashtag9
CAAGCTATCGAACCTA	Negative
CAAGGGACACAAACGG	Negative
CAAGGGACAGGCCTGT	Negative
CAAGGGAGTGATACTC	Negative
CAAGGGATCGTCAAAC	Negative
CAAGGGATCGTGTTCC	Hashtag10
CAATACGAGAAGGCTC	Hashtag9
CAATACGAGGACATCG	Negative
CAATACGCACGTGTGC	Negative
CAATACGCAGTCAGCC	Hashtag10_Hashtag9
CAATACGGTAGAGATT	Hashtag9
CAATACGTCGCTCATC	Negative
CAATACGTCTGTGCAA	Negative
CAATCGACAAGTGCAG	Hashtag10
CAATCGAGTAGAGTTA	Hashtag9
CAATCGAGTCAATCTG	Hashtag9
CAATCGAGTCCGTACG	Negative
CAATCGAGTGAGTAAT	Negative
CAATCGAGTGCCTATA	Hashtag10
CAATCGATCACAGAGG	Negative
CAATCGATCCGATCGG	Hashtag9
CAATCGATCCGCAAAT	Hashtag9
CAATCGATCGTGCAGC	Hashtag9
CAATGACAGAAACTAC	Hashtag9
CAATGACCAACACAAA	Hashtag10
CAATGACCATGAGGGT	Negative
CAATGACTCGCTAGCG	Hashtag9
CAATGACTCTCTTAAC	Negative
CAATTTCAGAGTCGAC	Hashtag9
CAATTTCAGCTGTACT	Negative
CAATTTCGTAGATGTA	Negative
CAATTTCGTATGTCCA	Negative
CAATTTCGTGTCCATA	Negative
CAATTTCGTTCCGTTC	Negative
CACAACACAGATTTCG	Negative
CACAACAGTTGACTGT	Hashtag10
CACAACATCAGCTGTA	Negative
CACAACATCGCCAACG	Negative
CACACAAAGCACTAGG	Hashtag9
CACACAAAGCTGAAGC	Negative
CACACAACACGTTGGC	Negative
CACACAACAGTTAGGG	Negative
CACACAAGTATCATGC	Negative
CACACAAGTCCACATA	Negative
CACACAAGTGGCAACA	Hashtag9
CACACAAGTTCATCTT	Negative
CACACAAGTTCGGCTG	Negative
CACACAATCGCTCTCA	Negative
CACACAATCTTCTGGC	Negative
CACAGATAGACATCCT	Hashtag9
CACAGATAGGCTGGAT	Hashtag9
CACAGATAGGTGAGCT	Hashtag9
CACAGATAGTGCACCC	Negative
CACAGATCACAGAGCA	Negative
CACAGATCAGTATACC	Hashtag9
CACAGATGTCACGTGC	Hashtag9
CACAGATTCCGATTAG	Hashtag9
CACAGATTCCTACGGG	Negative
CACAGATTCGGCCCAA	Negative
CACAGGCAGTATGGCG	Hashtag9
CACAGGCCAACCGTGC	Negative
CACAGGCCATGAGTAA	Negative
CACAGGCGTGCAGTGA	Negative
CACAGGCGTGTAGTGG	Negative
CACAGGCGTTCTTAGG	Negative
CACATGAAGATGACAT	Negative
CACATGACAACAAGTA	Hashtag9
CACATGACAATCGTCA	Negative
CACATGACATGAAGGC	Hashtag9
CACATGAGTGAACGGT	Hashtag9
CACATGAGTTATGTGC	Hashtag9
CACATGATCATTGGTG	Hashtag9
CACCAAAAGCCGATCC	Negative
CACCAAAAGGGTTAAT	Negative
CACCAAAAGGTCCGAA	Negative
CACCAAACACATATGC	Negative
CACCAAAGTATGTCAC	Negative
CACCAAAGTCCTATAG	Negative
CACCAAAGTCTACAAC	Negative
CACCAAAGTCTCCTGT	Negative
CACCAAAGTGCATGTT	Hashtag9
CACCAAAGTTCCAGGC	Negative
CACCGTTAGGACTAAT	Hashtag9
CACCGTTAGGTATAGT	Hashtag9
CACCGTTCATGGAATA	Hashtag9
CACCGTTGTTGACTGT	Negative
CACCGTTTCAAAGCCT	Negative
CACCGTTTCACGATCA	Negative
CACGAATAGAAGTCAT	Negative
CACGAATAGCGAGTAC	Hashtag10
CACGAATAGGAAGTAG	Negative
CACGAATCACAGCTGC	Hashtag9
CACGAATCACGTCGTG	Negative
CACGAATGTACTAACC	Hashtag9
CACGAATGTTCAGCTA	Negative
CACGAATTCAACTTTC	Negative
CACGAATTCCTAAACG	Hashtag9
CACGAATTCGTTCTCG	Hashtag9
CACGGGTAGGTGCTGA	Negative
CACGGGTAGGTTCCGC	Negative
CACGGGTGTAGACGGT	Hashtag10
CACGGGTGTCCTGAAT	Hashtag9
CACGGGTGTCTGTTAG	Hashtag9
CACGTGGAGCTAAGTA	Hashtag10
CACGTGGCAAGTTGGG	Negative
CACGTGGCATCATTGG	Negative
CACGTGGGTCTGTCCT	Negative
CACGTTCAGCGCTTCG	Negative
CACGTTCAGGATAATC	Negative
CACGTTCAGGGTCACA	Negative
CACGTTCAGTGGATTA	Negative
CACGTTCGTTGATGTC	Negative
CACGTTCTCAGATTGC	Negative
CACTAAGAGTCGCCCA	Hashtag9
CACTAAGCACAAGTTC	Hashtag9
CACTAAGGTAAGTTGA	Hashtag9
CACTAAGGTATGTCCA	Negative
CACTAAGGTCCGACGT	Negative
CACTAAGGTGCCCGTA	Hashtag9
CACTGAACATCGATGT	Negative
CACTGAAGTAACAGGC	Negative
CACTGAAGTGGCACTC	Hashtag9
CACTGAAGTTCACGAT	Negative
CACTGAAGTTCTAAGC	Negative
CACTGGGAGGTCACAG	Negative
CACTGGGTCCGTCCTA	Negative
CACTGGGTCGACACTA	Negative
CACTGTCAGATCGCTT	Negative
CACTGTCAGCCAGTAG	Hashtag9
CACTGTCAGTATGGAT	Negative
CACTGTCGTCATCAGT	Negative
CACTGTCTCAAGTCTG	Hashtag9
CACTGTCTCCATTCAT	Hashtag9
CACTGTCTCGTCGGGT	Negative
CACTTCGCAGGAGGAG	Hashtag9
CACTTCGGTACCGTGC	Negative
CACTTCGGTAGCGCTC	Negative
CACTTCGTCAGCCTCT	Negative
CACTTCGTCATCTATC	Negative
CAGAGCCCAGTGCCTG	Negative
CAGAGCCCATGACAAA	Hashtag9
CAGAGCCGTAATTGGA	Negative
CAGAGCCGTCTGTCCT	Negative
CAGAGCCTCTCTCAAT	Negative
CAGATACAGCGTTGTT	Hashtag10_Hashtag9
CAGATACAGTAGTCAA	Negative
CAGATACCAGAGTGAC	Hashtag9
CAGATACCATTGGCAT	Hashtag9
CAGATACGTCGCACGT	Negative
CAGATACGTCGTCATA	Hashtag9
CAGATACGTCGTTCAA	Hashtag9
CAGATACGTTTCTATC	Hashtag9
CAGATACTCAACCGAT	Hashtag9
CAGATACTCCTGTAAG	Hashtag9
CAGATCAAGACCATAA	Negative
CAGATCAAGTGAGGCT	Negative
CAGATCACATGCCGGT	Negative
CAGATCACATTGACCA	Hashtag9
CAGATCAGTAGACAAT	Hashtag9
CAGATCAGTGGATCAG	Negative
CAGATTGAGAAGTCAT	Negative
CAGATTGAGCCGCACT	Negative
CAGATTGAGCTCGGCT	Negative
CAGATTGCAGTCCCGA	Negative
CAGATTGTCCCAGGAC	Hashtag9
CAGATTGTCGCTTGCT	Negative
CAGCAATAGACGCAGT	Negative
CAGCAATAGTGGTCAG	Negative
CAGCAATCAGTTCCAA	Hashtag9
CAGCAATGTAACATCC	Negative
CAGCAATGTAGGTAGC	Negative
CAGCAATGTATGAGCG	Negative
CAGCAATGTCGCAACC	Negative
CAGCAATGTTCAGCGC	Negative
CAGCAATGTTCCAAAC	Hashtag9
CAGCAATTCATTTACC	Hashtag9
CAGCAATTCTACCAGA	Negative
CAGCAATTCTCCGTGT	Hashtag10
CAGCACGCAATCCTTT	Hashtag9
CAGCACGGTATTCCTT	Negative
CAGCACGGTTGTGGAG	Negative
CAGCACGTCAGACCTA	Hashtag9
CAGCACGTCATTGCCC	Hashtag10_Hashtag9
CAGCAGCAGCACTCAT	Negative
CAGCAGCCACACAGCC	Negative
CAGCAGCCAGAGGAAA	Negative
CAGCAGCGTACTTGTG	Negative
CAGCAGCGTGTTACAC	Hashtag9
CAGCCAGCAATGGGTG	Hashtag9
CAGCCAGCACGTAACT	Negative
CAGCCAGCACTGAATC	Hashtag9
CAGCCAGCATAATGAG	Negative
CAGCCAGGTCGCGTTG	Negative
CAGCCAGTCACATCAG	Hashtag9
CAGCCAGTCTACGCGG	Negative
CAGCCAGTCTCGCCTA	Negative
CAGCGTGCATGAATCC	Negative
CAGCGTGGTACTGCGC	Hashtag9
CAGCGTGTCAAGAATG	Negative
CAGGCCACACGGGTAA	Negative
CAGGCCACACTTGAAC	Negative
CAGGCCACAGGAAGTC	Negative
CAGGCCAGTGCCCACA	Negative
CAGGCCAGTTGCACGC	Hashtag9
CAGGCCATCTGATTCT	Negative
CAGGGCTAGGATTTCC	Negative
CAGGGCTAGTAATTGG	Negative
CAGGGCTCACGACGAA	Hashtag9
CAGGGCTTCTCCGTGT	Negative
CAGGTATGTGATATAG	Hashtag9
CAGGTATTCAGTCAGT	Hashtag9
CAGTGCGAGGTTACCT	Negative
CAGTGCGCATTATGCG	Hashtag9
CAGTGCGGTAAGGTCG	Negative
CAGTTAGAGGATTTAG	Hashtag9
CAGTTAGAGTGGTCAG	Negative
CAGTTAGCACGTAGTT	Negative
CAGTTAGGTAGAGCTG	Hashtag10
CAGTTAGGTCAGTCTA	Hashtag9
CAGTTAGGTCGAGATG	Negative
CAGTTAGGTGCCCGTA	Negative
CAGTTAGGTTGCGGAA	Negative
CAGTTAGTCTCCAAGA	Negative
CAGTTCCAGGGCAACT	Negative
CAGTTCCGTATGTCCA	Hashtag9
CAGTTCCGTGGGCTCT	Hashtag9
CAGTTCCTCGTTTACT	Negative
CAGTTCCTCTGAGATC	Hashtag10
CATAAGCAGACTGAGC	Negative
CATAAGCCAGCGTTTA	Hashtag9
CATAAGCCATCCCGTT	Hashtag9
CATACAGAGCTTCGTA	Negative
CATACAGGTCGACTGC	Negative
CATACAGGTGAAGCGT	Negative
CATACAGGTTTCTTAC	Hashtag9
CATACAGTCAAAGGAT	Hashtag9
CATACAGTCGCTGACG	Hashtag9
CATACAGTCTGCTAGA	Negative
CATACCCAGGTCGTGA	Negative
CATACCCCAATTAGGA	Hashtag9
CATACCCCATTGCCTC	Hashtag9
CATACCCGTGGAAATT	Negative
CATACCCTCATAGACC	Negative
CATACTTCATGTAACC	Negative
CATACTTGTATTCCTT	Negative
CATACTTGTCTTTCTA	Negative
CATACTTGTGATAGAT	Hashtag9
CATAGACAGGTCGCCT	Negative
CATAGACCAATAAGGT	Hashtag9
CATAGACCATTGACCA	Hashtag10
CATAGACTCCAGTGCG	Negative
CATAGACTCGGCATCG	Hashtag9
CATCAAGAGGTGCGAT	Hashtag9
CATCAAGAGTCGAAAT	Hashtag10
CATCAAGCAGACACAG	Negative
CATCAAGGTCTACGAT	Negative
CATCAAGTCTTCGTAT	Negative
CATCCACAGAGATGCC	Negative
CATCCACAGCTTGTTG	Negative
CATCCACCAAGCCATT	Hashtag9
CATCCACCACTAGTAC	Hashtag9
CATCCACGTAGACACG	Hashtag9
CATCCACGTGGCCCAT	Hashtag10
CATCCACGTTATCCAG	Negative
CATCCACTCATGCCAA	Hashtag9
CATCCCAAGTAAATGC	Hashtag9
CATCCCAGTGTCCGGT	Negative
CATCCCAGTTGCGGCT	Negative
CATCCCATCCTTTAGT	Hashtag9
CATCCCATCTGAGATC	Negative
CATCCGTCAAGGCAAC	Negative
CATCCGTCATAGTCAC	Hashtag9
CATCCGTGTTATTCCT	Hashtag9
CATCCGTGTTGTGCAT	Negative
CATCCGTTCCGAGCTG	Negative
CATCCGTTCTTAAGGC	Negative
CATCGCTAGGTTTACC	Negative
CATCGCTCAGTTCTAG	Negative
CATCGCTTCAAGAGGC	Negative
CATCGGGAGAGAATCT	Negative
CATCGGGCAATCCTAG	Hashtag9
CATCGGGGTCGTATGT	Negative
CATCGGGGTGTCGATT	Negative
CATCGGGGTTGAGTCT	Hashtag9
CATCGGGTCGATTTCT	Negative
CATCGGGTCGCAGAGA	Hashtag9
CATCGTCAGACTCATC	Negative
CATCGTCAGCGACATG	Hashtag9
CATCGTCAGCTCTATG	Hashtag9
CATCGTCCAATGTCTG	Hashtag9
CATCGTCCATTATGCG	Negative
CATCGTCGTTTACCAG	Hashtag9
CATCGTCTCTAGCCTC	Negative
CATGAGTAGGGCATGT	Negative
CATGAGTCAACCGACC	Negative
CATGAGTGTCCAGCGT	Hashtag9
CATGAGTGTTTAGAGA	Hashtag9
CATGAGTTCCCATAAG	Negative
CATGCAACAGAGTTGG	Negative
CATGCAAGTCGTGCCA	Negative
CATGCAAGTGAGGATC	Negative
CATGCAAGTGGTGATG	Negative
CATGCAAGTGGTTTGT	Negative
CATGCCTAGACTAGAT	Negative
CATGCCTAGTTCGCAT	Hashtag10
CATGCCTCACACACGC	Hashtag10
CATGCCTTCATTCTTG	Negative
CATGCCTTCGGTCGGT	Negative
CATGCGGCACTGTGAT	Negative
CATGCGGCATAGAAAC	Hashtag9
CATGCGGGTACTCCCT	Hashtag9
CATGCGGGTATTTCTC	Hashtag9
CATGCGGGTTTGATCG	Hashtag9
CATGCTCCATTAAGCC	Hashtag9
CATGCTCGTACTTGTG	Negative
CATGCTCTCCGATAGT	Hashtag9
CATGCTCTCTCATAGG	Negative
CATGCTCTCTTAGCAG	Hashtag9
CATGGATAGACCAGCA	Negative
CATGGATAGAGATCGC	Hashtag9
CATGGATAGCCTGTGC	Negative
CATGGATCAGAGGTTG	Negative
CATGGATCAGGACGAT	Hashtag10
CATGGATGTACCATAC	Negative
CATGGATTCTAGGAAA	Negative
CATGGTAAGAATTTGG	Hashtag9
CATGGTAAGGCCATAG	Negative
CATGGTAAGTGTACCT	Hashtag9
CATGGTACAGCTGTAT	Hashtag9
CATGGTACATGATCTG	Hashtag9
CATGGTAGTAGATCCT	Negative
CATGGTAGTCCAGCGT	Negative
CATGGTAGTCTGCATA	Negative
CATGGTAGTGCCGAAA	Negative
CATGGTAGTTCAGCGC	Hashtag9
CATGGTATCCTTCTAA	Hashtag9
CATGGTATCGCCAACG	Hashtag9
CATTCATAGAGAGCGG	Negative
CATTCATAGCCTCTCT	Hashtag9
CATTCATCACAAATGA	Negative
CATTCATCAGTTGTTG	Negative
CATTCATGTTCCGGTG	Hashtag9
CATTCATGTTCGGTTA	Hashtag9
CATTCATGTTGAGGAC	Hashtag9
CATTCCGAGTCAGCGA	Negative
CATTCCGCACGCTGCA	Negative
CATTCCGCACTTCAGA	Negative
CATTCCGGTAACCAGG	Negative
CATTCCGGTATCGCAT	Negative
CATTCCGGTGGACAGT	Negative
CATTCCGGTGGTCTAT	Hashtag9
CATTCCGTCGATGCAT	Negative
CATTCCGTCTATGCCC	Hashtag9
CATTCTAAGGGCGAGA	Hashtag9
CATTCTACAGTCTCTC	Negative
CATTCTAGTCGTACAT	Hashtag9
CATTCTATCACATCAG	Negative
CATTCTATCACGTCCT	Negative
CATTCTATCGCTATTT	Hashtag10
CATTCTATCTAGTACG	Hashtag9
CATTGAGCAGAGCCCT	Negative
CATTGAGGTACGTTCA	Negative
CATTGCCCAAGCTGCC	Hashtag10
CATTGCCCATGAGGGT	Hashtag9
CATTGCCGTCACTCTC	Negative
CATTGCCGTCTTGAAC	Negative
CATTGCCGTGCAGTGA	Hashtag9
CATTGCCTCCTTTGAT	Negative
CATTGTTAGGCTGAAC	Negative
CATTGTTCACTACCCT	Negative
CATTGTTCAGATCCAT	Negative
CATTGTTCAGGTGAGT	Hashtag10
CATTGTTGTAGAGATT	Hashtag9
CATTGTTGTCTGTCCT	Negative
CATTGTTGTCTTCATT	Negative
CATTGTTTCCACGTGG	Negative
CATTTCAAGGATACCG	Negative
CATTTCACAATACCTG	Hashtag9
CATTTCACATACCATG	Hashtag9
CATTTCACATATCTCT	Hashtag9
CATTTCAGTGGTAATA	Negative
CCAAGCGAGAGAGGTA	Negative
CCAAGCGAGGTGCATG	Hashtag9
CCAAGCGAGTATTGCC	Hashtag9
CCAAGCGAGTCCTACA	Hashtag9
CCAAGCGCACATTCGA	Hashtag10
CCAAGCGCACGGTCTG	Negative
CCAAGCGGTGGCGTAA	Hashtag9
CCAAGCGGTTACAGCT	Negative
CCAAGCGTCAATCTTC	Negative
CCAATGAAGATTAGTG	Negative
CCAATGAAGTTACGAA	Hashtag10_Hashtag9
CCAATGACAAAGGGTC	Hashtag9
CCAATGACAAGAATGT	Hashtag9
CCAATGACAGTCTCTC	Hashtag9
CCAATGATCAAGTCTG	Negative
CCAATGATCCGGGACT	Hashtag9
CCAATGATCTTGGAAC	Hashtag9
CCAATTTAGACGGTTG	Hashtag9
CCAATTTAGCAGGGAG	Negative
CCAATTTAGCCGATCC	Negative
CCAATTTAGGGTAGCT	Hashtag9
CCAATTTGTCCCGCAA	Negative
CCAATTTTCAGGAAAT	Negative
CCAATTTTCCACTTTA	Negative
CCAATTTTCGACCCAG	Negative
CCAATTTTCGACCTAA	Negative
CCACAAAAGATGATTG	Negative
CCACAAAAGTTACGAA	Hashtag9
CCACAAACATCGCTGG	Negative
CCACACTAGGCTTAAA	Hashtag9
CCACACTAGTAGGAAG	Negative
CCACACTCAAAGGCAC	Hashtag9
CCACACTCATAGGAGC	Hashtag9
CCACACTCATGAGTAA	Hashtag10_Hashtag9
CCACACTGTAACCCGC	Hashtag9
CCACACTGTTGTAAAG	Hashtag9
CCACACTTCCTTGGAA	Hashtag10
CCACCATAGTCAAGCG	Negative
CCACCATCAGACCTGC	Negative
CCACCATGTACTCCCT	Negative
CCACCATGTCTGTGGC	Negative
CCACCATGTTTCGTTT	Negative
CCACCATTCCGTCAAA	Hashtag9
CCACCATTCTTACTGT	Hashtag10
CCACGAGAGATGCGAC	Negative
CCACGAGAGGATATGT	Negative
CCACGAGCAACGATCT	Negative
CCACGAGCAGCGGATA	Negative
CCACGAGGTCAAGGCA	Negative
CCACGAGTCCCTCATG	Negative
CCACGAGTCGGTAGGA	Negative
CCACGTTAGGCACAAC	Negative
CCACGTTCAATCGCCG	Negative
CCACGTTCAGAGGTAC	Hashtag9
CCACGTTCATAGTCGT	Hashtag9
CCACGTTCATGTACGT	Hashtag9
CCACGTTGTGGGCTCT	Negative
CCACGTTGTGTGTTTG	Hashtag10
CCACTTGAGGTGAGAA	Negative
CCACTTGAGGTTCATC	Negative
CCACTTGAGTAAACTG	Negative
CCACTTGCACCAGCCA	Negative
CCACTTGCACTGCACG	Hashtag9
CCACTTGGTGTCTAAC	Negative
CCACTTGTCACTACTT	Negative
CCACTTGTCGCGTTTC	Hashtag9
CCATAAGAGATAGTCA	Negative
CCATAAGAGCATGAAT	Hashtag9
CCATAAGAGCTAGTTC	Hashtag9
CCATAAGAGGAGTATT	Negative
CCATAAGCATAAGCGG	Hashtag9
CCATAAGGTCCAGCCA	Negative
CCATAAGTCACTCGAA	Hashtag10
CCATAAGTCATCACAG	Hashtag9
CCATCACAGCCGTAAG	Negative
CCATCACAGCTCTGTA	Negative
CCATCACCATCCGAAT	Negative
CCATCACGTCGATGCC	Negative
CCATCACTCTACCCAC	Hashtag10
CCCAACTAGCCTCGTG	Negative
CCCAACTCACGGCCAT	Negative
CCCAACTGTGCCTACG	Negative
CCCAACTGTGTGCCTG	Negative
CCCAACTTCACTTCTA	Negative
CCCAACTTCAGACCTA	Negative
CCCATTGCACAGAGCA	Negative
CCCATTGCACGTACTA	Negative
CCCATTGCAGAGCGTA	Negative
CCCATTGCAGCTGCCA	Negative
CCCATTGGTGCGCTCA	Negative
CCCATTGTCAGTCACA	Negative
CCCGAAGAGAGCATAT	Negative
CCCGAAGAGTACAACA	Hashtag9
CCCGAAGCAAGTAGTA	Negative
CCCGAAGGTACCTTCC	Hashtag9
CCCGAAGTCACAGAGG	Negative
CCCGAAGTCGAAGTGG	Negative
CCCGGAAAGTGATTCC	Hashtag10_Hashtag9
CCCGGAACAATGCAGG	Hashtag9
CCCGGAACACCGTCTT	Negative
CCCGGAACATCGATAC	Negative
CCCGGAAGTAACATCC	Negative
CCCGGAATCACGGGCT	Negative
CCCGGAATCCCGTTCA	Hashtag9
CCCGGAATCGTCGACG	Hashtag9
CCCTAACCACCCATAA	Negative
CCCTAACGTGCCGTAC	Negative
CCCTAACTCAACACCA	Negative
CCCTAACTCCTAACAG	Negative
CCCTAACTCGTACACA	Hashtag9
CCCTAACTCTAGTTCT	Negative
CCCTCAAAGGAGGGTG	Hashtag9
CCCTCAACAAGACGAC	Hashtag9
CCCTCAAGTTTACTGG	Negative
CCCTCTCAGCAACAGC	Hashtag10
CCCTCTCCAAGTCCAT	Negative
CCCTCTCCAGTGTACT	Hashtag9
CCCTCTCCATCTAACG	Hashtag9
CCCTCTCGTATGTCAC	Negative
CCCTCTCGTCCCTCAT	Hashtag9
CCCTCTCGTGTAACGG	Negative
CCCTCTCTCAGCTTGA	Negative
CCCTCTCTCCGAAATC	Negative
CCCTCTCTCTGAGGTT	Hashtag9
CCCTGATCACTTGACA	Hashtag9
CCCTGATGTAGAATAC	Hashtag9
CCCTGATGTAGCGCTC	Negative
CCCTGATTCACTTTGT	Negative
CCCTGATTCATCCTAT	Negative
CCCTGATTCCGTTGAA	Negative
CCCTTAGCAAGACGAC	Hashtag9
CCCTTAGCATACTGAC	Negative
CCCTTAGGTCATCGGC	Negative
CCCTTAGGTCCTCCAT	Negative
CCCTTAGGTGTCCGTG	Hashtag9
CCCTTAGTCCTGTAAG	Hashtag9
CCCTTAGTCCTTGACC	Negative
CCCTTAGTCGAGCACC	Hashtag9
CCGAACGCAAGCGCAA	Negative
CCGAACGCAATGACCT	Negative
CCGAACGCACAACGCC	Negative
CCGAACGCACCAGTAT	Negative
CCGAACGGTTATCCAG	Negative
CCGAACGTCAAATAGG	Hashtag9
CCGAACGTCCATCGTC	Negative
CCGAACGTCGCCTTTG	Negative
CCGAACGTCTAGAACC	Negative
CCGATCTAGACTCTAC	Negative
CCGATCTCACGTTCGG	Hashtag9
CCGATCTCAGAGCTAG	Negative
CCGATCTTCCGAAGGA	Negative
CCGATGGAGCTGAGCA	Hashtag9
CCGATGGCACAGTCGC	Negative
CCGATGGGTAGATTGA	Negative
CCGATGGTCTCAACGA	Negative
CCGCAAGAGCACCAGA	Hashtag9
CCGCAAGAGCCGATCC	Negative
CCGCAAGCAATGCAGG	Hashtag10
CCGCAAGCACCCTTAC	Hashtag9
CCGCAAGCACCGCTAG	Negative
CCGCAAGCAGAGAAAG	Negative
CCGCAAGCAGTAGAGC	Negative
CCGCAAGGTTGTCTAG	Negative
CCGCAAGTCCCTCGAT	Hashtag9
CCGGACAGTATGTCCA	Hashtag9
CCGGACAGTCTAGGTT	Hashtag9
CCGGACATCGGTATGT	Negative
CCGGGTAAGTACTGGG	Hashtag9
CCGGGTACAACCCTCT	Negative
CCGGGTACAGATCCTA	Negative
CCGGGTACATCAGCGC	Negative
CCGGGTATCATGGCCG	Negative
CCGGGTATCCAGTTCC	Negative
CCGGGTATCTTACTGT	Negative
CCGGTAGAGACCACGA	Negative
CCGGTAGAGAGATGCC	Negative
CCGGTAGAGGAACGAA	Hashtag9
CCGGTAGGTCGCCACA	Hashtag9
CCGGTAGTCGAAACAA	Negative
CCGGTAGTCGTCCTTG	Hashtag9
CCGGTAGTCTGGCTGG	Hashtag9
CCGGTGAAGTTGGACG	Negative
CCGGTGACATAATGCC	Hashtag9
CCGGTGAGTGGATGAC	Negative
CCGGTGATCATTCTTG	Hashtag9
CCGTAGGCACACCAGC	Negative
CCGTAGGCACGACCTG	Hashtag9
CCGTAGGCAGCTGTTA	Negative
CCGTAGGCATCGGAAG	Negative
CCGTAGGGTATGGTTC	Negative
CCGTAGGGTCCACATA	Hashtag9
CCGTAGGGTGCAGGAT	Hashtag9
CCGTAGGGTTGTTGAC	Negative
CCGTAGGTCGAGTCTA	Negative
CCGTGAGCACAGTATC	Hashtag9
CCGTGAGCAGGCCTGT	Hashtag9
CCGTGAGGTTAGTCGT	Negative
CCGTGAGGTTGTTGTG	Negative
CCGTGAGTCTACTATC	Negative
CCGTGAGTCTTCACGC	Hashtag9
CCGTTCAAGGTTACCT	Negative
CCGTTCACAATAGTAG	Negative
CCGTTCATCCCAATAG	Negative
CCGTTCATCTTTCTAG	Negative
CCTAACCAGGTCGAGT	Hashtag10
CCTAACCCACAACGAG	Negative
CCTAACCCAGCTGTTA	Negative
CCTAACCGTCAGTCGC	Negative
CCTAACCGTGAATTGA	Negative
CCTAACCTCAGCTGAT	Negative
CCTAACCTCATTTGCT	Negative
CCTAACCTCTGTGCTC	Negative
CCTAAGAGTACCTAGT	Negative
CCTAAGAGTGTCATGT	Negative
CCTAAGAGTTCGGACC	Hashtag9
CCTAAGATCTCGTCAC	Negative
CCTACGTCAATTCTCT	Hashtag9
CCTACGTCAGAACTCT	Negative
CCTACGTGTAACCAGG	Hashtag9
CCTACGTGTGAGATCG	Negative
CCTACGTTCAGCATTG	Negative
CCTACGTTCCCGAGAC	Hashtag10
CCTACGTTCGGCTGTG	Hashtag9
CCTATCGAGATCACCT	Negative
CCTATCGCAATCGCCG	Negative
CCTATCGCACAGTCAT	Negative
CCTATCGCAGAAGTGC	Hashtag9
CCTATCGCAGTTACCA	Negative
CCTATCGTCTGTCGCT	Negative
CCTCAACAGGTTGAGC	Negative
CCTCAACCAAATGCGG	Negative
CCTCAACGTGAACCGA	Negative
CCTCAACTCAACACCA	Hashtag9
CCTCACAAGCCTTTGA	Hashtag9
CCTCACAAGGGTTTCT	Negative
CCTCACAAGTAAGACT	Hashtag10
CCTCACAAGTCTAGCT	Negative
CCTCACACAGTAGATA	Hashtag9
CCTCACAGTAAGATCA	Hashtag10
CCTCACAGTCCACGCA	Hashtag10
CCTCACAGTGACGCCT	Negative
CCTCACAGTGAGACCA	Negative
CCTCACATCCCTGGTT	Negative
CCTCAGTAGACCATAA	Negative
CCTCAGTAGTTGAAGT	Hashtag9
CCTCAGTGTCGCCTAG	Negative
CCTCAGTGTTGGACTT	Hashtag9
CCTCAGTTCTTCCGTG	Hashtag9
CCTCATGCAAACCACT	Hashtag9
CCTCATGCAAGCGATG	Hashtag9
CCTCATGCAATTAGGA	Negative
CCTCATGCACATTCTT	Negative
CCTCATGTCAAATGCC	Negative
CCTCATGTCCACAGCG	Hashtag9
CCTCATGTCTATCCAT	Hashtag10
CCTCCAAAGAAGGGAT	Negative
CCTCCAAAGGAACATT	Negative
CCTCCAACAACAAGAT	Negative
CCTCCAACAGTCCGTG	Negative
CCTCCAAGTACGCGTC	Negative
CCTCCAAGTTGCTTGA	Negative
CCTCCTCAGGACACTG	Negative
CCTCCTCAGGCCTAAG	Negative
CCTCCTCCACTAGGCC	Hashtag9
CCTCCTCCAGCGAACA	Hashtag9
CCTCCTCCATGAATAG	Negative
CCTCCTCGTACGGATG	Hashtag9
CCTCCTCGTAGCTGAG	Negative
CCTCCTCGTCTGTCCT	Hashtag9
CCTCCTCTCAGGACAG	Negative
CCTCCTCTCCACGGGT	Hashtag9
CCTCCTCTCCTCACTG	Negative
CCTCCTCTCGACTCCT	Hashtag9
CCTCTAGAGGCATTTC	Negative
CCTCTAGCACTACGGC	Negative
CCTCTAGCATGCACTA	Negative
CCTCTAGGTAGCTTGT	Negative
CCTCTAGGTTGGAGAC	Negative
CCTCTAGTCACAATGC	Negative
CCTCTAGTCTCCTGTG	Hashtag9
CCTCTCCCAAACTCGT	Hashtag9
CCTCTCCCAATATCCG	Hashtag10
CCTCTCCGTTAGGACG	Hashtag9
CCTCTCCGTTGTTGCA	Negative
CCTCTCCTCTGACAGT	Negative
CCTGCATAGAGAGGGC	Negative
CCTGCATAGATGGTCG	Hashtag9
CCTGCATAGCCATCCG	Hashtag9
CCTGCATAGGTTCATC	Negative
CCTGCATAGTATGCAA	Hashtag9
CCTGCATCAACGTTAC	Hashtag9
CCTGCATCACTATGTG	Negative
CCTGCATCAGACATCT	Negative
CCTGCATGTCGTTGCG	Hashtag9
CCTGCATGTGACCTGC	Hashtag9
CCTGCATGTGTGTCGC	Hashtag9
CCTGCATGTTCCGGTG	Hashtag9
CCTGCATTCGCAGTTA	Negative
CCTGTTGAGACAACTA	Negative
CCTGTTGAGACCAAGC	Hashtag9
CCTGTTGAGAGGATGA	Negative
CCTGTTGAGTGAGCCA	Negative
CCTGTTGCAAGGCCTC	Hashtag9
CCTGTTGCACCGTGCA	Negative
CCTGTTGCAGTGCCTG	Hashtag9
CCTGTTGGTTAGGACG	Negative
CCTGTTGTCACCCATC	Hashtag9
CCTGTTGTCTCACTCG	Negative
CCTTCAGAGCAAGTCG	Hashtag9
CCTTCAGAGCGCACAA	Hashtag9
CCTTCAGAGCGTGAGT	Negative
CCTTCAGGTCCTGGTG	Hashtag9
CCTTCAGGTTCCCACT	Hashtag10_Hashtag9
CCTTCAGTCTGCCCTA	Negative
CCTTGTGAGAAACACT	Hashtag9
CCTTGTGAGACATACA	Negative
CCTTGTGCACGCGTGT	Hashtag10
CCTTGTGCAGGTGAGT	Negative
CCTTGTGCATCTCCCA	Hashtag9
CCTTGTGCATGCCGCA	Negative
CCTTGTGCATGTGACT	Negative
CCTTGTGGTATTTCTC	Hashtag10
CCTTGTGGTCGCCACA	Negative
CCTTGTGTCCGTCCTA	Negative
CCTTGTGTCTATCACT	Hashtag9
CCTTTGGAGAGGTCAC	Negative
CCTTTGGAGGCCACTC	Negative
CCTTTGGCACCCTTGT	Negative
CCTTTGGCAGTGTGCC	Hashtag9
CCTTTGGGTCCAAGAG	Hashtag9
CCTTTGGGTCTAGGTT	Negative
CCTTTGGGTCTGTAAC	Negative
CCTTTGGGTGCACATT	Negative
CCTTTGGTCCAGGACC	Negative
CCTTTGGTCCCAAGTA	Negative
CGAAGGACACCCTATC	Negative
CGAAGGAGTTGTCTAG	Negative
CGAAGGATCGAACTCA	Hashtag9
CGAAGTTAGTGCTCGC	Negative
CGAAGTTCACCAGACC	Negative
CGAATTGAGCATGCAG	Negative
CGAATTGAGGCAGTCA	Hashtag9
CGAATTGAGGTTACAA	Hashtag9
CGAATTGGTAGGAGGG	Hashtag9
CGAATTGGTTAAAGTG	Hashtag9
CGAATTGTCAGAGCGA	Negative
CGACAGCGTATGATCC	Hashtag9
CGACAGCGTGACTCGC	Negative
CGACAGCTCCCATAAG	Negative
CGAGAAGAGCGCAATG	Hashtag9
CGAGAAGAGTGAACAT	Hashtag9
CGAGAAGGTAACTTCG	Negative
CGAGAAGGTCCGTACG	Negative
CGAGAAGTCATGGAGG	Negative
CGAGAAGTCGGAATGG	Negative
CGAGGAAAGATGAAGG	Negative
CGAGGAACACGTTCGG	Negative
CGAGGAACATCAGTGT	Negative
CGAGGAAGTCCTGGTG	Negative
CGAGGAATCATGCGGC	Negative
CGAGGAATCTTTACAC	Negative
CGAGGCTCACCAGCCA	Negative
CGAGGCTGTATCTTCT	Hashtag9
CGAGGCTTCAGCATTG	Hashtag9
CGAGGCTTCCATTCAT	Hashtag9
CGAGTGCAGCACACCC	Hashtag10
CGAGTGCGTATCGTGT	Hashtag9
CGAGTTAAGATACAGT	Hashtag9
CGAGTTAGTGAGACGT	Negative
CGAGTTAGTTGATCGT	Hashtag10_Hashtag9
CGAGTTATCAGATTGC	Negative
CGAGTTATCATTTGGG	Negative
CGAGTTATCCTCTGCA	Hashtag9
CGAGTTATCGGTCGAC	Negative
CGATCGGAGCATTTCG	Hashtag9
CGATCGGAGGCCCAAA	Negative
CGATCGGAGTAGCAAT	Negative
CGATCGGCAGAAGTGC	Hashtag9
CGATCGGCATTCGGGC	Negative
CGATCGGGTTAGTTCG	Hashtag10
CGATCGGGTTGAAGTA	Hashtag9
CGATCGGTCCGCGAGT	Negative
CGATCGGTCCGTGTCT	Negative
CGATCGGTCCTTTGAT	Negative
CGATCGGTCGGTGCAC	Negative
CGATGCGAGCTGCGAA	Hashtag9
CGATGCGAGGACAACC	Negative
CGATGCGAGTCCCGGT	Negative
CGATGCGCAAGTCCCG	Hashtag9
CGATGCGGTACGACAG	Negative
CGATGCGGTAGTTAGA	Negative
CGATGCGGTGCAGGAT	Negative
CGATGCGGTTAAGAAC	Negative
CGATGCGTCGTCGACG	Negative
CGATGGCCATGTGCTA	Hashtag9
CGATGGCTCAGACCGC	Negative
CGCAGGTCAGTGTGCC	Hashtag9
CGCAGGTGTAGGCAAC	Negative
CGCAGGTGTTGCGGCT	Negative
CGCATAAAGCTCAGAG	Hashtag9
CGCATAACAACCAACT	Hashtag9
CGCATAACACCCATAA	Hashtag10_Hashtag9
CGCATAACACTATGTG	Negative
CGCATAACAGAGTAAT	Hashtag10_Hashtag9
CGCATAACAGTAGAGC	Negative
CGCATAAGTAACTGCT	Hashtag9
CGCATAAGTAAGAACT	Negative
CGCATAAGTCCGGTCA	Negative
CGCATAAGTGCTCGTG	Negative
CGCATAATCGAATGCT	Negative
CGCATAATCTAGACCA	Negative
CGCATGGAGAGTATAC	Hashtag9
CGCATGGCACACGGTC	Hashtag9
CGCATGGCAGCCTACG	Hashtag9
CGCATGGGTGCAATGG	Negative
CGCCAGAAGTCTAACC	Hashtag9
CGCCAGACAAGGTCAG	Negative
CGCCAGACAGCTGAGA	Hashtag9
CGCCAGAGTAATCAGA	Negative
CGCCAGAGTACCGTGC	Hashtag9
CGCCAGAGTCTAGATC	Negative
CGCCAGAGTTTCGGCG	Negative
CGCCAGATCTCGTGGG	Hashtag9
CGCCAGATCTGTACAG	Negative
CGCCATTAGGATTCAA	Hashtag9
CGCCATTCATCCTGTC	Negative
CGCCATTGTATGCGTT	Negative
CGCCATTGTGCAACGA	Negative
CGCGTGAAGATCACTC	Negative
CGCGTGAAGGAACGTC	Negative
CGCGTGACAATTGCCA	Negative
CGCGTGACACGTTGGC	Negative
CGCGTGACAGTAACGG	Hashtag9
CGCGTGATCCGTTGGG	Negative
CGCGTGATCTCAATCT	Negative
CGGAACCAGAGAGCCT	Hashtag9
CGGAACCAGCCACCGT	Hashtag9
CGGAACCAGGTAGTAT	Negative
CGGAACCCAAACCACT	Hashtag9
CGGAACCCACTGGCCA	Hashtag9
CGGAACCCATGGTGGA	Hashtag9
CGGAACCGTACGATCT	Hashtag9
CGGAACCGTATGTGTC	Negative
CGGAACCGTTCGGTCG	Negative
CGGAACCTCCCGATCT	Hashtag9
CGGAACCTCCCTTTGG	Negative
CGGAACCTCCGTGACG	Negative
CGGAACCTCGGCATTA	Negative
CGGAATTAGATGGCAC	Negative
CGGAATTAGCAACAGC	Hashtag10
CGGAATTAGCCACCGT	Negative
CGGAATTCACCATATG	Negative
CGGAATTCAGATTTCG	Negative
CGGAATTCATCGGAAG	Negative
CGGAATTGTACCTAAC	Negative
CGGAATTGTGCTGCAC	Negative
CGGAATTTCATGCAGT	Negative
CGGACACAGCAATAAC	Negative
CGGACACAGTAAACTG	Negative
CGGACACCAAATAGCA	Negative
CGGACACCAAGCTACT	Hashtag9
CGGACACCAATTCTTC	Negative
CGGACACCAGGACATG	Negative
CGGACACTCTGCCTGT	Negative
CGGAGAAAGACTGTTC	Hashtag9
CGGAGAAAGCGATCGA	Negative
CGGAGAACAAAGGATT	Hashtag9
CGGAGAACAATTGCGT	Negative
CGGAGAACATCTAGAC	Hashtag9
CGGAGAACATGTGGCC	Negative
CGGAGAAGTAGGTTTC	Negative
CGGCAGTAGCTTCATG	Negative
CGGCAGTGTAGTCGTT	Negative
CGGCAGTTCGGTCATA	Hashtag9
CGGGACTAGCGTCTCG	Hashtag9
CGGGACTCACGTGTGC	Hashtag9
CGGGACTCAGTATACC	Negative
CGGGACTGTGAGGAAA	Negative
CGGGACTTCATAGGCT	Negative
CGGGACTTCCCTCTCC	Negative
CGGGACTTCGGCATAT	Negative
CGGGACTTCTGGTGGC	Hashtag9
CGGGCATAGATGAACT	Hashtag10
CGGGCATCACGTGAGA	Negative
CGGGCATTCACGTAGT	Hashtag9
CGGGCATTCTCGGGAC	Negative
CGGGTCAAGCTCCACG	Hashtag9
CGGGTCAAGGTTGCCC	Hashtag9
CGGGTCACACAAGTTC	Hashtag9
CGGGTCACACTGAATC	Hashtag9
CGGGTCACAGCACGAA	Hashtag9
CGGGTCACATGTACGT	Hashtag10_Hashtag9
CGGGTCACATTCCTCG	Hashtag9
CGGGTCAGTCTCAGGC	Negative
CGGGTCATCAAGAATG	Negative
CGGGTGTAGGCTGTAG	Hashtag9
CGGGTGTAGTCACAGG	Negative
CGGGTGTCACCCTAGG	Hashtag9
CGGTCAGAGACTTCAC	Hashtag9
CGGTCAGAGCCATATC	Negative
CGGTCAGAGTTTCGAC	Hashtag9
CGTAAGTCACCCAACG	Negative
CGTAAGTGTCATGACT	Hashtag9
CGTAATGAGACTCCGC	Hashtag9
CGTAATGAGGCCTGAA	Negative
CGTAATGCACATCCCT	Negative
CGTAATGCATGGCTAT	Negative
CGTAATGTCACATCAG	Negative
CGTAGTAAGTGAGGTC	Hashtag10_Hashtag9
CGTAGTACAAACTAAG	Negative
CGTAGTACAACTCATG	Negative
CGTAGTACACAGACGA	Negative
CGTAGTACAGTGCGCT	Hashtag9
CGTAGTACATCCAATG	Negative
CGTAGTAGTGGCGTAA	Negative
CGTAGTAGTTCCTTGC	Hashtag9
CGTAGTAGTTCTAAGC	Hashtag9
CGTAGTATCTCGTGGG	Negative
CGTCAAAAGAGCGACT	Hashtag9
CGTCAAAAGCTATCCA	Hashtag9
CGTCAAAAGTCACTCA	Negative
CGTCAAAAGTGTTGAA	Negative
CGTCAAACAATATCCG	Negative
CGTCAAACATATGGCT	Negative
CGTCAAATCCGCAAAT	Negative
CGTCAAATCGGTGCAC	Negative
CGTCAAATCGTGAGAG	Negative
CGTCCATAGGAAAGAC	Negative
CGTCCATCAACGGCCT	Hashtag9
CGTCCATCATTACTCT	Negative
CGTCCATGTAGACACG	Negative
CGTGAATCACTGGCGT	Negative
CGTGAATCAGGATCTT	Hashtag9
CGTGAATGTCCAGCCA	Hashtag9
CGTGATACACACAGCC	Hashtag9
CGTGATATCATCCTGC	Negative
CGTGCTTAGACGAGCT	Negative
CGTGCTTAGCATGCGA	Negative
CGTGCTTAGTGATTCC	Hashtag9
CGTGCTTCATAGGCGA	Hashtag10
CGTGCTTGTGCATTTG	Hashtag9
CGTGCTTTCAACGTGT	Hashtag9
CGTGTCTAGAGTGTGC	Negative
CGTGTCTTCAGCTGAT	Negative
CGTTAGAAGACTCAAA	Negative
CGTTAGACAATAAGGT	Hashtag9
CGTTAGACACACAGAG	Negative
CGTTAGACAGGATTCT	Negative
CGTTAGACATCAGCAT	Negative
CGTTCTGAGATCCCGC	Hashtag9
CGTTCTGAGTCTCGTA	Negative
CGTTCTGGTCAGCTTA	Hashtag9
CGTTCTGTCACAGAGG	Negative
CGTTCTGTCTAGTGTG	Negative
CGTTGGGCAGTGGTGA	Negative
CGTTGGGGTAGCGATG	Negative
CTAACCCAGATCACTC	Negative
CTAACCCCAATCCTAG	Negative
CTAACCCCAGGGATAC	Hashtag9
CTAACCCTCACCACAA	Negative
CTAACCCTCAGAGTGG	Negative
CTAACCCTCGGCCTTT	Negative
CTAACCCTCTCATGCC	Negative
CTAACTTAGACATCAA	Negative
CTAACTTAGTACAGAT	Negative
CTAACTTCATGGATCT	Hashtag9
CTAACTTCATTGACCA	Hashtag9
CTAACTTGTATGGAGC	Hashtag9
CTAACTTGTTGCTCAA	Hashtag9
CTAACTTTCGAGATGG	Hashtag9
CTAAGTGAGCTTTGTG	Negative
CTAAGTGAGTAAACTG	Hashtag9
CTAAGTGTCGATAACC	Negative
CTAAGTGTCTCGGGAC	Negative
CTACAGAAGAGCTGCA	Negative
CTACAGACAGTCGCAC	Negative
CTACAGACATGGATCT	Hashtag9
CTACAGAGTGTCGCTG	Hashtag9
CTACAGAGTTGGAGAC	Hashtag9
CTACAGATCAAACTGC	Negative
CTACATTAGAGTCAAT	Hashtag9
CTACATTAGGCTGGAT	Negative
CTACATTAGGTTGGTG	Negative
CTACATTCAAACACGG	Hashtag9
CTACATTCAATTTCGG	Negative
CTACATTCAGGATTCT	Negative
CTACATTGTGCGGATA	Negative
CTACATTGTTCAAGGG	Negative
CTACATTTCGTCCATC	Negative
CTACCCAAGGATCACG	Hashtag9
CTACCCAAGGTCCGAA	Hashtag9
CTACCCACAGAGTTCT	Negative
CTACCCACAGCTCATA	Negative
CTACCCACAGGTTTAC	Negative
CTACCCACATGGGTTT	Negative
CTACCCAGTTTAGTCG	Negative
CTACCCATCCCTTGTG	Hashtag10
CTACCCATCTTTACAC	Negative
CTACCTGAGAAATGGG	Hashtag9
CTACCTGAGTTGGACG	Negative
CTACCTGCAACGATTC	Negative
CTACCTGCAATGGCCC	Negative
CTACCTGCATTGCTTT	Hashtag10_Hashtag9
CTACCTGGTAAGGAGA	Negative
CTACCTGTCTTTGATC	Negative
CTACGGGAGATCCTAC	Negative
CTACGGGAGCCAAGCA	Hashtag9
CTACGGGAGTCGAAGC	Hashtag9
CTACGGGAGTGCTCAT	Hashtag10
CTACGGGAGTGTTCCA	Negative
CTACGGGCACTCCGGA	Hashtag9
CTACGGGGTAGACAAT	Negative
CTACGGGGTCGCTCGA	Negative
CTACGGGTCCGGCAGT	Hashtag9
CTACTATCATAGACTC	Negative
CTACTATGTATTTCCT	Negative
CTACTATGTTAAACCC	Negative
CTAGACAAGAGCTGCA	Negative
CTAGACAAGGGTTAGC	Hashtag9
CTAGACACAAGGGTCA	Negative
CTAGACACATGCCATA	Hashtag9
CTAGACAGTGGGATTG	Hashtag9
CTAGACATCTGCTAGA	Hashtag10
CTAGGTAAGTAACCGG	Negative
CTAGGTAAGTTCCGGC	Negative
CTAGGTACAAAGTATG	Negative
CTAGGTACACTCTAGA	Hashtag9
CTAGGTACAGGTGTGA	Negative
CTAGGTACATGTTTGG	Negative
CTAGGTAGTGCCCACA	Hashtag9
CTATAGGAGCGCTGCT	Negative
CTATAGGCAATCCTTT	Hashtag9
CTATAGGCAGCTCGGT	Hashtag9
CTATAGGGTGTATTCG	Hashtag9
CTATAGGGTTAGGCCC	Negative
CTATAGGGTTCAACGT	Negative
CTATAGGGTTCCTAGA	Hashtag9
CTATAGGTCATCACCC	Hashtag9
CTATCCGAGTCGGCAA	Negative
CTATCCGAGTCTTCCC	Hashtag9
CTATCCGCACAGGATG	Negative
CTATCCGCACCTGCAG	Negative
CTATCCGGTGCAGTGA	Hashtag9
CTATCCGTCACTTTGT	Hashtag9
CTATCCGTCAGGAAGC	Hashtag9
CTATCTACAGTGTACT	Hashtag9
CTATCTAGTAGATTAG	Hashtag9
CTATCTAGTCGCAGTC	Negative
CTATCTAGTCTCAGGC	Negative
CTATCTAGTGCATGTT	Hashtag9
CTATCTAGTGCCTTTC	Negative
CTATCTATCAAATGAG	Negative
CTATCTATCAACCTCC	Negative
CTATCTATCATCTACT	Negative
CTATCTATCTAGTGAC	Negative
CTCAACCAGCCGAACA	Hashtag9
CTCAACCAGCCTCTCT	Hashtag9
CTCAACCAGCCTGGAA	Negative
CTCAACCAGGCGATAC	Hashtag9
CTCAACCAGTAGGGTC	Negative
CTCAACCGTTTGGCTA	Negative
CTCAACCTCCACGGGT	Hashtag9
CTCAACCTCCCGTTGT	Hashtag10
CTCAACCTCCTCACCA	Negative
CTCAACCTCTTTCTAG	Hashtag9
CTCAAGACAAATACGA	Negative
CTCAAGACAGCAAGAC	Negative
CTCAAGACATCCGATA	Hashtag9
CTCAAGATCCATACAG	Negative
CTCAAGATCGACATCA	Negative
CTCAATTAGGCTTCCG	Negative
CTCAATTTCAACCTCC	Negative
CTCACTGAGACCATTC	Negative
CTCACTGAGCTCGACC	Negative
CTCACTGCAGCTGGTC	Hashtag9
CTCACTGCATTGGCAT	Hashtag9
CTCACTGGTACGGTTT	Negative
CTCACTGGTAGGATAT	Negative
CTCACTGGTAGTACGG	Hashtag9
CTCACTGGTCATCCCT	Negative
CTCAGAAAGCCAAGTG	Hashtag9
CTCAGAAAGCTTGTGT	Hashtag9
CTCAGAACAATGACCT	Negative
CTCAGAATCCCTTTGG	Negative
CTCAGAATCGAGGCAA	Negative
CTCAGAATCTCTGGTC	Negative
CTCAGGGAGCACTCAT	Negative
CTCAGGGAGGTTGGAC	Negative
CTCAGGGAGTTGCGAG	Negative
CTCAGGGGTACTGACT	Hashtag9
CTCAGGGGTTTCGCTC	Hashtag9
CTCAGTCAGACATAAC	Negative
CTCAGTCCATTGAGGG	Hashtag9
CTCAGTCGTCATACCA	Negative
CTCAGTCGTCGTCAGC	Negative
CTCAGTCGTCGTCGGT	Negative
CTCAGTCGTGCGTGCT	Negative
CTCAGTCTCATAGCAC	Negative
CTCAGTCTCTCCAATT	Hashtag9
CTCATCGAGATGCGAC	Negative
CTCATCGCACGCGTCA	Negative
CTCATCGGTCGCTGCA	Negative
CTCATCGTCAGTCATG	Negative
CTCATCGTCGTAACCA	Negative
CTCATCGTCTCCGATC	Negative
CTCATCGTCTTCTGGC	Hashtag9
CTCATGCAGAACGTGC	Negative
CTCATGCCACTAACCA	Hashtag9
CTCATGCGTCAGTCGC	Hashtag9
CTCATGCGTTGGAGAC	Negative
CTCATTAAGACCCTTA	Hashtag9
CTCATTAAGTTCAACC	Negative
CTCATTAAGTTGGAAT	Hashtag9
CTCATTACAAGACCTT	Hashtag9
CTCATTACACTTGTGA	Negative
CTCATTAGTCATCGCG	Hashtag9
CTCATTATCACGGGAA	Hashtag9
CTCATTATCGCAATTG	Hashtag9
CTCCAACAGGGAGGCA	Hashtag9
CTCCAACAGTTGCTCA	Hashtag9
CTCCAACGTACCGCGT	Hashtag9
CTCCAACGTCAGTCCG	Negative
CTCCAACGTCGCACGT	Negative
CTCCAACGTGCCTTCT	Hashtag9
CTCCAACTCCAAGCCG	Hashtag9
CTCCAACTCTTCGGAA	Hashtag9
CTCCACAAGCCTTTCC	Hashtag9
CTCCACAAGTTAGAAC	Negative
CTCCACACACCCTGTT	Hashtag10
CTCCACAGTATACAGA	Hashtag10
CTCCACAGTGTGATGG	Hashtag9
CTCCACAGTTGCTCGG	Negative
CTCCACATCAAGGTGG	Hashtag9
CTCCACATCCGAACGC	Negative
CTCCATGAGCTCGGCT	Negative
CTCCATGCACCTGCTT	Negative
CTCCATGCATAGAATG	Hashtag9
CTCCATGGTATCTCTT	Negative
CTCCATGTCGCTACGG	Hashtag9
CTCCCAAAGAGCCGAT	Negative
CTCCCAAAGAGTCGAC	Negative
CTCCCAAGTTGACTGT	Negative
CTCCCAATCGGCTCTT	Hashtag9
CTCCCTCAGACTACCT	Negative
CTCCCTCAGATACGAT	Hashtag9
CTCCCTCAGTTACGGG	Negative
CTCCCTCCAGCTCATA	Negative
CTCCCTCGTTAATCGC	Negative
CTCCGATAGCACTGGA	Negative
CTCCGATAGGTAGCCA	Negative
CTCCGATCATTCGATG	Negative
CTCCGATGTAGTATAG	Negative
CTCCGATGTGAAGCTG	Negative
CTCCGATGTTTCGTTT	Negative
CTCCGATTCGTGGCTG	Hashtag9
CTCCTCCAGAGTAACT	Negative
CTCCTCCCAAATGCGG	Hashtag9
CTCCTCCCAACTCCAA	Hashtag10
CTCCTCCGTACCTATG	Hashtag9
CTCCTCCGTCTGTGGC	Hashtag9
CTCCTCCGTTGGCCTG	Hashtag9
CTCCTCCTCCCGAGTG	Negative
CTCCTCCTCTCGAACA	Hashtag9
CTCCTTTAGGAAGTCC	Negative
CTCCTTTCAAGCTACT	Hashtag9
CTCCTTTCACCTAAAC	Hashtag9
CTCCTTTCAGAGGTAC	Hashtag9
CTCCTTTCATGAATAG	Negative
CTCCTTTTCCCTTGTG	Hashtag9
CTCGAGGAGCCTAGGA	Hashtag9
CTCGAGGAGTCTGCGC	Hashtag9
CTCGAGGGTCAAGGCA	Negative
CTCGAGGGTCTAATCG	Hashtag9
CTCGAGGTCCAGTTCC	Hashtag9
CTCGAGGTCGGAAACG	Negative
CTCGAGGTCTACGCAA	Negative
CTCTCAGAGGTATTGA	Hashtag9
CTCTCAGAGTTGCCTA	Negative
CTCTCAGCAATGTCTG	Hashtag9
CTCTCAGTCCCTATTA	Hashtag10
CTCTCGAAGGCCTGCT	Negative
CTCTCGACAAGGATGC	Hashtag9
CTCTCGAGTTGATCGT	Negative
CTCTGGTAGAAGCGGG	Negative
CTCTGGTAGGGATCGT	Negative
CTCTGGTGTAGGAAAG	Negative
CTCTGGTGTGATAGTA	Hashtag9
CTCTGGTGTGGTAATA	Negative
CTCTGGTGTTGGTAGG	Negative
CTCTGGTTCAAGGACG	Negative
CTCTGGTTCTACTGCC	Hashtag9
CTGAATGAGTCGAATA	Hashtag10
CTGAATGAGTGAGGCT	Negative
CTGAATGCAAGCAGGT	Negative
CTGAATGGTACAAAGT	Hashtag9
CTGAATGGTAGAATAC	Negative
CTGAATGTCCAAGGGA	Negative
CTGAATGTCGCAATGT	Hashtag9
CTGAGCGAGCCTTGAT	Negative
CTGAGCGCAGTACTAC	Negative
CTGAGCGGTGAGTCAG	Negative
CTGAGCGGTTCCAGGC	Negative
CTGAGCGTCTCATAGG	Hashtag10
CTGAGCGTCTGGAGAG	Negative
CTGAGGCAGAGCTGAC	Negative
CTGAGGCAGGTTGAGC	Hashtag10
CTGAGGCAGTGATTCC	Negative
CTGAGGCAGTGGCCTC	Negative
CTGAGGCCAATACGAA	Negative
CTGAGGCCAATAGTGA	Negative
CTGAGGCCACTACAGT	Negative
CTGAGGCGTAAGATCA	Negative
CTGAGGCGTGCGAGTA	Negative
CTGAGGCGTTCTCACC	Negative
CTGAGGCTCATGCCCT	Hashtag9
CTGATCCAGATGAACT	Negative
CTGATCCAGGAACGTC	Hashtag9
CTGATCCAGGTGCCTC	Negative
CTGATCCCAGAACTCT	Negative
CTGATCCGTTGATCGT	Hashtag9
CTGATCCTCCATAGAC	Hashtag9
CTGATCCTCCCGTTGT	Hashtag9
CTGCAGGAGCGTCAAG	Hashtag9
CTGCAGGCAACCGTAT	Hashtag9
CTGCAGGGTAGTTACC	Negative
CTGCAGGGTCTACAAC	Negative
CTGCAGGGTGCGGTAA	Negative
CTGCATCAGGTGCAGT	Negative
CTGCATCCACCCTGTT	Negative
CTGCATCCACCGTGAC	Hashtag9
CTGCATCCAGCCGTCA	Hashtag9
CTGCATCCAGGCACTC	Negative
CTGCATCCAGGCGTTC	Negative
CTGCATCCAGTAACGG	Negative
CTGCATCCATTAGGCT	Negative
CTGCATCGTTGCCGAC	Hashtag9
CTGCATCTCATTATCC	Negative
CTGCATCTCGCAATGT	Negative
CTGCCATAGCGCTGAA	Negative
CTGCCATTCGACGATT	Negative
CTGCCTAAGGGTAGCT	Negative
CTGCCTACAGAACTTC	Negative
CTGCCTATCCGGGACT	Negative
CTGCGAGCATGAAGGC	Negative
CTGCGAGGTAAGCAAT	Negative
CTGCGAGGTAGTTCCA	Negative
CTGCGAGGTCGGAAAC	Negative
CTGCGAGGTTAAGGAT	Negative
CTGCGAGTCCAGCCTT	Hashtag9
CTGCGAGTCTGGCCTT	Hashtag9
CTGCTCAAGCAGGTCA	Negative
CTGCTCAAGGTTATAG	Hashtag9
CTGCTCACAAACTCGT	Hashtag9
CTGCTCACAATAGGAT	Negative
CTGCTCACATCGTGCG	Hashtag9
CTGCTCAGTAGCTTAC	Negative
CTGCTCAGTCTCGGAC	Negative
CTGCTCATCACTGATG	Negative
CTGCTCATCGACGACC	Hashtag9
CTGGACGAGGTATTGA	Hashtag9
CTGGACGCAAGAAACT	Hashtag9
CTGGACGCACGCGTCA	Hashtag9
CTGGACGCAGATCACT	Negative
CTGGACGCATGCCGCA	Hashtag9
CTGGACGGTATGAGAT	Hashtag9
CTGGACGGTCACTCAA	Negative
CTGGACGGTCCTTAAG	Negative
CTGGACGGTTGCAAGG	Hashtag9
CTGGACGTCAAACGTC	Negative
CTGGACGTCCCATTTA	Hashtag9
CTGGACGTCGATTTCT	Negative
CTGGACGTCGCTTGCT	Negative
CTGGCAGAGCCTCTTC	Negative
CTGGCAGCAACAGAGC	Negative
CTGGCAGTCTGCGGAC	Hashtag9
CTGGTCTAGTAGTCAA	Negative
CTGGTCTCAAAGCACG	Hashtag9
CTGGTCTCAAGTGCAG	Hashtag9
CTGGTCTGTGATACAA	Negative
CTGGTCTTCACCCTTG	Negative
CTGGTCTTCTCGGCTT	Negative
CTGTACCGTCAAGCGA	Hashtag9
CTGTACCGTGCCTTTC	Negative
CTGTACCGTGTATTCG	Negative
CTGTACCTCATGGAGG	Hashtag9
CTGTACCTCCACTGAA	Hashtag9
CTGTAGAAGAATCGTA	Hashtag10
CTGTAGAAGATAACGT	Hashtag9
CTGTAGAAGGATGCGT	Negative
CTGTAGAAGTCGTTAC	Negative
CTGTAGACAGCACGAA	Hashtag9
CTGTAGAGTACCGCGT	Negative
CTGTAGAGTATCTCTT	Hashtag9
CTGTAGAGTGAGTGAC	Hashtag9
CTGTAGATCACTACGA	Negative
CTGTAGATCATCGCAA	Negative
CTGTAGATCCCGAAAT	Hashtag9
CTGTATTAGTTTCGAC	Negative
CTGTATTGTATTGGCT	Negative
CTGTATTGTCATCGGC	Hashtag9
CTGTCGTAGCGGTAAC	Negative
CTGTCGTCAAACCGGA	Negative
CTGTCGTCAAACTCTG	Hashtag9
CTGTCGTCAAACTGCT	Hashtag9
CTGTCGTCAGAGTAAT	Negative
CTGTCGTGTGTCCCTT	Negative
CTGTCGTGTTGGTACT	Negative
CTGTCGTTCTGCTTAT	Negative
CTGTGAAAGGTCGTAG	Negative
CTGTGAACATCATCCC	Negative
CTGTGAAGTCACAGTT	Hashtag9
CTGTGGGCAATACCCA	Negative
CTGTGGGTCCAACTGA	Negative
CTTACCGAGTTGCATC	Hashtag9
CTTACCGCAATATCCG	Hashtag10
CTTACCGCATTGGCAT	Hashtag10
CTTACCGGTCATAGTC	Negative
CTTACCGGTCGACGCT	Negative
CTTACCGGTGCGTGCT	Hashtag9
CTTACCGTCATGCCGG	Negative
CTTACCGTCTTCTGTA	Hashtag9
CTTAGGAAGGCTCTAT	Hashtag10
CTTAGGAAGGGACACT	Negative
CTTAGGACATCAGTCA	Hashtag9
CTTAGGACATGTCTAG	Hashtag9
CTTAGGACATTAAGCC	Negative
CTTAGGAGTCACCCTT	Negative
CTTAGGAGTGGTATGG	Hashtag9
CTTAGGAGTGTGATGG	Negative
CTTAGGAGTTGGACCC	Hashtag9
CTTAGGATCCATTTGT	Hashtag9
CTTAGGATCCGAGAAG	Negative
CTTCAATAGGTCGTCC	Negative
CTTCAATAGTGAGTTA	Negative
CTTCAATGTCCGGATC	Hashtag9
CTTCAATGTCTCACGG	Hashtag9
CTTCAATGTTGTGCAT	Hashtag9
CTTCAATTCCCTTGGT	Negative
CTTCAATTCGCTAGCG	Negative
CTTCCGAAGACGCATG	Negative
CTTCCGAAGCTACAAA	Negative
CTTCCGAAGTTTCTTC	Negative
CTTCCGAGTAGGCAGT	Hashtag9
CTTCCGAGTCGTGTTA	Negative
CTTCCGAGTTGATGTC	Negative
CTTCCGAGTTGTTGCA	Negative
CTTCCGATCACTAGCA	Negative
CTTCCGATCGATCCCT	Hashtag9
CTTCCTTAGCCAGTAG	Negative
CTTCCTTAGTGGATAT	Negative
CTTCCTTCACGCAAAG	Hashtag9
CTTCCTTGTCTACAGT	Negative
CTTCCTTGTGGTAATA	Hashtag9
CTTCCTTTCAACTCTT	Negative
CTTCGGTAGAGAGCAA	Hashtag9
CTTCGGTAGGCGTTAG	Hashtag9
CTTCGGTGTTCGGGTC	Negative
CTTCGGTTCCGGCAAC	Hashtag10
CTTCGGTTCCGTAGTA	Hashtag9
CTTCGGTTCGGACTGC	Negative
CTTCTAACACCCTCTA	Hashtag9
CTTCTAAGTCTACAAC	Negative
CTTCTAATCACCTGGG	Hashtag10
CTTCTAATCAGAGTGG	Negative
CTTCTCTAGAAGTCAT	Hashtag10
CTTCTCTCATGGTGGA	Hashtag9
CTTCTCTGTGAACGGT	Hashtag9
CTTCTCTGTGGCAACA	Negative
CTTCTCTGTTGACTAC	Negative
CTTCTCTGTTGTTTGG	Negative
CTTGAGAAGAGAGTTT	Hashtag9
CTTGAGAAGTACTGTC	Hashtag10
CTTGAGACACCGTACG	Negative
CTTGAGACACTGTCGG	Hashtag9
CTTGAGACATGTGGTT	Negative
CTTGATTCACTACAGT	Hashtag9
CTTGATTGTAACTAAG	Negative
CTTGATTGTAGAGCTG	Negative
CTTGATTGTTATCTTC	Negative
CTTGATTTCCAGGACC	Negative
CTTGATTTCCTACGGG	Hashtag10
CTTGATTTCTGGGCCA	Hashtag9
CTTGATTTCTGTGCTC	Negative
CTTTCAAGTAGGACCA	Negative
CTTTCAAGTTATGTGC	Hashtag9
CTTTCAATCCCTCGAT	Negative
CTTTCGGAGGGTCTTT	Negative
CTTTCGGGTACCAATC	Hashtag10_Hashtag9
CTTTCGGGTCTACGAT	Hashtag9
CTTTCGGGTCTCGCGA	Negative
CTTTCGGGTGGACAGT	Negative
CTTTCGGTCAAGCCTA	Negative
CTTTCGGTCTGCCTGT	Hashtag10
GAAACCTAGTAACCTC	Negative
GAAACCTGTCGCAACC	Hashtag9
GAAACCTGTTTACTTC	Negative
GAAACCTTCCTTCAGC	Negative
GAAATGAAGCAATAAC	Hashtag9
GAAATGACACTAAACC	Hashtag9
GAAATGAGTGCTGTCG	Hashtag9
GAAATGAGTGGGCTTC	Negative
GAAATGATCCGAGGCT	Negative
GAAATGATCGTTGTGA	Hashtag9
GAACACTAGGCCCGTT	Negative
GAACACTCACGAGGTA	Negative
GAACACTCAGCGGTTC	Negative
GAACACTGTGGTCCGT	Hashtag9
GAACACTTCACCTCTG	Negative
GAACACTTCCAAGCTA	Negative
GAACACTTCCATTCAT	Hashtag9
GAACACTTCTCGCTCA	Negative
GAACGTTAGTAGAATC	Hashtag10_Hashtag9
GAACGTTCACTAGGCC	Negative
GAACGTTTCTTTCCAA	Negative
GAACTGTAGATCGCCC	Negative
GAACTGTAGTGCACAG	Negative
GAACTGTCAAATAAGC	Negative
GAACTGTCAATCACGT	Negative
GAACTGTCACGGTGAA	Negative
GAACTGTCAGAACTAA	Hashtag9
GAACTGTGTACCTAAC	Hashtag10
GAACTGTGTATAGGAT	Hashtag9
GAACTGTGTCTCAGGC	Negative
GAACTGTGTTGTAAAG	Negative
GAACTGTTCGAGAATA	Hashtag10_Hashtag9
GAACTGTTCGAGTACT	Negative
GAACTGTTCTTAGGAC	Negative
GAACTGTTCTTCGGAA	Hashtag9
GAACTGTTCTTGTTAC	Hashtag9
GAAGAATAGGGACACT	Negative
GAAGAATCATTACGGT	Negative
GAAGAATCATTCCTCG	Hashtag9
GAAGAATTCCTACCGT	Negative
GAAGAATTCTATCCAT	Hashtag9
GAAGCCCCAGAACTTC	Hashtag9
GAAGCCCCAGCCCAGT	Negative
GAAGCCCGTACTGTTG	Negative
GAAGCCCGTATCGAAA	Negative
GAAGCCCGTCGAATTC	Hashtag9
GAAGCCCTCAGGTAAA	Negative
GAAGCGAAGAACGCGT	Hashtag9
GAAGCGAAGCGCAATG	Negative
GAAGCGAAGTTAGAAC	Negative
GAAGCGACAAAGGCTG	Hashtag9
GAAGCGACACGCTGTG	Negative
GAAGCGACATCGAAGG	Hashtag9
GAAGCGAGTGCCCTTT	Hashtag9
GAAGCGATCGAAGCCC	Negative
GAAGCGATCGCATGAT	Negative
GAAGCGATCGTTCTAT	Negative
GAAGGACCAACACACT	Hashtag9
GAAGGACCACGACAAG	Hashtag9
GAAGGACGTAAGATTG	Negative
GAAGGACGTCAATCTG	Negative
GAAGGACGTCGAATGG	Negative
GAAGGACTCGTGCACG	Hashtag10_Hashtag9
GAAGGACTCTACGGTA	Hashtag10
GAAGGACTCTTGGTGA	Negative
GAAGGGTAGTGCTACT	Negative
GAAGGGTTCAAATGAG	Hashtag9
GAAGGGTTCCGCGAGT	Negative
GAAGGGTTCGCACGGT	Hashtag9
GAAGGGTTCGCTACGG	Negative
GAAGTAAAGTAGTCAA	Negative
GAAGTAAAGTTCCAGT	Hashtag9
GAAGTAACAAGCTGCC	Hashtag9
GAAGTAACATGACTCA	Hashtag10
GAAGTAAGTGGCGTAA	Hashtag10_Hashtag9
GAAGTAAGTTGTTGAC	Hashtag9
GAATAGAAGATTCGCT	Negative
GAATAGACAGTCTACA	Hashtag9
GAATAGAGTACTTCCC	Negative
GAATAGAGTCCTGTTC	Negative
GAATAGATCCACTAGA	Negative
GAATAGATCCGGCAGT	Negative
GAATCACAGTCAACAA	Negative
GAATCACCACCTTCCA	Negative
GAATCACCACGGCACT	Negative
GAATCACGTTTACTTC	Negative
GAATCACGTTTCGGCG	Hashtag9
GAATCACGTTTGGGTT	Negative
GAATCACTCAAGGAGC	Hashtag9
GAATCACTCCCAGTGG	Negative
GAATCACTCGACATAC	Negative
GAATCGTGTGCTCTCT	Hashtag10
GAATCGTTCTTGCGCT	Negative
GACACGCAGCTTTGTG	Hashtag9
GACACGCAGTGGAATT	Negative
GACACGCCAACTCCCT	Negative
GACACGCCACCAACAT	Hashtag9
GACACGCCACCAGCGT	Negative
GACACGCGTGAGCGAT	Negative
GACACGCGTTATCTGG	Hashtag9
GACACGCTCCTAACAG	Negative
GACAGCCAGCACTCCG	Negative
GACAGCCCAAACCGGA	Negative
GACAGCCCAAAGGCGT	Negative
GACAGCCCATCTCCCA	Hashtag9
GACAGCCGTGTCCCTT	Negative
GACAGCCTCAGCTAGT	Hashtag9
GACAGCCTCTTACCAT	Negative
GACATCAAGCAACTTC	Negative
GACATCACATCGCTAA	Negative
GACATCAGTACCCGAC	Negative
GACATCAGTAGGCTCC	Negative
GACATCAGTCATAGTC	Negative
GACATCAGTGGATGAC	Hashtag9
GACCAATAGTCACTAC	Negative
GACCAATCATGGGAAC	Negative
GACCAATTCGCTAGCG	Negative
GACCCAGCACGCACCA	Hashtag9
GACCCAGGTTAGAAAC	Negative
GACCCTTAGAAGAACG	Hashtag9
GACCCTTAGATACAGT	Hashtag9
GACCCTTAGGGAGGTG	Hashtag9
GACCCTTAGGGAGTTC	Negative
GACCCTTCAGGAATAT	Negative
GACCCTTCATCACGGC	Negative
GACCCTTGTGTTAACC	Negative
GACCCTTTCAGCCTCT	Negative
GACCCTTTCTACACTT	Negative
GACCGTGAGAGCCCAA	Negative
GACCGTGAGCAAATCA	Hashtag9
GACCGTGCACTCCTTG	Hashtag9
GACCGTGCATAGGTTC	Hashtag9
GACCGTGGTCAAATCC	Hashtag9
GACCGTGGTCCATACA	Negative
GACCGTGGTGCCCACA	Negative
GACCGTGTCATTCCTA	Negative
GACCGTGTCGCGTGAC	Hashtag9
GACCTTCAGGATACCG	Negative
GACCTTCAGTTCCGTA	Negative
GACCTTCCATGACCCG	Hashtag10
GACCTTCGTCAGACTT	Negative
GACCTTCGTGTGCCTG	Negative
GACGCTGAGACCAAGC	Negative
GACTATGAGTGGACTG	Hashtag9
GACTATGCAGAGACTG	Hashtag9
GACTATGCAGGAGACT	Hashtag9
GACTATGGTCGTATTG	Negative
GACTATGTCATCACCC	Negative
GACTCAAAGCTAGAAT	Negative
GACTCAAAGGTCTGGA	Negative
GACTCAAGTGCAGATG	Negative
GACTCTCAGATGCGAC	Hashtag9
GACTCTCAGGACGCTA	Hashtag9
GACTCTCCAACACAAA	Negative
GACTCTCCAGTTGCGC	Negative
GACTCTCCATACATCG	Negative
GACTCTCGTCTGTTAG	Negative
GACTCTCGTGCGTGCT	Negative
GACTCTCTCCCTTGTG	Negative
GACTCTCTCGCACGGT	Negative
GACTGATAGCTTTCTT	Negative
GACTGATCAGAGACTG	Hashtag9
GACTGATTCCCAAGCG	Negative
GACTGATTCCGGGACT	Hashtag9
GACTGATTCCGTATAG	Negative
GACTGATTCGTAGCTA	Negative
GACTGATTCGTCAACA	Hashtag9
GACTTCCAGATTGACA	Negative
GACTTCCAGCAAGGAA	Hashtag9
GACTTCCAGCGAATGC	Hashtag9
GACTTCCAGGGAGTGG	Hashtag9
GACTTCCCACCAGGTC	Negative
GACTTCCCAGACAAAT	Hashtag9
GACTTCCGTAAGGCTG	Hashtag9
GACTTCCTCTAGAGCT	Negative
GACTTCCTCTTCTGTA	Negative
GAGAAATCACGTATAC	Negative
GAGAAATCAGGTGAGT	Negative
GAGAAATGTAGCTTTG	Negative
GAGAAATTCGTTCATT	Negative
GAGACCCAGGTCTACT	Hashtag9
GAGACCCAGTGGATAT	Negative
GAGACCCCACTCTCGT	Negative
GAGACCCCATCCTCAC	Hashtag9
GAGACCCGTGTCCTAA	Negative
GAGACCCGTGTGTGTT	Negative
GAGACCCGTTCTCCAC	Negative
GAGACCCTCAAGTCTG	Negative
GAGACCCTCCGATCTC	Hashtag9
GAGACCCTCGAGAAAT	Negative
GAGACTTGTCCACATA	Negative
GAGACTTGTTACCCAA	Negative
GAGACTTTCGAAGCAG	Hashtag9
GAGAGGTAGACCATAA	Hashtag9
GAGAGGTAGAGTCTTC	Negative
GAGAGGTCATTCCTCG	Negative
GAGAGGTGTCTTTCTA	Negative
GAGAGGTGTGTTGCCG	Negative
GAGATGGAGACGCCCT	Hashtag9
GAGATGGAGGAACGAA	Hashtag9
GAGATGGCACAACGTT	Negative
GAGATGGCATGTCGTA	Hashtag9
GAGATGGGTAGCGCTC	Hashtag9
GAGATGGGTGACGTCC	Negative
GAGATGGTCACTCTTA	Negative
GAGATGGTCCGAGGCT	Negative
GAGATGGTCCGTCCTA	Hashtag9
GAGATGGTCGAAGCCC	Hashtag9
GAGCCTGAGGCGACAT	Negative
GAGCCTGAGGGTCTTT	Negative
GAGCCTGAGGTTTACC	Negative
GAGCCTGCAGACCAAG	Hashtag9
GAGCCTGGTAGATCGG	Hashtag9
GAGCCTGGTCCAGGTC	Negative
GAGCCTGGTGGCGCTT	Hashtag9
GAGCCTGGTGTTAAAG	Negative
GAGCCTGTCCTAGCTC	Hashtag9
GAGCCTGTCGGAATGG	Hashtag9
GAGCTGCAGTCGAAAT	Negative
GAGCTGCCAAGCTCTA	Hashtag9
GAGCTGCGTCATAAAG	Negative
GAGCTGCGTGCATGAG	Negative
GAGCTGCGTGGTCCCA	Hashtag9
GAGCTGCGTGTTGACT	Negative
GAGGCAAAGTCCTACA	Hashtag9
GAGGCAACACCGTGGT	Negative
GAGGCAACACTCAGAT	Hashtag9
GAGGCCTAGTCGCGAA	Negative
GAGGCCTGTCTACATG	Hashtag10
GAGGCCTTCGCACTCT	Negative
GAGGCCTTCGGAGTGA	Negative
GAGGCCTTCGTCGACG	Hashtag9
GAGGGATAGCCTCTGG	Hashtag10
GAGGGATAGCTGCGAA	Negative
GAGGGATCAACGTAAA	Hashtag9
GAGGGATCAATCGCAT	Hashtag9
GAGGGATGTGCCTTCT	Negative
GAGGGATGTTGGGCCT	Negative
GAGGGATTCGATACTG	Negative
GAGGGATTCGCTATTT	Negative
GAGGGTAAGATGTTCC	Hashtag9
GAGGGTACACAACGTT	Negative
GAGGGTACATGACAAA	Negative
GAGGGTAGTACCCGAC	Negative
GAGGGTAGTGGCTCTG	Hashtag10_Hashtag9
GAGGGTAGTTCAACGT	Negative
GAGGGTAGTTCTATCT	Hashtag9
GAGTCATAGGTCGACA	Hashtag9
GAGTCATAGGTGCGAT	Negative
GAGTCATAGTTGCCTA	Hashtag9
GAGTCATCAAGTGCAG	Negative
GAGTCATGTCAGATTC	Hashtag9
GAGTCATGTTATGTCG	Hashtag9
GAGTCATTCCTCGATC	Negative
GAGTCATTCGGCTCTT	Hashtag9
GAGTCATTCTGTGTGA	Negative
GAGTCTAAGAATAGTC	Hashtag9
GAGTCTAAGGACAACC	Negative
GAGTCTAAGGACAAGA	Hashtag9
GAGTCTAAGTGCCCGT	Negative
GAGTCTAGTTGATCGT	Negative
GAGTGAGAGCTAATCC	Negative
GAGTGAGCAGGCTTGC	Negative
GAGTGAGCATACATCG	Hashtag9
GAGTGAGCATGGCGCT	Negative
GAGTGAGGTACAACGG	Negative
GAGTGAGGTTGCGTAT	Hashtag9
GAGTGAGTCGAGGCAA	Hashtag9
GAGTGAGTCTGACGCG	Negative
GAGTGTTAGATTCGCT	Hashtag10
GAGTGTTTCGGTTGTA	Negative
GAGTTACAGCCAAGGT	Negative
GAGTTACCAAAGAACT	Negative
GAGTTACCAAGCGAGT	Hashtag9
GAGTTACGTGCAATAA	Negative
GAGTTACTCCATGAGT	Hashtag10
GAGTTACTCGGAGCAA	Negative
GAGTTACTCTAGGCAT	Hashtag9
GAGTTACTCTGCGGAC	Negative
GAGTTGTAGAGATCGC	Hashtag9
GAGTTGTGTCACTAGT	Hashtag9
GAGTTGTGTTGTTGAC	Hashtag9
GAGTTTGCACGAGAAC	Negative
GAGTTTGCACTGTCCT	Negative
GAGTTTGCAGGAGACT	Negative
GAGTTTGCATTCCTCG	Negative
GAGTTTGGTGGACTGA	Negative
GAGTTTGTCCTCGATC	Negative
GAGTTTGTCTACGCGG	Negative
GATAGAAAGGTGCTTT	Hashtag9
GATAGAACAATGCAAA	Negative
GATAGAACAGTCAACT	Negative
GATAGAAGTAGTGATA	Negative
GATAGAAGTTAGGCCC	Hashtag9
GATAGAATCAGCTAGT	Negative
GATAGAATCGGTGTTA	Hashtag9
GATAGCTCACAGCCAC	Negative
GATAGCTCAGTCAACT	Hashtag9
GATAGCTGTCCCACGA	Negative
GATAGCTGTGCAGTGA	Negative
GATAGCTTCCCATTCG	Negative
GATAGCTTCTGAATCG	Negative
GATCACAAGATCCTAC	Hashtag9
GATCACAAGGTAACTA	Negative
GATCACACAATATCCG	Hashtag9
GATCACAGTCTTCGAA	Hashtag9
GATCACAGTTGACTAC	Hashtag9
GATCACAGTTGCATTG	Negative
GATCAGTCACCAGCTG	Negative
GATCAGTGTATGGTAA	Negative
GATCAGTGTCTCCTGT	Hashtag9
GATCAGTGTTTCAGAC	Hashtag10
GATCAGTTCAAGTCGT	Hashtag9
GATCAGTTCACAATGC	Negative
GATCAGTTCTAGATCG	Negative
GATCATGAGCGCCGTT	Hashtag9
GATCATGAGTATAACG	Negative
GATCATGAGTTCTCTT	Hashtag9
GATCATGCAACTGCTA	Hashtag9
GATCATGCAATTTCCT	Negative
GATCATGCACGAAAGC	Hashtag9
GATCATGCACGGGTAA	Hashtag9
GATCATGCAGCAGACA	Negative
GATCATGGTACAGAGC	Hashtag9
GATCATGGTTATGTGC	Negative
GATCATGTCACACCGG	Negative
GATCATGTCGATAACC	Hashtag9
GATCCCTAGTTCGCAT	Negative
GATCCCTCATAGAGGC	Negative
GATCCCTGTTGTGTTG	Negative
GATCCCTTCCTCACGT	Negative
GATCCCTTCGAGTGAG	Negative
GATCCCTTCTGGCCTT	Negative
GATCGTACATGTGGTT	Hashtag9
GATCGTAGTGTGTACT	Hashtag9
GATCGTATCCATACTT	Hashtag9
GATCGTATCCGTGTGG	Negative
GATCGTATCGCACGAC	Negative
GATCGTATCGGTGCAC	Hashtag9
GATCGTATCTCATGGA	Hashtag9
GATCGTATCTGATTCT	Hashtag9
GATGACTCAGCCTATA	Negative
GATGACTTCCTTTAGT	Hashtag9
GATGAGGAGAAACACT	Negative
GATGAGGAGAAGGATG	Hashtag9
GATGAGGAGTAGCTCT	Negative
GATGAGGCAAGGCCTC	Negative
GATGAGGCAATTGCCA	Negative
GATGAGGCACATGTTG	Hashtag9
GATGAGGGTTCTCCCA	Negative
GATGAGGGTTGTTGCA	Negative
GATGAGGTCAGATGCT	Negative
GATGAGGTCGCTCATC	Negative
GATGAGGTCGGTCAGC	Hashtag9
GATGAGGTCTCTCTTC	Negative
GATGAGGTCTGTGCGG	Hashtag9
GATGATCCACGACAAG	Negative
GATGATCCACGAGGAT	Negative
GATGATCCAGATCCAT	Negative
GATGATCCAGGCATGA	Negative
GATGATCCATAATGAG	Negative
GATGATCGTCGTCGGT	Hashtag9
GATGATCTCCGCACGA	Negative
GATGCTAGTCCTCATC	Hashtag9
GATGCTAGTGCATTAC	Negative
GATGCTATCCAAGAGG	Hashtag9
GATGCTATCCATGAGT	Negative
GATGCTATCCCGTTGT	Negative
GATGCTATCCTTATCA	Hashtag9
GATGGAGAGCTTTCCC	Negative
GATGGAGCAAGCGATG	Hashtag9
GATGGAGCAAGTGACG	Negative
GATGGAGCACAAGCCC	Hashtag10_Hashtag9
GATGGAGCACAGAGCA	Hashtag9
GATGGAGGTATGACAA	Hashtag9
GATGGAGGTCCAGTTA	Hashtag9
GATGGAGGTTTACACG	Hashtag10
GATGTTGAGCAGATAT	Hashtag9
GATGTTGAGTGCAAAT	Hashtag9
GATGTTGAGTTCACTG	Negative
GATGTTGGTCATCCGG	Hashtag9
GATGTTGTCCGAGAAG	Negative
GATGTTGTCGCTTGCT	Negative
GATTCGAAGCCATCCG	Hashtag9
GATTCGAAGGAACGAA	Negative
GATTCGAAGTCACTAC	Negative
GATTCGAGTCACTGAT	Negative
GATTCGAGTCTTACAG	Hashtag9
GATTCGATCAAGAATG	Negative
GATTCGATCACCTGTC	Negative
GATTCGATCGCCCAGA	Negative
GATTCTTAGCGTTACT	Negative
GATTCTTAGGGAGGCA	Hashtag9
GATTCTTAGTAGTCTC	Hashtag9
GATTCTTGTACGGGAT	Hashtag9
GATTCTTGTAGACAGC	Hashtag9
GATTCTTGTCCGGACT	Hashtag9
GATTGGTAGCCTTTGA	Hashtag9
GATTGGTCAGAACTCT	Hashtag9
GATTGGTCAGTCGAGA	Negative
GATTGGTGTTTACTGG	Negative
GATTGGTTCTCGTTTA	Hashtag9
GATTTCTAGCATCTTG	Hashtag9
GATTTCTAGGACAACC	Hashtag9
GATTTCTAGTTCGGTT	Negative
GATTTCTCAGCTCCTT	Hashtag9
GATTTCTCAGGAGGTT	Hashtag9
GATTTCTCAGGTACGA	Negative
GATTTCTGTATCGAGG	Hashtag9
GATTTCTGTCTGTCCT	Hashtag9
GCAACATAGACGGATC	Hashtag9
GCAACATAGCTCAGAG	Negative
GCAACATAGTCATCGT	Negative
GCAACATAGTTCCTGA	Hashtag9
GCAACATCACAGCGCT	Negative
GCAACATCAGACCTAT	Negative
GCAACATCAGCCCACA	Negative
GCAACATCATCCTTGC	Hashtag10_Hashtag9
GCAACATGTACGGTTT	Negative
GCAACATGTGAGACGT	Hashtag9
GCAACATTCAGTGATC	Negative
GCAACATTCGTCTCAC	Hashtag9
GCAACCGAGCCTTTCC	Negative
GCAACCGAGGTTCATC	Negative
GCAACCGAGTCCGCCA	Hashtag9
GCAACCGCACAGTACT	Hashtag9
GCAACCGCATTGACCA	Hashtag9
GCAACCGGTCTACTGA	Negative
GCAACCGGTCTCACAA	Negative
GCAACCGTCGAGAATA	Hashtag9
GCAACCGTCGTAGTGT	Hashtag9
GCACATAAGCACCGAA	Negative
GCACATAAGGCCTTCG	Negative
GCACATAAGGGCAGAG	Negative
GCACATAAGTTTGAGA	Negative
GCACATAGTAGACACG	Hashtag9
GCACATAGTGTAACGG	Negative
GCACATAGTTAAGCAA	Negative
GCACATAGTTAAGGGC	Negative
GCACATATCAAGCTTG	Hashtag9
GCACATATCACTCACC	Hashtag9
GCACGGTCAGAGTGTG	Hashtag9
GCACGGTGTCGTGTTA	Negative
GCACGGTTCAGGAACG	Negative
GCACGGTTCGGTAGAG	Negative
GCACGGTTCTCTGGTC	Negative
GCACGTGAGCTACAAA	Negative
GCACGTGCAACATACC	Negative
GCACGTGCAGGTATGG	Negative
GCACGTGCATCGGAGA	Negative
GCACGTGGTCCCTCAT	Hashtag10_Hashtag9
GCACGTGGTGAATGTA	Hashtag10_Hashtag9
GCACGTGTCGAAGCCC	Negative
GCACGTGTCGGTAGGA	Hashtag10
GCACTAAGTGGTAACG	Negative
GCACTAATCAGTGATC	Hashtag9
GCAGCCAAGGCATTTC	Negative
GCAGCCAAGGCTCACC	Negative
GCAGCCAAGGTCTGGA	Negative
GCAGCCACAAGCGATG	Hashtag9
GCAGCCAGTAACAGTA	Negative
GCAGCCAGTGGACTAG	Negative
GCAGCCATCTTTCCGG	Hashtag9
GCAGCTGAGGCCTTGC	Hashtag9
GCAGCTGCAAACTGCT	Negative
GCAGCTGGTCGTTTCC	Negative
GCAGCTGGTGTTCGTA	Negative
GCAGGCTCATGTAACC	Negative
GCAGGCTGTGCGGATA	Negative
GCAGGCTGTGGTATGG	Negative
GCAGGCTGTTCTGAGT	Hashtag9
GCAGGCTTCGCAGATT	Hashtag10_Hashtag9
GCAGGCTTCGGCTGTG	Negative
GCAGTTACAGGAATAT	Negative
GCAGTTACATGAAAGT	Negative
GCAGTTACATGTCGTA	Hashtag9
GCAGTTATCTTACGGA	Negative
GCATCGGAGACGACTG	Negative
GCATCGGAGTGAGCCA	Negative
GCATCGGCAAGCTGCC	Negative
GCATCGGCAGTGTATC	Negative
GCATCGGGTACTAACC	Negative
GCATCGGGTCACCACG	Hashtag9
GCATCGGTCCATCTGC	Hashtag9
GCATCGGTCGCCTAGG	Hashtag9
GCATCTCAGAGATGCC	Hashtag10
GCATCTCAGTGATTCC	Hashtag9
GCATCTCCATTCAGCA	Hashtag9
GCATCTCGTCAAAGAT	Negative
GCATCTCGTCGTGATT	Negative
GCATCTCGTTCTTAGG	Hashtag9
GCATCTCTCACCATGA	Negative
GCATCTCTCCAAATGC	Negative
GCATCTCTCCACGGAC	Hashtag9
GCATGATAGGTAATCA	Hashtag9
GCATGATAGGTCCGAA	Negative
GCATGATAGTATCCTG	Hashtag9
GCATGATCATCTTCGC	Hashtag9
GCATGATGTCCCTGTT	Negative
GCATGATGTGACGCCT	Negative
GCATGATGTGGTATGG	Negative
GCATGATTCAAACGTC	Hashtag9
GCATGATTCTTCGACC	Negative
GCATTAGCATCTTAGG	Hashtag9
GCATTAGGTATGAAGT	Hashtag10
GCATTAGTCACCACAA	Hashtag9
GCATTAGTCCCTCTCC	Hashtag9
GCATTAGTCGCAGATT	Negative
GCCAACGAGCTGTTCA	Hashtag9
GCCAACGCACAGAAGC	Negative
GCCAACGTCGTGTGGC	Hashtag9
GCCAGCAAGAGGTTAT	Hashtag9
GCCAGCAAGCAGTACG	Negative
GCCAGCACAATCGCAT	Negative
GCCAGCACAGAGGCTA	Hashtag9
GCCAGCAGTGACTCTA	Negative
GCCAGCAGTTCTATCT	Hashtag9
GCCAGCATCATCCCGT	Hashtag9
GCCAGGTAGACGCAGT	Negative
GCCAGGTAGCAATAAC	Hashtag9
GCCAGGTCAGATCCTA	Negative
GCCAGGTCAGGTACGA	Hashtag9
GCCAGGTCATCCGGCA	Hashtag9
GCCAGGTGTCATGCAT	Negative
GCCAGGTGTGACTATC	Negative
GCCAGGTGTGTTATCG	Hashtag9
GCCAGGTGTTGCCGAC	Hashtag9
GCCAGGTTCACACGAT	Hashtag9
GCCAGGTTCCATGATG	Negative
GCCAGTGAGCTCGTGC	Hashtag9
GCCAGTGAGCTGGAGT	Hashtag9
GCCAGTGAGTGTCATC	Negative
GCCAGTGGTAAGATCA	Negative
GCCAGTGGTTCTCAGA	Negative
GCCATGGAGAACAGGA	Hashtag9
GCCATGGAGAAGGATG	Hashtag10
GCCATGGAGTAACCTC	Negative
GCCATGGAGTGTACAA	Hashtag9
GCCATGGCAACGCATT	Negative
GCCATGGCATCGGAAG	Negative
GCCATGGGTGAATATG	Negative
GCCATGGGTGATACCT	Negative
GCCATGGGTTGCTCCT	Hashtag9
GCCATGGTCGAAGGAC	Negative
GCCATGGTCGTGTGGC	Negative
GCCATTCCACTTGGGC	Hashtag9
GCCATTCCATGTTCGA	Hashtag9
GCCATTCGTGAGGCAT	Negative
GCCATTCGTGTATACC	Negative
GCCATTCGTTATAGCC	Hashtag9
GCCATTCTCAGCTGTA	Negative
GCCATTCTCATACGAC	Hashtag9
GCCATTCTCGCAATGT	Negative
GCCCAGAAGCCGATTT	Hashtag9
GCCCAGAAGGTGCCAA	Negative
GCCCAGAAGTGTACCT	Hashtag10_Hashtag9
GCCCAGAGTCACTTAG	Hashtag9
GCCCAGAGTGGAACAC	Negative
GCCCAGAGTGTCGCTG	Hashtag9
GCCCAGATCCTAGCTC	Negative
GCCCAGATCCTGTTAT	Hashtag9
GCCCGAAAGCACGTCC	Hashtag9
GCCCGAAAGCCTCAGC	Negative
GCCCGAAAGTCTTCGA	Negative
GCCCGAACACATCATG	Hashtag9
GCCCGAAGTAGGTGCA	Negative
GCCCGAAGTCGACGCT	Negative
GCCCGAAGTGTTATCG	Hashtag9
GCCCGAATCCGCATAA	Hashtag9
GCCGATGAGGCCTTGC	Hashtag9
GCCGATGGTCGAGCAA	Negative
GCCGATGTCATGCGGC	Negative
GCCGATGTCGGACTTA	Hashtag9
GCCGTGAAGCTGGTGA	Hashtag9
GCCGTGAGTGGCTTAT	Negative
GCCGTGATCGTAGAGG	Hashtag9
GCCTGTTAGCAAGTGC	Negative
GCCTGTTGTAGTATAG	Hashtag9
GCCTGTTGTGGTCTCG	Hashtag9
GCCTGTTGTTGAATCC	Negative
GCCTGTTTCAAAGAAC	Hashtag10
GCCTGTTTCGCGTGAC	Negative
GCGAGAAAGACCAACG	Negative
GCGAGAAAGCATACTC	Hashtag9
GCGAGAAAGCCATTGT	Negative
GCGAGAAAGGGTCACA	Negative
GCGAGAAAGGTCGACA	Negative
GCGAGAACAGAGTTCT	Hashtag10
GCGAGAACATGTGTCA	Negative
GCGAGAAGTCTCAGGC	Negative
GCGAGAAGTTGCTTGA	Negative
GCGATCGAGCCAAGGT	Hashtag10
GCGATCGAGGTCCGAA	Negative
GCGATCGCAAGAGGTC	Negative
GCGATCGCAATGTCAC	Hashtag9
GCGATCGCAGCTGAAG	Hashtag9
GCGATCGCAGGCATGA	Hashtag9
GCGATCGGTGCTCTCT	Negative
GCGATCGTCAACTGAC	Negative
GCGATCGTCAATCCGA	Negative
GCGGAAACAGTTTCAG	Negative
GCGGAAACATCCGATA	Hashtag9
GCGGAAAGTTGCGGCT	Hashtag9
GCGGAAATCGGTGTTA	Hashtag9
GCGGAAATCTGTGCGG	Negative
GCGGATCAGTACAGAT	Hashtag9
GCGGATCCACAAAGCG	Negative
GCGGATCCACAACGTT	Hashtag9
GCGGATCCATCGATCA	Negative
GCGGATCGTTGACGGA	Negative
GCGGATCTCATTGCTT	Negative
GCGGATCTCGATGCTA	Hashtag10_Hashtag9
GCGGATCTCTATCGCC	Negative
GCGTGCAAGTAGCATA	Negative
GCGTGCACACGGTAGA	Hashtag9
GCGTGCACAGTTTCGA	Negative
GCGTGCACATCAGTCA	Negative
GCGTGCAGTGCACATT	Negative
GCGTGCATCATGCAGT	Hashtag9
GCGTGCATCTAGCCTC	Negative
GCGTGCATCTTACCAT	Negative
GCGTGCATCTTACGTT	Hashtag9
GCGTGCATCTTCACGC	Negative
GCGTTTCAGTAAGCAT	Negative
GCGTTTCAGTGGATTA	Negative
GCGTTTCCACAATGAA	Hashtag9
GCGTTTCGTAGTCGTT	Negative
GCGTTTCTCATGCCAA	Negative
GCGTTTCTCCACAAGT	Hashtag9
GCGTTTCTCGGTGCAC	Hashtag9
GCTACAAAGTTGGCGA	Negative
GCTACAACATGAAGCG	Negative
GCTACAAGTCATATGC	Hashtag9
GCTACAATCACAAGGG	Negative
GCTACAATCCGAACGC	Negative
GCTACCTCAAACCATC	Hashtag9
GCTACCTCAGCCTTCT	Negative
GCTACCTGTCGAAACG	Negative
GCTACCTGTGTGGTCC	Hashtag9
GCTCAAAAGGAATGTT	Hashtag9
GCTCAAACAGTAGTGG	Hashtag9
GCTCAAAGTACTGACT	Negative
GCTCAAAGTGTCTCCT	Negative
GCTCAAATCCAAGCAT	Negative
GCTCAAATCCTCCACA	Negative
GCTGAATAGTGTGTTC	Negative
GCTGAATCACAGAAGC	Negative
GCTGAATCAGCGGATA	Negative
GCTGAATGTACTGACT	Hashtag9
GCTGAATGTATGGGAC	Negative
GCTGAATGTGCGACAA	Negative
GCTGAATTCCATAGGT	Hashtag9
GCTGCAGAGAACTTCC	Hashtag9
GCTGCAGGTGACTCGC	Negative
GCTGCAGTCATTTGTC	Negative
GCTGCAGTCCCGAGTG	Negative
GCTGCAGTCTCGAACA	Negative
GCTGGGTAGCTCGAAG	Negative
GCTGGGTAGCTTTGTG	Hashtag9
GCTGGGTGTGCTTCAA	Negative
GCTGGGTGTGTTCGAT	Hashtag9
GCTGGGTTCACTCTTA	Hashtag10
GCTGGGTTCTGAGGCC	Hashtag9
GCTTCACCAGTACTAC	Hashtag9
GCTTCACGTGAAGCTG	Negative
GCTTCACTCGACCCAG	Hashtag9
GCTTCACTCTCCGAGG	Negative
GCTTGGGAGGTGGCTA	Negative
GCTTGGGAGTGGTCAG	Negative
GCTTGGGAGTTGGCGA	Negative
GCTTGGGGTTCGGTAT	Negative
GCTTGGGTCAAGGTGG	Hashtag9
GCTTTCGAGACAAGCC	Hashtag9
GCTTTCGAGACGAGCT	Negative
GCTTTCGAGCATCAAA	Hashtag9
GCTTTCGAGCGCCATC	Negative
GCTTTCGAGCGGTATG	Negative
GCTTTCGGTCGTGATT	Negative
GCTTTCGGTCTTACAG	Negative
GGAACCCAGCGTATGG	Hashtag9
GGAACCCAGCTCCGAC	Negative
GGAACCCGTGGATCAG	Hashtag9
GGAACCCTCACTGGTA	Hashtag10
GGAAGTGAGCTCGACC	Negative
GGAAGTGCAAGGAGTC	Negative
GGAAGTGCAATTGCTG	Negative
GGAAGTGGTCAATGGG	Hashtag9
GGAAGTGTCACAAGGG	Negative
GGAAGTGTCCGTATGA	Hashtag9
GGAATCTAGAATGTTG	Negative
GGAATCTAGCAATAAC	Negative
GGAATCTAGGTACCTT	Hashtag10
GGAATCTCAGGTGGAT	Negative
GGAATCTGTAAGCGGT	Negative
GGAATCTGTGCCCAGT	Negative
GGAATGGAGCCTGACC	Negative
GGAATGGAGCCTGTCG	Negative
GGAATGGCATCCGGCA	Negative
GGAATGGGTCTCGGAC	Negative
GGACGTCAGCGTATGG	Negative
GGACGTCAGGGATGTC	Hashtag9
GGACGTCAGTTGGCTT	Negative
GGACGTCCATCTTAGG	Negative
GGACGTCGTATCTTCT	Negative
GGACGTCTCACTGTCC	Negative
GGACGTCTCCTGGTCT	Negative
GGACGTCTCGACACCG	Hashtag10_Hashtag9
GGAGAACAGTCACTGT	Negative
GGAGAACAGTGAGCCA	Negative
GGAGAACCAACAGTGG	Negative
GGAGATGCACTACCGG	Hashtag10_Hashtag9
GGAGATGCATGCTGCG	Negative
GGAGATGCATTAGGCT	Negative
GGAGATGGTACGGTTT	Negative
GGAGATGGTTGGGCCT	Negative
GGAGATGTCTATGCCC	Hashtag9
GGAGATGTCTGGTGCG	Hashtag9
GGAGCAACACTATCCC	Negative
GGAGCAAGTAGATGTA	Hashtag9
GGAGCAAGTCGTACAT	Hashtag9
GGAGCAAGTTCAAAGA	Negative
GGAGCAAGTTCGAACT	Negative
GGAGGATAGACCATTC	Hashtag9
GGAGGATAGTTGTAAG	Hashtag9
GGAGGATCATTGTACG	Negative
GGAGGATTCATCGTAG	Negative
GGAGGTAAGATTGGGC	Hashtag9
GGAGGTAAGGCTCACC	Negative
GGAGGTACAGCTGAAG	Negative
GGAGGTAGTCTCTCAC	Negative
GGAGGTATCATGGGAG	Hashtag9
GGAGGTATCTAGACCA	Negative
GGATCTAAGGCGTTAG	Hashtag9
GGATCTAAGTCTTCGA	Hashtag9
GGATCTAGTGGTCTGC	Negative
GGATCTAGTGTCTTGA	Negative
GGATCTATCCGTCCTA	Negative
GGATCTATCCTACGGG	Negative
GGATGTTCAATCGCAT	Negative
GGATGTTGTAGGCAAC	Negative
GGATGTTGTTAACAGA	Negative
GGATGTTTCTGTCTCG	Hashtag9
GGCACGTCAAGACTGG	Negative
GGCACGTTCTTTGGAG	Hashtag9
GGCAGTCAGAGTTGTA	Negative
GGCAGTCCAAATCGGG	Negative
GGCAGTCCACCCAAGC	Hashtag9
GGCAGTCCACTGTCGG	Negative
GGCAGTCGTGCTGATT	Negative
GGCGTCAAGATGGGCT	Negative
GGCGTCAAGTCTCCTC	Negative
GGCGTCAAGTCTGCAT	Negative
GGCGTCAAGTGTTCCA	Negative
GGCGTCAAGTTTCGGT	Negative
GGCGTCACACATGACT	Hashtag9
GGCGTCAGTCTTAGTG	Hashtag9
GGCGTCAGTGTGTCCG	Negative
GGCGTCAGTTCGAAGG	Negative
GGCTGTGAGCTGAGCA	Negative
GGCTGTGAGGATACGC	Hashtag9
GGCTGTGCACGATTCA	Negative
GGCTGTGGTAGGCTGA	Hashtag9
GGCTTGGAGCGGTATG	Hashtag10_Hashtag9
GGCTTGGCAAATTGGA	Negative
GGCTTGGCAACATCGT	Hashtag9
GGCTTGGCATGGAATA	Negative
GGCTTGGGTCCAGCGT	Hashtag9
GGCTTGGTCGCCTAGG	Hashtag9
GGCTTTCAGCAGATAT	Hashtag9
GGCTTTCAGTGCAACG	Negative
GGCTTTCCACGTCGGT	Hashtag10
GGCTTTCCATCAGCAT	Negative
GGCTTTCGTGGCGTAA	Hashtag9
GGCTTTCGTTCCTACC	Negative
GGCTTTCGTTGAGTCT	Negative
GGCTTTCTCAACCCGG	Hashtag9
GGCTTTCTCGCTCTCA	Negative
GGGAAGTAGACATATG	Hashtag9
GGGAAGTAGTTCCGTA	Hashtag9
GGGAAGTCAATTGGTC	Negative
GGGAAGTCAGAGATTA	Hashtag9
GGGAAGTCAGCCCAGT	Hashtag9
GGGAAGTGTGCCGAAA	Hashtag9
GGGAAGTTCCCATAAG	Hashtag9
GGGACAAAGGACGCAT	Negative
GGGACAAAGGCCACCT	Negative
GGGACAAAGTCTGTAC	Negative
GGGACAAGTCACATTG	Hashtag9
GGGACAAGTCCTCAGG	Negative
GGGACAATCATGCATG	Negative
GGGACAATCGCGGTAC	Negative
GGGACAATCTTCGCTG	Hashtag10
GGGACCTCAGCGCTTG	Hashtag9
GGGACCTCATCGGAAG	Negative
GGGACCTGTACCTTCC	Negative
GGGACCTGTCTCGACG	Hashtag9
GGGACCTGTGCTGCAC	Negative
GGGACCTGTTATAGAG	Negative
GGGACTCCAAACCACT	Negative
GGGACTCCACTGTCCT	Negative
GGGACTCCAGCTCTGG	Negative
GGGACTCCAGCTGTTA	Negative
GGGACTCTCAGCCCAG	Hashtag9
GGGAGATCACAGTACT	Negative
GGGAGATGTCGAGTGA	Hashtag10
GGGAGATGTGCTAGCC	Negative
GGGAGATGTGTTAGCT	Negative
GGGAGTAGTACGTGTT	Hashtag9
GGGAGTATCAATCTTC	Negative
GGGATCCAGGCACTCC	Negative
GGGATCCCACCTGCGA	Negative
GGGATCCCATATGCGT	Hashtag9
GGGATCCCATCAACCA	Negative
GGGATCCGTCATCAGT	Hashtag9
GGGATCCGTGGCTTGC	Negative
GGGATCCGTTCGTGCG	Negative
GGGATCCTCACCGCTT	Negative
GGGATGAAGAGAGGGC	Negative
GGGATGAAGCACCTGC	Negative
GGGATGAAGCATCGAG	Hashtag9
GGGATGACAACGTATC	Negative
GGGATGACAATAGTAG	Negative
GGGATGACACAACGTT	Negative
GGGATGACAGTGCGCT	Negative
GGGATGAGTACCCGAC	Negative
GGGATGAGTAGTCTGT	Negative
GGGATGATCACCGCTT	Hashtag9
GGGATGATCCCGTTGT	Negative
GGGCCATAGCAAGTCG	Hashtag9
GGGCCATCACACCAGC	Negative
GGGCCATCATCTCAAG	Negative
GGGCCATCATTATGCG	Hashtag9
GGGCCATGTAGTGTGG	Negative
GGGCCATGTTTCACAG	Negative
GGGCCATTCCAAAGGG	Hashtag9
GGGCCATTCTGCGATA	Negative
GGGCCATTCTGGGTCG	Hashtag9
GGGCCATTCTGTCCGT	Hashtag9
GGGCGTTAGACATACA	Hashtag9
GGGCGTTAGCTTTGTG	Negative
GGGCGTTAGGAACGCT	Negative
GGGCGTTCAAAGGTTA	Hashtag9
GGGCGTTCAGAAGCTG	Negative
GGGCGTTCATTGTACG	Hashtag9
GGGCGTTGTAGCCCTG	Hashtag9
GGGCGTTGTCACATTG	Negative
GGGCGTTTCGAACCTA	Negative
GGGCGTTTCGATAACC	Hashtag9
GGGCGTTTCGCTGCGA	Hashtag9
GGGCTACAGGATTACA	Hashtag9
GGGCTACAGTTGGACG	Negative
GGGCTACAGTTGGCTT	Negative
GGGCTACCACTACAGT	Negative
GGGCTACGTGGTATGG	Hashtag9
GGGCTACTCAACACCA	Hashtag9
GGGCTCAAGGTGATCG	Hashtag9
GGGCTCACAACGACAG	Negative
GGGCTCAGTCGGATTT	Negative
GGGTAGAAGGGATCAC	Hashtag9
GGGTAGAAGTAGGAAG	Negative
GGGTAGAAGTGGAAGA	Negative
GGGTAGAGTCGTCATA	Hashtag9
GGGTAGAGTGGCTACC	Negative
GGGTAGATCCGCACGA	Negative
GGGTAGATCCTGGTCT	Hashtag9
GGGTATTAGGTGAGCT	Negative
GGGTATTAGTTGGGAC	Hashtag9
GGGTATTCAAGAGTAT	Negative
GGGTATTTCTGTGCAA	Hashtag9
GGGTCACAGCCGATCC	Negative
GGGTCACAGGCTCTCG	Hashtag9
GGGTCACCACCAGTTA	Negative
GGGTCACGTACGGCAA	Negative
GGGTCACGTCAGGAGT	Negative
GGGTCACGTCCACTTC	Negative
GGGTCTGAGGAACTAT	Negative
GGGTCTGCAAGCGGAT	Negative
GGGTCTGCACTGTGTA	Hashtag9
GGGTCTGCAGCTTCGG	Hashtag9
GGGTCTGTCGAGATAA	Hashtag9
GGGTGAAAGACAACAT	Negative
GGGTGAACAAGAAACT	Negative
GGGTGAACACCTGATA	Hashtag9
GGGTGAAGTCAAATCC	Negative
GGGTGAAGTTAAGACA	Hashtag9
GGGTGAAGTTCCGCAG	Negative
GGGTGAATCAACGAGG	Hashtag9
GGGTGTCAGAATTGTG	Negative
GGGTGTCAGTATTCCG	Negative
GGGTGTCCAGTAGAAT	Negative
GGGTGTCCATGTCAGT	Negative
GGGTGTCTCAACCGAT	Hashtag9
GGGTGTCTCTCGGTAA	Negative
GGGTTATCATACCGTA	Negative
GGGTTATTCTTGGTCC	Hashtag9
GGGTTTAAGTGGGAAA	Negative
GGGTTTAGTAAGACCG	Negative
GGGTTTAGTATCATGC	Hashtag10
GGGTTTAGTCAATGGG	Hashtag9
GGGTTTAGTGCAGTGA	Negative
GGGTTTATCCACGTAA	Hashtag9
GGGTTTATCCATGATG	Negative
GGTAACTAGCCTTGAT	Hashtag9
GGTAACTAGCGTCGAA	Hashtag9
GGTAACTAGTCTGTAC	Negative
GGTAACTCACGGTGAA	Negative
GGTAACTGTGCTTATG	Negative
GGTAACTTCATGGTAC	Negative
GGTAACTTCTGAGATC	Hashtag9
GGTAACTTCTGGGCCA	Negative
GGTAATCAGACTCATC	Negative
GGTAATCCACCAGCGT	Hashtag9
GGTAATCCAGGGACTA	Negative
GGTAATCGTCGTATTG	Negative
GGTAATCGTTCCAAAC	Hashtag9
GGTAATCTCAAAGACA	Negative
GGTAGAGAGAGAGGGC	Hashtag9
GGTAGAGTCACGATCA	Negative
GGTAGAGTCCTTCACG	Negative
GGTAGAGTCGACATTG	Negative
GGTCACGGTCGAATTC	Hashtag9
GGTCACGGTGGCTAGA	Negative
GGTCACGGTTCTTAGG	Hashtag9
GGTCACGGTTCTTGCC	Negative
GGTCACGGTTGTTTGG	Negative
GGTCACGTCTGGCCGA	Hashtag9
GGTCTGGAGAGAGTTT	Hashtag9
GGTCTGGAGTAACCTC	Negative
GGTCTGGGTGAGCTCC	Negative
GGTCTGGGTGTGAATA	Negative
GGTCTGGGTTAAGCAA	Negative
GGTCTGGGTTAAGTCC	Hashtag9
GGTCTGGTCAAGTCTG	Negative
GGTGAAGAGACTTCGT	Hashtag9
GGTGAAGAGGAAGAAC	Hashtag9
GGTGAAGCACGACCTG	Hashtag9
GGTGAAGCACGAGGAT	Negative
GGTGAAGCAGCGATTT	Negative
GGTGAAGTCGGTGTAT	Hashtag9
GGTGATTAGCCTGACC	Negative
GGTGATTAGTCAGCGA	Negative
GGTGATTCACTGTGAT	Negative
GGTGATTCATAGAATG	Negative
GGTGATTGTACTGCCG	Negative
GGTGATTGTTTGGGAG	Negative
GGTGATTTCAACCGAT	Hashtag9
GGTGATTTCACCTGGG	Negative
GGTGATTTCGTAGTGT	Negative
GGTGATTTCTCCCATG	Hashtag9
GGTGGCTAGAACAGGA	Negative
GGTGGCTCATTCCTCG	Negative
GGTGGCTGTCTTCAAG	Hashtag9
GGTGGCTGTTGTGGCC	Negative
GGTGGCTTCTGGGATT	Negative
GGTGTCGCAAAGCAAT	Hashtag9
GGTGTCGCAAGCTGTT	Negative
GGTGTCGCATCGTTCC	Negative
GGTGTCGGTCGCTTGG	Negative
GGTGTCGGTTGCTCCT	Negative
GGTGTTAAGCGTTCCG	Hashtag10
GGTGTTAAGGACAGCT	Negative
GGTGTTAAGTGCACAG	Negative
GGTGTTACACTACCGG	Negative
GGTGTTACACTGTGAT	Negative
GGTGTTACATGAATAG	Negative
GGTGTTAGTAACATAG	Hashtag9
GGTGTTAGTGTTTACG	Negative
GGTGTTATCCCATAGA	Hashtag9
GGTGTTATCTGCGGGT	Hashtag9
GGTTAACAGAAACCCG	Hashtag9
GGTTAACCAACCGTAT	Negative
GGTTAACCACTGTGTA	Negative
GGTTAACCATCGTCCT	Negative
GGTTAACGTACGGATG	Hashtag9
GGTTAACTCACTTATC	Negative
GGTTAACTCAGCGCAC	Hashtag9
GGTTAACTCATCTATC	Hashtag9
GGTTCTCAGCCAGAGT	Negative
GGTTCTCAGTACCGGA	Negative
GGTTCTCAGTGATTCC	Hashtag9
GGTTCTCCAAATCCCA	Hashtag9
GGTTCTCCACAACATC	Hashtag9
GGTTCTCGTACGGCAA	Hashtag9
GGTTCTCTCAGATGCT	Negative
GGTTCTCTCCACTTCG	Negative
GGTTCTCTCCCAAGCG	Negative
GGTTGTAAGATGCGAC	Negative
GGTTGTAAGCATGCGA	Hashtag9
GGTTGTACACGACAGA	Negative
GGTTGTACACTGAGTT	Hashtag10
GGTTGTACATTACTCT	Negative
GGTTGTAGTAGTGATA	Hashtag10
GGTTGTAGTCCAGGTC	Hashtag9
GGTTGTAGTCTTTCAT	Negative
GGTTGTATCCTCTCGA	Negative
GTAACACAGCAGCACA	Negative
GTAACACAGCGTGAAC	Hashtag9
GTAACACGTACTCAAC	Hashtag9
GTAACACGTCCGCAGT	Negative
GTAACACGTCGCCTAG	Hashtag9
GTAACCAAGGTAGTAT	Hashtag9
GTAACCACACTCCGGA	Negative
GTAACCATCGTCTAAG	Hashtag9
GTAAGTCAGCACTTTG	Negative
GTAAGTCCAAGACGGT	Negative
GTAAGTCCAAGGCTTT	Negative
GTAAGTCCACGATTCA	Hashtag9
GTAATCGAGCCTTTGA	Negative
GTAATCGCAATCTAGC	Negative
GTAATCGGTAAGATCA	Hashtag10
GTAATCGGTTACTCAG	Negative
GTAATCGTCATGAGAA	Hashtag9
GTAATGCAGAGTGTTA	Negative
GTAATGCAGTCTTCCC	Negative
GTAATGCTCCTGTTGC	Hashtag10_Hashtag9
GTAATGCTCGATACAC	Hashtag9
GTAATGCTCGTGGCGT	Negative
GTACAACAGGATTTGA	Negative
GTACAACCAATCAAGA	Hashtag9
GTACAACCATGGAGAC	Negative
GTACAACGTATCCTTT	Negative
GTACAACGTTGCAACT	Negative
GTACAACTCAATCCGA	Negative
GTACAACTCATGCCAA	Negative
GTACAACTCTTTCTAG	Negative
GTACAGTAGAGAGTTT	Hashtag9
GTACAGTCAATTGTGC	Hashtag9
GTACAGTCACAAGTGG	Negative
GTACAGTCATCTAGAC	Negative
GTACAGTGTCTACAGT	Negative
GTACAGTGTTCTCGCT	Negative
GTAGAAAGTGAACTAA	Hashtag10
GTAGAAATCGTAGTCA	Negative
GTAGAGGAGCCTGGAA	Negative
GTAGAGGAGGCGAACT	Negative
GTAGAGGAGGTAGACC	Negative
GTAGAGGCAATAAGGT	Hashtag9
GTAGAGGGTGGTAATA	Negative
GTAGAGGGTTGTAGCT	Negative
GTAGAGGTCGCTCATC	Hashtag9
GTAGAGGTCTAAGGAA	Negative
GTAGAGGTCTGGCCTT	Negative
GTAGATCAGACTTAAG	Hashtag9
GTAGATCAGCACGGAT	Negative
GTAGATCAGCAGCCCT	Negative
GTAGATCGTCAGACGA	Negative
GTAGATCTCAGACCTA	Negative
GTAGCTAAGATGTTGA	Negative
GTAGCTAGTCCAGAAG	Hashtag9
GTAGCTAGTCTTCTAT	Negative
GTAGCTAGTGTTGCCG	Negative
GTAGCTATCAGTCATG	Hashtag9
GTAGCTATCGGTTGTA	Negative
GTAGGAGAGAGCAGCT	Hashtag9
GTAGGAGAGTACCCTA	Negative
GTAGGAGGTACAAGTA	Hashtag9
GTAGGAGTCTCGCTTG	Negative
GTAGGTTCAATCTAGC	Negative
GTAGGTTGTATCACCA	Negative
GTAGTACAGATTGATG	Hashtag9
GTAGTACAGGAGAATG	Hashtag9
GTAGTACCAGGTGTTT	Negative
GTAGTACGTAACGTTC	Negative
GTAGTACTCATAAGGA	Negative
GTATTGGAGTGAGTTA	Negative
GTATTGGCAAATGCGG	Negative
GTATTGGCAATTGTGC	Negative
GTATTGGGTAGAGACC	Negative
GTATTGGGTTCCGCAG	Negative
GTATTGGGTTGAGGAC	Negative
GTATTGGTCCTTGGAA	Negative
GTATTTCAGAGTGTTA	Hashtag9
GTATTTCCAAGACAAT	Hashtag9
GTATTTCGTTCGAAGG	Negative
GTCAAACAGACTCAAA	Hashtag10
GTCAAACAGGAAAGAC	Negative
GTCAAACCACTTTATC	Negative
GTCAAACTCAGAACCT	Negative
GTCAAGTTCAGTGTCA	Hashtag9
GTCAAGTTCCTTCTGG	Hashtag9
GTCACGGAGCCTTCTC	Negative
GTCACGGAGTTGCCCG	Hashtag9
GTCACGGCAAGTGGAC	Negative
GTCACGGCACTCCGGA	Negative
GTCACGGCATGACTCA	Hashtag10
GTCACGGTCATAGGCT	Negative
GTCACGGTCATGACAC	Hashtag9
GTCACGGTCGATTGGT	Negative
GTCACGGTCGCCGATG	Negative
GTCACGGTCTATACTC	Negative
GTCACTCAGACGCAGT	Negative
GTCACTCGTATGATCC	Negative
GTCACTCGTTTCGGCG	Negative
GTCACTCTCCACGTAA	Negative
GTCACTCTCTGCTGAA	Negative
GTCAGCGAGCTGACCC	Negative
GTCAGCGCAGAGTGTG	Negative
GTCAGCGCAGGAAGTC	Hashtag9
GTCAGCGGTCCACGCA	Negative
GTCAGCGGTTATCCAG	Negative
GTCAGCGTCTCTAGGA	Hashtag10
GTCATCCAGAAACTCA	Hashtag10
GTCATCCAGCGTATAA	Negative
GTCATCCAGGCCTTCG	Hashtag9
GTCATCCCAAGCCTGC	Negative
GTCATCCGTAGGACCA	Negative
GTCATCCGTCACGTGC	Hashtag9
GTCATCCGTCATAAAG	Negative
GTCATCCGTCTTTCTA	Negative
GTCATCCGTTAAGAAC	Hashtag10
GTCATCCTCTTTGCAT	Negative
GTCATGAAGAATGTTG	Hashtag9
GTCATGAAGCGACCCT	Hashtag9
GTCATGAAGTTACGGG	Hashtag9
GTCATGACAACAAGAT	Hashtag9
GTCATGACAACGGTAG	Hashtag9
GTCATGACAGCGAACA	Negative
GTCATGACATCGATCA	Negative
GTCATGAGTAAGTCAA	Negative
GTCATGAGTAGACACG	Negative
GTCATGAGTGGTACAG	Negative
GTCATGAGTTATTCCT	Hashtag9
GTCATGATCAAGCCAT	Negative
GTCATGATCACGGACC	Negative
GTCATGATCGCGTAGC	Hashtag9
GTCATGATCGTTAGTG	Hashtag9
GTCATGATCTGGGCCA	Negative
GTCATTTGTTCGAGCC	Hashtag9
GTCATTTTCCACTGGG	Negative
GTCCACTAGATCCAAA	Hashtag10
GTCCACTAGATGCTTC	Negative
GTCCACTCACATATCG	Negative
GTCCACTCATCGAGCC	Negative
GTCCACTGTGGTTCTA	Hashtag9
GTCCACTGTTTGGGAG	Negative
GTCCACTTCCAAATGC	Negative
GTCCACTTCGATACTG	Negative
GTCCACTTCGCTGACG	Negative
GTCCCATAGTTGAAGT	Hashtag9
GTCCCATCAGATTAAG	Negative
GTCCCATCAGTAACCT	Negative
GTCCCATGTACTGAGG	Hashtag10
GTCCCATGTGCATGTT	Negative
GTCCCATTCATGAGAA	Negative
GTCCCATTCTCTGCCA	Hashtag9
GTCCTCAAGAAACACT	Hashtag9
GTCCTCAAGAGTCAAT	Hashtag9
GTCCTCAAGTCTGCAT	Negative
GTCCTCACAAGCGAGT	Hashtag9
GTCCTCACAATGGCAG	Hashtag9
GTCCTCACACGTGAGA	Hashtag9
GTCCTCACAGCCTACG	Hashtag9
GTCCTCAGTTCCGGTG	Negative
GTCCTCATCATGCCCT	Negative
GTCCTCATCTTCCGTG	Negative
GTCGAATAGTCAATCC	Hashtag9
GTCGAATCACTTGAAC	Hashtag9
GTCGAATCAGCAGAAC	Negative
GTCGAATGTAGCGTTT	Negative
GTCGAATGTGCATGAG	Negative
GTCGAATGTTGTGGCC	Hashtag9
GTCGAATTCCTGTAAG	Hashtag9
GTCGCGAAGCAGTAAT	Negative
GTCGCGAAGTTCCAGT	Hashtag10
GTCGCGAGTGCAGATG	Hashtag9
GTCGCGAGTGGAGAAA	Negative
GTCGTAAAGACATGCG	Hashtag9
GTCGTAAAGAGTCTGG	Negative
GTCGTAAAGGGCAATC	Hashtag9
GTCGTAAGTAAGACCG	Negative
GTCGTAATCGTAGTCA	Negative
GTCGTAATCGTCGCTT	Hashtag9
GTCGTTCGTACGGCAA	Hashtag9
GTCGTTCGTCATACCA	Hashtag9
GTCGTTCGTTGGGACA	Negative
GTCTACCAGACTGAGC	Negative
GTCTACCAGATAGCTA	Negative
GTCTACCAGCATCAAA	Negative
GTCTACCAGTAACCTC	Negative
GTCTACCGTATGAAGT	Negative
GTCTACCGTCAACCTA	Negative
GTCTAGAAGTTTGTCG	Hashtag9
GTCTAGACATAATCGC	Negative
GTCTAGACATACCAGT	Negative
GTCTAGAGTGCATTAC	Negative
GTCTAGAGTGGACTGA	Negative
GTCTAGATCACCATCC	Negative
GTCTAGATCGAATCCA	Negative
GTCTAGATCGGTCGAC	Negative
GTCTAGATCTCGGTCT	Negative
GTCTAGATCTTTGGAG	Negative
GTCTCACAGACGACGT	Hashtag9
GTCTCACAGGGTATAT	Negative
GTCTCACAGGTTGTTC	Hashtag9
GTCTCACAGTCAGCGA	Negative
GTCTCACAGTCTTGGT	Negative
GTCTCACAGTGCAGCA	Hashtag9
GTCTCACAGTTCTACG	Negative
GTCTCACCAACCAACT	Negative
GTCTCACCAGGGTTGA	Hashtag9
GTCTCACCATGACTAC	Negative
GTCTCACGTGACTGAG	Negative
GTCTCACTCTCTATGT	Negative
GTCTGTCAGGAAAGAC	Negative
GTCTGTCCAGTTGTCA	Negative
GTCTGTCGTGTCTCCT	Hashtag9
GTCTGTCTCAAGAGTA	Negative
GTCTGTCTCGCCGTGA	Negative
GTCTTTAAGCCGGATA	Hashtag9
GTCTTTACAGGACTTT	Negative
GTCTTTAGTCCGTACG	Negative
GTCTTTATCCAGTACA	Negative
GTCTTTATCTGTAACG	Negative
GTGACGCAGCGTCAAG	Hashtag9
GTGACGCAGGGATCGT	Negative
GTGACGCAGTTTCGAC	Hashtag10
GTGACGCCAGGCCTGT	Hashtag10_Hashtag9
GTGACGCGTTAGAAGT	Hashtag9
GTGACGCTCACGTCCT	Negative
GTGACGCTCGCGAAGA	Hashtag9
GTGAGCCAGAACGTGC	Negative
GTGAGCCAGTCCTACA	Negative
GTGAGCCCATCCTTGC	Negative
GTGAGCCGTGACCGTC	Negative
GTGAGCCGTTGGGTTT	Negative
GTGAGCCTCAGCGCGT	Negative
GTGAGCCTCGCTGATA	Negative
GTGAGGAAGCCAAGCA	Hashtag9
GTGAGGACACAATGCT	Negative
GTGAGGACAGTTCCAA	Negative
GTGAGGACATGCAGCC	Hashtag9
GTGAGGACATGGCTAT	Negative
GTGAGGAGTCTTCGAA	Negative
GTGAGGAGTGTTACTG	Negative
GTGAGGATCAAACTGC	Negative
GTGAGGATCAGCTGTA	Negative
GTGAGGATCGCCCAGA	Hashtag9
GTGAGTTAGGTGGCTA	Negative
GTGAGTTCAAACCATC	Negative
GTGAGTTCACTGGCCA	Hashtag9
GTGAGTTGTACCCGCA	Negative
GTGAGTTGTAGGTGCA	Hashtag9
GTGAGTTTCCAATCTT	Hashtag9
GTGATGTAGCCAGAGT	Negative
GTGATGTCAACAGATA	Hashtag9
GTGATGTGTATAATGG	Negative
GTGATGTTCTGATGGT	Negative
GTGATGTTCTTTCCAA	Hashtag9
GTGCACGAGACAACAT	Negative
GTGCAGCAGTTACGTC	Negative
GTGCAGCCACATTACG	Negative
GTGCAGCGTATGGTAA	Negative
GTGCAGCGTGACACAG	Hashtag9
GTGCAGCTCTGAGAAA	Hashtag9
GTGCAGCTCTTCGGTC	Hashtag9
GTGCGTGAGTGAACAT	Negative
GTGCGTGGTGTAGCAG	Negative
GTGCGTGTCAGTGTGT	Negative
GTGCGTGTCGACGCTG	Hashtag9
GTGCTGGCATGGAGAC	Negative
GTGCTGGGTTAGGCCC	Negative
GTGCTGGTCAACTCTT	Hashtag9
GTGCTGGTCCTAGCTC	Negative
GTGCTGGTCTTGATTC	Hashtag9
GTGCTTCAGAATCGCG	Negative
GTGCTTCAGCGAGTCA	Negative
GTGCTTCAGTAAAGCT	Negative
GTGCTTCAGTCAAGCG	Hashtag9
GTGCTTCGTGTGTGGA	Negative
GTGCTTCTCCATTCAT	Hashtag9
GTGCTTCTCCATTTCA	Hashtag9
GTGCTTCTCCCGTTGT	Negative
GTGCTTCTCTAGGCAT	Negative
GTGGAAGAGGAGGGTG	Negative
GTGGAAGCATACCGTA	Hashtag9
GTGGAAGGTCCTACAA	Hashtag9
GTGGAAGGTGCTCGTG	Negative
GTGGAGACAACAGCTT	Hashtag9
GTGGAGACAGTGGCTC	Negative
GTGGAGAGTTAGGCCC	Negative
GTGGAGATCCACGTAA	Negative
GTGGCGTAGTCTCCTC	Hashtag9
GTGGCGTCAAGCACAG	Negative
GTGGCGTGTGCCAAGA	Negative
GTGGCGTTCGGTCTAA	Hashtag9
GTGGCGTTCTTTGATC	Negative
GTGGGAACACCCTGAG	Negative
GTGGGAACACTTCAGA	Negative
GTGGGAACATATCGGT	Negative
GTGGGAACATGAATCC	Hashtag10_Hashtag9
GTGGGAAGTAATTAGG	Negative
GTGGTTAAGGATACAT	Hashtag9
GTGGTTAAGTGCCAGA	Hashtag9
GTGGTTACACCGCTAG	Negative
GTGGTTACAGGGTTGA	Negative
GTGGTTACATAGACTC	Negative
GTGGTTATCCGAGCTG	Hashtag9
GTGGTTATCGACCTAA	Negative
GTGGTTATCTTAATCC	Hashtag9
GTGTAACAGGATCACG	Negative
GTGTAACCAAGAAATC	Negative
GTGTAACCACACGTGC	Negative
GTGTAACCATGTACGT	Negative
GTGTAACGTGATACTC	Negative
GTGTAACTCAAGAGTA	Negative
GTGTCCTAGCAAGCCA	Negative
GTGTCCTCAAATGCGG	Negative
GTGTCCTCATAGGTTC	Hashtag10
GTGTCCTCATCGATAC	Negative
GTGTCCTGTAGAGGAA	Negative
GTGTCCTGTAGTGCGA	Negative
GTGTGATAGGTTCTAC	Negative
GTGTGATCACATATGC	Negative
GTGTGATGTATAGGAT	Hashtag9
GTGTGATTCGATTGAC	Negative
GTGTGATTCTGAGTCA	Negative
GTGTGGCCAATATCCG	Negative
GTGTGGCCAGCATACT	Negative
GTGTGGCGTGACAGGT	Hashtag9
GTGTGGCTCAGTGTGT	Hashtag9
GTGTGGCTCCCGTGAG	Hashtag9
GTGTGGCTCTATCGGA	Negative
GTGTTAGAGTCTTGGT	Hashtag9
GTGTTAGCACGGATCC	Hashtag9
GTGTTAGGTCTGTCAA	Negative
GTGTTAGGTTGGTGTT	Negative
GTGTTAGTCGAACACT	Negative
GTGTTAGTCGCGATCG	Negative
GTGTTAGTCTCGTCAC	Negative
GTGTTAGTCTGAACGT	Negative
GTGTTAGTCTTCCGTG	Negative
GTGTTCCAGAGTGTGC	Hashtag9
GTGTTCCCACAGAAGC	Negative
GTGTTCCGTGTTCGAT	Negative
GTTACAGAGGGATCTG	Negative
GTTACAGCACTTACAG	Negative
GTTACAGTCCTGCCAT	Hashtag10
GTTACCCAGCGGATCA	Negative
GTTACCCAGCTGGCTC	Negative
GTTACCCAGGCGACAT	Negative
GTTACCCAGGGACTGT	Hashtag10_Hashtag9
GTTACCCCACACGCCA	Hashtag9
GTTACCCCAGATACTC	Negative
GTTACCCCAGGGCTTC	Hashtag9
GTTACCCGTACGTACT	Negative
GTTACCCGTACTGGGA	Hashtag9
GTTACCCGTCGTAATC	Hashtag9
GTTACCCTCGACGCTG	Negative
GTTACGAAGCATTGAA	Negative
GTTACGACAAGATGGC	Hashtag9
GTTACGACAAGTCATC	Hashtag10
GTTACGACACGGTGCT	Negative
GTTACGACAGCTGTAT	Negative
GTTACGAGTCCCGCAA	Negative
GTTAGACCAGACGCTC	Hashtag9
GTTAGACGTCGCGGTT	Hashtag9
GTTAGACGTGAGAACC	Negative
GTTAGACTCCTACGGG	Negative
GTTAGACTCGAGAGCA	Negative
GTTAGTGCACAGCCAC	Negative
GTTAGTGCAGACCGCT	Hashtag9
GTTAGTGGTCATGACT	Negative
GTTAGTGGTTGGCCGT	Negative
GTTAGTGTCCAGTGCG	Negative
GTTAGTGTCGCGGACT	Negative
GTTATGGAGTGCAGCA	Negative
GTTATGGCAAATCAAG	Negative
GTTATGGCAAATGGAT	Negative
GTTATGGCAACCGTGC	Hashtag9
GTTATGGCATCAGTGT	Negative
GTTATGGTCTGCCCTA	Hashtag9
GTTCATTAGCTTGTTG	Hashtag9
GTTCATTAGTCCCAGC	Hashtag10
GTTCATTCAAAGGATT	Negative
GTTCATTTCAGTGTTG	Negative
GTTCCGTGTATCCTCC	Negative
GTTCCGTTCGAGCCAC	Negative
GTTCCGTTCGATTCCC	Negative
GTTCCGTTCGCATAGT	Negative
GTTCCGTTCGGAGTAG	Negative
GTTCGCTAGCGTCTCG	Hashtag9
GTTCGCTCACAATCTG	Hashtag9
GTTCGCTCAGCGACAA	Negative
GTTCGCTGTGCTGATT	Hashtag10_Hashtag9
GTTCGCTTCATAGACC	Hashtag9
GTTCTATTCATGGAGG	Hashtag9
GTTGAACAGACTTGTC	Hashtag9
GTTGAACCACAACCGC	Negative
GTTGAACCAGACATCT	Negative
GTTGAACGTTCCGCGA	Hashtag9
GTTGAACTCTGAGGCC	Negative
GTTGCGGCACTAACGT	Negative
GTTGCGGGTACTCGAT	Hashtag9
GTTGCGGGTCACATTG	Hashtag9
GTTGCGGGTTCAAAGA	Hashtag9
GTTGCGGTCATTGCCC	Negative
GTTGCGGTCGTGTGGC	Negative
GTTGCTCAGGTAAGAG	Negative
GTTGCTCCACTCCACT	Negative
GTTGCTCGTAGACGTG	Negative
GTTGCTCGTCTTGCTC	Negative
GTTGCTCGTGGGTTGA	Negative
GTTGCTCTCGCTTACC	Negative
GTTGTAGGTTGCTTGA	Negative
GTTGTCCAGAACTCCT	Negative
GTTGTCCAGCGCAATG	Negative
GTTGTCCAGTAGTGCG	Negative
GTTGTCCAGTATTGCC	Negative
GTTGTCCGTTCTAAGC	Negative
GTTGTCCTCGAGAAGC	Negative
GTTGTCCTCGATCCCT	Negative
GTTGTCCTCGGCCCAA	Negative
GTTGTCCTCGGTAGAG	Negative
GTTGTCCTCTTTCGAT	Negative
GTTGTGAAGCAGGGAG	Hashtag9
GTTGTGAAGTGGATTA	Hashtag9
GTTGTGACACAAATCC	Hashtag9
GTTGTGAGTCGAGATG	Negative
GTTGTGAGTCGGATTT	Hashtag9
GTTGTGAGTGTCTCCT	Hashtag9
GTTGTGATCATGAGGG	Hashtag9
GTTGTGATCGGTCTAA	Negative
GTTGTGATCGTCGACG	Negative
GTTTACTAGCTCCACG	Negative
GTTTACTAGTGCAAAT	Negative
GTTTACTCACAACGTT	Hashtag9
GTTTACTCACGCAGTC	Hashtag9
GTTTACTCAGCAGGAT	Negative
GTTTACTCAGGATCTT	Negative
GTTTACTGTGCATGTT	Negative
GTTTACTTCTACCACC	Hashtag9
GTTTGGAAGCAGATAT	Hashtag10
GTTTGGAAGCCTCGTG	Negative
GTTTGGACAACGGGTA	Negative
GTTTGGACAGAGCTAG	Negative
GTTTGGACAGCTGGTC	Negative
GTTTGGAGTCCTTAAG	Negative
GTTTGGAGTTCTCTAT	Hashtag9
GTTTGGAGTTCTTGCC	Negative
GTTTGGATCGCCGTGA	Negative
TAACACGAGGCGACAT	Hashtag9
TAACACGAGTAATTGG	Negative
TAACACGCAAGTACCT	Negative
TAACACGCACAGAGAC	Hashtag9
TAACACGCAGCGAACA	Hashtag9
TAACACGTCACGAGGA	Negative
TAACACGTCCCTTGTG	Negative
TAACACGTCTTGGGCG	Negative
TAACCAGAGGAGAGGC	Negative
TAACCAGAGTAATACG	Hashtag9
TAACCAGCATGAGAAT	Hashtag9
TAACCAGTCGTTCTCG	Hashtag9
TAACCAGTCTACGCGG	Negative
TAACCAGTCTAGTTCT	Negative
TAACGACCATAGAATG	Negative
TAACGACGTAGCGTTT	Negative
TAACGACGTCTCAAGT	Negative
TAACTTCAGCCATCCG	Negative
TAACTTCCAACAAGTA	Hashtag9
TAACTTCCAGACACAG	Hashtag9
TAACTTCGTCAAATCC	Hashtag9
TAACTTCGTGCCGAAA	Negative
TAAGCACAGATTCGAA	Negative
TAAGCACAGTGGTGGT	Negative
TAAGCACCAAAGCTAA	Negative
TAAGCACGTTATCTTC	Hashtag9
TAAGCACTCAACCTCC	Negative
TAAGCACTCGCCGTGA	Negative
TAAGCCAAGGTGGTTG	Negative
TAAGCCACACTTGGGC	Negative
TAAGCCACAGAGGGTT	Hashtag9
TAAGCCAGTCCGCAGT	Negative
TAAGCCATCAAAGAAC	Hashtag9
TAAGCCATCAAGAATG	Negative
TAAGCCATCCTGTAGA	Negative
TAAGCGTAGCATAGGC	Negative
TAAGCGTCAGGAATCG	Negative
TAAGCGTTCCTGTAAG	Negative
TAAGCGTTCGAGCTGC	Hashtag9
TAAGTCGAGTCATAGA	Hashtag9
TAAGTCGCAGACGCTC	Negative
TAAGTCGGTTGGACCC	Negative
TAATCTCCAATAACCC	Negative
TAATCTCCAATACGCT	Hashtag9
TAATCTCGTCGCAACC	Negative
TAATCTCGTGTGTTTG	Negative
TAATCTCTCAGGAACG	Negative
TAATCTCTCTGACCCT	Hashtag9
TAATTCCAGGTTTACC	Negative
TAATTCCCAGCCGGTT	Negative
TAATTCCGTAGAGTTA	Negative
TAATTCCGTAGATCCT	Hashtag9
TAATTCCGTTCCTAAG	Hashtag9
TAATTCCTCGGACTGC	Negative
TACAACGAGCGCTGCT	Hashtag9
TACAACGAGTCTGTAC	Hashtag9
TACAACGCAAATGGCG	Negative
TACAACGTCATCGACA	Negative
TACACCCAGCCTATTG	Hashtag9
TACACCCAGCGATCGA	Negative
TACACCCAGGGAGTGG	Negative
TACACCCAGTTGTACC	Negative
TACACCCAGTTTCAGC	Negative
TACACCCCACTCATAG	Hashtag9
TACACCCCAGACATCT	Hashtag9
TACACCCTCGACTCCT	Negative
TACAGGTAGCAGCGAT	Negative
TACAGGTAGTTCAACC	Hashtag9
TACAGGTCAATACAGA	Negative
TACAGGTCACCGTGAC	Negative
TACAGGTGTACTGGGA	Hashtag9
TACAGGTGTTAAGACA	Hashtag9
TACATTCAGAGTGACC	Hashtag9
TACATTCAGGTCTTTG	Hashtag9
TACATTCCAGTCCCGA	Negative
TACATTCGTACGTGAG	Hashtag9
TACATTCGTAGACAAT	Hashtag9
TACATTCGTCGTTCAA	Negative
TACATTCGTCTTGAGT	Negative
TACATTCTCCGGTAAT	Negative
TACATTCTCGGCATAT	Hashtag9
TACATTCTCTCCAAGA	Hashtag9
TACCCACAGTCCCAGC	Negative
TACCCACAGTGCGCTC	Hashtag9
TACCCACCACTTGAAC	Hashtag9
TACCCACCAGTCCGTG	Hashtag9
TACCCACCATACTGTG	Negative
TACCCACCATAGATGA	Negative
TACCCACGTAGCTTAC	Negative
TACCCACTCTGGCTGG	Negative
TACCCGTCAACACAAA	Hashtag9
TACCCGTCACCCTAAA	Hashtag10
TACCCGTCAGCAGTCC	Negative
TACCCGTCATATACCG	Negative
TACCCGTGTCGCAGTC	Negative
TACCCGTGTCGCGTTG	Hashtag10
TACCCGTGTGTTCATG	Negative
TACCCGTGTTCCCAAA	Negative
TACCCGTGTTCTAAGC	Negative
TACCCGTTCACCTTGC	Hashtag9
TACCGAACAATCGCCG	Negative
TACCGAACACTGTGAT	Negative
TACCGAAGTTCTGAGT	Negative
TACCGAATCACTGATG	Negative
TACCGAATCACTTGGA	Negative
TACCGAATCCGAGTGC	Hashtag9
TACCGAATCCTCATAT	Negative
TACCGAATCGTGGACC	Negative
TACCGGGCAAATGATG	Negative
TACCGGGCACAGTACT	Negative
TACCGGGCAGAGTTCT	Negative
TACCGGGTCTTCTGTA	Hashtag9
TACCTCGAGGGCCCTT	Hashtag9
TACCTGCAGTGCCTCG	Hashtag9
TACCTGCCATCATCCC	Negative
TACCTGCTCGAGAAGC	Hashtag10
TACCTGCTCTGCGGCA	Negative
TACGCTCAGAGGTGCT	Negative
TACGCTCAGATTGCGG	Negative
TACGCTCAGGTCATCT	Hashtag9
TACGCTCGTGAATTGA	Hashtag9
TACGCTCTCGCAGTGC	Negative
TACGCTCTCGCTTTAT	Hashtag10
TACGCTCTCTTTCCGG	Hashtag9
TACGGGCAGCGTTGTT	Hashtag9
TACGGGCAGTGCACCC	Negative
TACGGGCCACGCGCAT	Negative
TACGGTAAGAATTCAG	Negative
TACGGTAAGCCGCACT	Negative
TACGGTAAGGTATAGT	Hashtag9
TACGGTACAAGGAGTC	Hashtag9
TACGGTACATGTGACT	Negative
TACGGTAGTAGATTAG	Hashtag9
TACGGTAGTCCACAGC	Negative
TACGGTAGTCTGTCAA	Negative
TACGGTATCACCCTGT	Negative
TACGGTATCTTCCCAG	Negative
TACGTCCAGAACGTGC	Negative
TACGTCCAGCAAATGT	Negative
TACGTCCAGCAACCAG	Hashtag9
TACGTCCAGCCTTTCC	Negative
TACTGCCAGCGCACAA	Hashtag9
TACTGCCCATACAGCT	Hashtag9
TACTGCCGTGGCCCAT	Negative
TACTGCCGTTTCGCTC	Negative
TACTGCCTCCTACTGC	Hashtag9
TACTTACAGATAGCAT	Hashtag10
TACTTACAGTACAACA	Negative
TACTTACAGTAGGATT	Hashtag9
TACTTACCAATCGCGC	Negative
TACTTACGTCGCTTAA	Negative
TACTTACGTGATACAA	Hashtag9
TACTTACTCCAAACCA	Negative
TACTTACTCTGGGATT	Negative
TACTTCAAGTATAGGT	Negative
TACTTCAGTACTGTTG	Hashtag9
TACTTCAGTCCTATAG	Negative
TACTTCAGTCTGATAC	Negative
TACTTCATCAGGGTAG	Negative
TACTTCATCTTGAGCA	Negative
TACTTGTAGGCAGCTA	Negative
TACTTGTAGTGACACG	Negative
TACTTGTCAGTGTATC	Hashtag9
TACTTGTGTCTCGGGT	Negative
TACTTGTTCACCTTGC	Hashtag9
TACTTGTTCCCGAATA	Negative
TACTTGTTCGCCATAA	Negative
TAGACCAAGAACAAGG	Negative
TAGACCAAGGATGGCT	Negative
TAGACCACACACACTA	Negative
TAGACCACATCCTTGC	Negative
TAGACCACATGTTTGG	Hashtag9
TAGACCAGTTCGAACT	Negative
TAGACTGAGAAGTCTA	Hashtag9
TAGACTGAGGAACTAT	Negative
TAGACTGAGGGACCAT	Negative
TAGACTGAGTGCAAAT	Hashtag9
TAGACTGCAATAGGAT	Hashtag10_Hashtag9
TAGACTGCACAGTCGC	Negative
TAGACTGGTAGAATAC	Hashtag9
TAGACTGGTATCCCAA	Negative
TAGACTGGTCAGCTTA	Negative
TAGACTGGTGAATAAC	Hashtag9
TAGACTGTCTCCAATT	Negative
TAGACTGTCTTAATCC	Negative
TAGAGTCAGGGTTAAT	Hashtag9
TAGAGTCCACTCACTC	Negative
TAGAGTCCACTGCGTG	Negative
TAGAGTCGTTCTCTCG	Negative
TAGATCGAGAGTTGCG	Hashtag10
TAGATCGCAACGTTAC	Hashtag9
TAGATCGCATCGGAAG	Negative
TAGATCGTCCGATGCG	Hashtag9
TAGATCGTCTCGAACA	Negative
TAGATCGTCTCTGAGA	Hashtag9
TAGCACAAGTAGGGTC	Negative
TAGCACACAGTTCACA	Negative
TAGCACAGTCCGGTCA	Hashtag9
TAGCACATCGTAACCA	Negative
TAGGAGGAGCTGTACT	Hashtag9
TAGGAGGAGTGTAGTA	Hashtag9
TAGGAGGCAACTAGAA	Negative
TAGGAGGCATGGATCT	Negative
TAGGAGGTCAATCTCT	Negative
TAGGGTTAGCTATCTG	Negative
TAGGGTTAGTAACGTA	Hashtag9
TAGGGTTGTAGGAGTC	Negative
TAGGGTTGTTGTTGCA	Negative
TAGGGTTTCCGATAAC	Hashtag9
TAGGGTTTCGGAGTGA	Negative
TAGGGTTTCGTGTGAT	Negative
TAGGGTTTCTACAGGT	Hashtag9
TAGGGTTTCTGTGCTC	Hashtag9
TAGGTACAGGCGAACT	Hashtag10
TAGGTACCAGCAGTAG	Negative
TAGGTACCATTGAGGG	Negative
TAGGTACGTAGCGATG	Negative
TAGGTACTCAGATGCT	Hashtag9
TAGGTACTCAGCATTG	Negative
TAGGTACTCAGTGCGC	Negative
TAGGTACTCCATTCGC	Negative
TAGGTACTCCTGGTCT	Negative
TAGGTACTCTTCACGC	Negative
TAGGTTGAGCATTGAA	Negative
TAGGTTGAGTTGAAGT	Hashtag9
TAGGTTGTCTCTCGCA	Hashtag9
TAGTGCAAGCAATAAC	Hashtag9
TAGTGCAAGCTGGCTC	Negative
TAGTGCAAGGGTACGT	Negative
TAGTGCAAGTCGGCCT	Hashtag9
TAGTGCACAGCCCACA	Hashtag9
TAGTGCATCCACTGAA	Negative
TAGTGCATCCGGCTTT	Negative
TATACCTAGCGCCTTG	Negative
TATACCTCACTCTGCT	Hashtag10
TATACCTCAGAGTAAT	Negative
TATACCTTCATCTACT	Hashtag9
TATACCTTCATTCGTT	Negative
TATACCTTCGAGAAGC	Hashtag9
TATACCTTCGGACTTA	Negative
TATATCCAGAAGCCTG	Negative
TATATCCAGAGGGCGA	Negative
TATATCCAGCAGCAGT	Negative
TATATCCAGCAGTAAT	Negative
TATATCCCAATTGTGC	Negative
TATATCCCACTAACCA	Negative
TATATCCCAGGATGAC	Hashtag9
TATATCCCATAACCCA	Negative
TATATCCGTACCCACG	Negative
TATATCCTCTCCGAAA	Hashtag9
TATCAGGCAGCACACC	Negative
TATCAGGCAGTAACGG	Negative
TATCAGGCAGTGTATC	Negative
TATCAGGGTTCTCCTG	Negative
TATCAGGTCACGGGAA	Hashtag9
TATCAGGTCTTGCAGA	Negative
TATCCTAAGGCGATAC	Hashtag9
TATCGCCGTACGATTC	Negative
TATCGCCGTAGAATGT	Hashtag9
TATCGCCTCACAATGC	Negative
TATCGCCTCACCGCTT	Negative
TATCGCCTCCGATGTA	Hashtag9
TATCGCCTCGTAGAGG	Negative
TATCTGTAGTCTGGTT	Negative
TATCTGTGTATAGCTC	Negative
TATCTGTGTCGTGATT	Negative
TATCTTGCAACCGACC	Negative
TATCTTGCACCAAATC	Hashtag9
TATCTTGCAGGTGTTT	Negative
TATCTTGGTGGCCTCA	Hashtag9
TATGTTCAGGATGAGA	Hashtag9
TATGTTCCAGGGACTA	Negative
TATGTTCCAGGTGGAT	Negative
TATGTTCGTCAGTCCG	Hashtag9
TATTCCAAGGCTAACG	Negative
TATTCCACACATGGTT	Negative
TATTCCACATCGAACT	Hashtag9
TATTCCAGTATTCCGA	Negative
TATTCCATCGCAGTTA	Hashtag9
TATTCCATCGGTCATA	Negative
TATTCCATCTGTCGCT	Negative
TATTGCTCACCGTGGT	Negative
TATTGCTCAGAGGTAC	Negative
TATTGCTGTAGGGAGG	Negative
TATTGCTGTAGTGGCA	Negative
TATTGGGAGTACAGCG	Negative
TATTGGGAGTAGTCTC	Hashtag9
TATTGGGTCACTACGA	Negative
TATTGGGTCCGATAGT	Negative
TATTGGGTCGGTCAGC	Hashtag9
TATTGGGTCGTAGCCG	Negative
TATTTCGCAAAGGGTC	Negative
TATTTCGCACAAATCC	Hashtag9
TATTTCGCACCATTCC	Negative
TATTTCGCATAGATGA	Negative
TATTTCGGTCGGAAAC	Negative
TATTTCGGTGAGAGGG	Hashtag9
TATTTCGTCCTCTGCA	Negative
TCAAGACAGAGGCCAT	Negative
TCAAGACAGCCTCAGC	Negative
TCAAGACAGTTCTACG	Negative
TCAAGACGTCTCGCGA	Negative
TCAAGACTCTCGCTCA	Hashtag10
TCAAGCACAAAGGTTA	Hashtag9
TCAAGCAGTTTCACTT	Negative
TCAAGCATCACTGCTC	Hashtag9
TCAAGCATCCACGGGT	Negative
TCAAGTGCACAGTCCG	Hashtag9
TCAAGTGCAGCACGAA	Negative
TCAAGTGCATAACCCA	Hashtag9
TCAAGTGTCCAAATGC	Negative
TCAAGTGTCCCGTGTT	Negative
TCAAGTGTCGGCTATA	Negative
TCAAGTGTCGTTGCCT	Hashtag9
TCAATCTAGACATACA	Negative
TCAATCTAGTCATGGG	Negative
TCAATCTCAGAACCGA	Negative
TCAATCTGTGCCCAGT	Hashtag9
TCAATCTGTGGATCAG	Hashtag9
TCAATTCAGTACAGAT	Negative
TCAATTCCACGGGCTT	Negative
TCAATTCCAGACTGCC	Hashtag9
TCAATTCCAGGACATG	Negative
TCAATTCCATGGCTAT	Negative
TCAATTCGTAGATTAG	Negative
TCAATTCGTCACTCTC	Hashtag9
TCAATTCTCAGCAGAG	Hashtag9
TCAATTCTCGACCAAT	Hashtag9
TCAATTCTCGGTCAGC	Hashtag9
TCAATTCTCGTTCCCA	Negative
TCACAAGAGACGTCGA	Negative
TCACAAGAGCTCCGAC	Hashtag9
TCACAAGAGGCCCGTT	Negative
TCACAAGAGGGTATAT	Negative
TCACAAGAGTTGGGAC	Negative
TCACAAGCAAGACCGA	Hashtag9
TCACAAGCAAGTGGCA	Negative
TCACAAGCAATCGTCA	Negative
TCACAAGGTATGCGGA	Negative
TCACAAGTCCTTCGAC	Negative
TCACACCAGACGGTTG	Hashtag9
TCACACCAGCAGCCTC	Negative
TCACACCGTCTTGCGG	Hashtag9
TCACACCGTTACCCAA	Negative
TCACATTAGCCTCTGG	Hashtag10
TCACATTCAACCGCCA	Hashtag9
TCACATTCAATACGAA	Hashtag10
TCACGCTAGGTAGGCT	Negative
TCACGCTCACGTGTGC	Hashtag9
TCACGCTGTAGGTCAG	Negative
TCACGCTGTGCGAACA	Hashtag9
TCACGCTGTGGGCTCT	Hashtag9
TCACGCTGTTTCGCTC	Hashtag10
TCACGCTTCTCATGGA	Hashtag9
TCACGGGAGAGATTCA	Hashtag9
TCACGGGAGCTTCATG	Hashtag9
TCACGGGAGGAGGGTG	Hashtag9
TCACGGGCACTATGTG	Hashtag9
TCACGGGCATTGACTG	Negative
TCACGGGGTACGTGAG	Hashtag9
TCACGGGTCAAATGCC	Negative
TCACGGGTCCCAGCGA	Negative
TCACGGGTCCTAAGTG	Negative
TCACTATCAAGTAGTA	Negative
TCACTATCAGTCGGTC	Negative
TCACTATGTATGCAAA	Negative
TCACTATTCTTAATCC	Negative
TCACTATTCTTTCTAG	Hashtag9
TCAGCAAAGAAAGTCT	Negative
TCAGCAAAGCAGTCTT	Hashtag9
TCAGCAAAGTGTAGTA	Hashtag9
TCAGCAAGTCAGGAGT	Negative
TCAGCAATCACCTCGT	Hashtag9
TCAGCCTAGAGTTCGG	Negative
TCAGCCTCAATGTTGC	Hashtag9
TCAGCCTCACGGTGCT	Hashtag9
TCAGCCTCAGCGTAGA	Negative
TCAGCCTCATTCTCCG	Hashtag9
TCAGCCTGTACACGTT	Negative
TCAGCCTGTACCCGCA	Negative
TCAGCCTGTGCAGATG	Hashtag9
TCAGCCTGTGTACGCC	Negative
TCAGGGCAGCCTGGAA	Negative
TCAGGGCAGCGACTGA	Negative
TCAGGGCAGGGACAGG	Negative
TCAGGGCAGTATGAGT	Negative
TCAGGGCAGTTAGTAG	Negative
TCAGGGCCAAGATGTA	Hashtag9
TCAGGGCGTGATAGTA	Negative
TCAGGGCGTTCGTGCG	Hashtag10
TCAGGGCTCAACACCA	Negative
TCAGGGCTCAACTGGT	Negative
TCAGGGCTCGCTCATC	Negative
TCAGGGCTCGGCATTA	Negative
TCAGGTACAAATCGGG	Negative
TCAGGTACATTCAGCA	Negative
TCAGGTAGTATCGCAT	Hashtag10
TCAGGTAGTCTACGAT	Negative
TCAGGTATCCAAACCA	Hashtag9
TCAGGTATCGCTCTCA	Negative
TCAGTCCAGCTGGTGA	Hashtag9
TCAGTCCAGTCCCTAA	Hashtag9
TCAGTCCCAAGACGAC	Negative
TCAGTCCCACACGTGC	Hashtag9
TCAGTCCCAGGCGATA	Negative
TCAGTCCGTAGCTTGT	Negative
TCAGTCCGTCAAGCCC	Hashtag10
TCAGTCCTCCTACGGG	Hashtag10
TCAGTGAAGTCTGTAC	Hashtag9
TCAGTGACAAATAGCA	Negative
TCAGTGAGTAACTTCG	Hashtag9
TCAGTGAGTAGACGGT	Negative
TCAGTGAGTCCGGTGT	Hashtag9
TCAGTGAGTGATATAG	Hashtag9
TCAGTGATCCACACCT	Negative
TCAGTGATCCATATGG	Negative
TCAGTTTAGTAGTCAA	Hashtag9
TCAGTTTCATCTGCGG	Negative
TCAGTTTGTATCCTTT	Hashtag10
TCAGTTTGTCGACTGC	Negative
TCAGTTTGTGCCTACG	Negative
TCAGTTTTCTCCCAAC	Negative
TCATACTAGACTGAGC	Negative
TCATACTAGAGTTGTA	Negative
TCATACTAGATGTTCC	Negative
TCATACTAGGCGCTTC	Negative
TCATACTCATCCGGTG	Hashtag9
TCATACTGTCAAAGAT	Negative
TCATACTGTTGCGAAG	Negative
TCATACTTCCGTGGTG	Negative
TCATATCCAAGGTCAG	Hashtag9
TCATATCCAGGACGAT	Negative
TCATCATAGTGAACAT	Negative
TCATCATCAGAGGTAC	Negative
TCATCATGTGAGATCG	Hashtag9
TCATCATTCCCTCTCC	Negative
TCATCCGAGAGTCTTC	Negative
TCATCCGAGATCACTC	Negative
TCATCCGAGCCAGACA	Hashtag9
TCATCCGAGGGTCACA	Negative
TCATCCGAGTGGAAGA	Hashtag9
TCATCCGGTGGCTAGA	Negative
TCATCCGTCCACGTAA	Negative
TCATGAGCAGAGGGTT	Negative
TCATGAGGTTCCAGGC	Negative
TCATGCCCAAGAGGTC	Negative
TCATGCCCAAGTCATC	Negative
TCATGCCGTATAGGAT	Negative
TCATGCCGTCCTTAAG	Negative
TCATGCCTCAATCTCT	Hashtag9
TCATGCCTCGAGAGAC	Negative
TCATGCCTCGCATTGA	Negative
TCATGGACAACATACC	Negative
TCATGGACAACTTGGT	Negative
TCATGGAGTCGGAACA	Negative
TCATGGAGTTGTGCCG	Negative
TCATGGATCCGCAACG	Negative
TCATGTTAGAAGCCTG	Hashtag9
TCATGTTAGAATCGCG	Hashtag10
TCATGTTAGCTAATCC	Negative
TCATGTTCACATGAAA	Hashtag9
TCATGTTCAGTTAAAG	Negative
TCATGTTCATCGCTCT	Hashtag10
TCATGTTGTTCCCAAA	Negative
TCATGTTTCAGATGCT	Negative
TCATGTTTCGCCATAA	Hashtag9
TCATGTTTCGTAGTGT	Negative
TCATGTTTCGTTGCCT	Negative
TCATGTTTCGTTTACT	Negative
TCATTACCACTGGCGT	Negative
TCATTACCACTTCATT	Hashtag9
TCATTACCATGACAAA	Hashtag10
TCATTACGTCTCGGAC	Hashtag9
TCATTACGTGCATGTT	Hashtag9
TCATTACTCGAACGGA	Negative
TCATTCACAACCTATG	Hashtag9
TCATTCACAATAGAGT	Negative
TCATTCACATGGACAG	Negative
TCATTCAGTCAAGGCA	Negative
TCATTCAGTCACTAGT	Negative
TCATTCAGTTCCCAAA	Negative
TCATTCATCGATGCAT	Hashtag10
TCATTGTAGCTTGTTG	Hashtag9
TCATTGTCAGAAGTTA	Negative
TCATTGTCATTGCTTT	Negative
TCATTGTGTGATGTAA	Negative
TCATTGTGTTCGAACT	Hashtag9
TCATTTGAGCTCCATA	Negative
TCATTTGCACCTCTGT	Negative
TCATTTGCAGGTCTCG	Negative
TCATTTGGTACCCGCA	Negative
TCATTTGGTCATAAAG	Hashtag10
TCCACCACAACTTCTT	Negative
TCCACCACATCTGTTT	Negative
TCCACCAGTCAACACT	Hashtag9
TCCACCAGTCTTACTT	Negative
TCCACCAGTGAATTAG	Negative
TCCACCAGTGATAGTA	Hashtag9
TCCACCATCATCACAG	Hashtag10_Hashtag9
TCCACCATCCGACGGT	Negative
TCCACGTAGGTCTGGA	Hashtag10
TCCACGTCACTAGTAC	Negative
TCCACGTCATAATGCC	Hashtag9
TCCACGTGTCAACCAT	Negative
TCCACGTGTGGTACAG	Hashtag9
TCCACGTGTTATTCTC	Negative
TCCACGTTCCCAGCGA	Negative
TCCAGAAAGAGCAGTC	Hashtag9
TCCAGAAAGCAGCCTC	Negative
TCCAGAACAAATGAGT	Negative
TCCAGAACAATGACCT	Negative
TCCAGAAGTCTCTCCA	Negative
TCCAGAATCTAAGGAA	Negative
TCCATCGAGATTGCGG	Negative
TCCATCGAGGGTGAAA	Negative
TCCATCGAGGTACAGC	Hashtag9
TCCATCGCAATAACCC	Hashtag9
TCCATCGCAATCACGT	Negative
TCCATCGCAGGTAGTG	Negative
TCCATCGGTAGTTAGA	Negative
TCCATCGGTCCAGCCA	Hashtag9
TCCATCGGTGGGAGAG	Hashtag9
TCCATCGTCAACTTTC	Negative
TCCATCGTCAGAGTTC	Hashtag9
TCCATCGTCTGAATGC	Negative
TCCATCGTCTGCTGAA	Hashtag10_Hashtag9
TCCATGCAGTACAACA	Negative
TCCATGCGTCAAAGCG	Negative
TCCATGCTCCGATGTA	Negative
TCCCACAAGCACGGAT	Negative
TCCCACAAGTCCCGAC	Negative
TCCCACAGTGTCCTAA	Negative
TCCCACATCAAATGCC	Negative
TCCCACATCTGGCCTT	Negative
TCCCAGTCAGCGTTTA	Negative
TCCCAGTTCCAACCAA	Hashtag9
TCCCATGCAACAGTGG	Hashtag9
TCCCATGCACGACTAT	Negative
TCCCATGCATCTCAAG	Hashtag9
TCCCATGGTAAGTAGT	Negative
TCCCATGGTGGAGAAA	Negative
TCCCATGTCGAGAACG	Negative
TCCCATGTCGTGGCTG	Hashtag9
TCCCATGTCTTACTGT	Negative
TCCGAAAAGACGGAAA	Negative
TCCGAAACAACAACAA	Negative
TCCGAAACAGCTTTCC	Negative
TCCGAAATCAAGTTGC	Negative
TCCGATCAGGCGTCCT	Negative
TCCGATCAGTGAATAC	Hashtag9
TCCGATCCAGAAGTTA	Hashtag9
TCCGATCGTATAATGG	Hashtag9
TCCGATCTCCTACCGT	Negative
TCCGGGAAGCTAATGA	Negative
TCCGGGAAGGTTGTTC	Negative
TCCGGGACACATTGTG	Negative
TCCGGGATCTACGGGC	Hashtag9
TCCGTGTCAATTCTTC	Negative
TCCGTGTCACGTGAGA	Negative
TCCGTGTGTCCAAGAG	Negative
TCCGTGTGTGGACCTC	Negative
TCCGTGTGTTCCGCTT	Hashtag9
TCCGTGTTCCAAGAGG	Hashtag9
TCCGTGTTCCACTAGA	Negative
TCCTAATAGCGTGAGT	Negative
TCCTAATCATGTACGT	Hashtag10
TCCTAATGTCAAGCGA	Negative
TCCTAATGTGTCATGT	Negative
TCCTAATTCTCTATGT	Negative
TCCTCCCAGATAGCAT	Negative
TCCTCCCCAGATTAAG	Negative
TCCTCCCCAGTACTAC	Hashtag9
TCCTCCCGTAATGCGG	Hashtag9
TCCTCCCGTTGTGGCC	Hashtag10
TCCTCCCTCCTAACAG	Hashtag9
TCCTCCCTCGTACACA	Negative
TCCTCGAAGAAGTATC	Negative
TCCTCGAAGCTCGAAG	Negative
TCCTCGAAGGTACAAT	Negative
TCCTCGACACATAGCT	Hashtag9
TCCTCGAGTGCGTGCT	Negative
TCCTCGATCAAACTGC	Hashtag9
TCCTCGATCGAACCAT	Hashtag9
TCCTCTTAGGACGCAT	Hashtag9
TCCTCTTAGTCACTGT	Hashtag9
TCCTCTTCAAGATTGA	Negative
TCCTCTTCATTCAGCA	Negative
TCCTCTTGTACTCGCG	Hashtag10
TCCTCTTGTGGTATGG	Hashtag9
TCCTCTTGTGTTTGCA	Negative
TCCTCTTTCATCCTGC	Negative
TCCTCTTTCCATCGTC	Negative
TCCTGCACATGGACAG	Hashtag9
TCCTTCTAGGATAATC	Hashtag9
TCCTTCTAGTAATACG	Negative
TCCTTCTCACAACGCC	Hashtag10_Hashtag9
TCCTTCTCACCGAATT	Negative
TCCTTCTGTCTGGTTA	Negative
TCCTTCTGTGCAGGAT	Hashtag9
TCCTTCTTCTTACTGT	Negative
TCCTTTCAGGCTCTCG	Hashtag9
TCCTTTCAGTGAACAT	Hashtag9
TCCTTTCCAACGATCT	Negative
TCCTTTCCACGGTGAA	Hashtag9
TCCTTTCCAGAACTCT	Negative
TCCTTTCTCAGCCTTC	Negative
TCGAACAGTAAGCGGT	Hashtag9
TCGAACAGTGACCTGC	Hashtag10
TCGAACATCAGTCATG	Hashtag9
TCGAAGTCAACCGATT	Negative
TCGAAGTCAGAAGTTA	Negative
TCGAAGTGTAACAGGC	Hashtag9
TCGAAGTGTAGGATAT	Hashtag9
TCGAAGTGTCAAAGCG	Negative
TCGAAGTGTCCTGGTG	Negative
TCGAAGTGTTCTTAGG	Hashtag10
TCGAAGTTCACCCTCA	Negative
TCGAAGTTCACTGATG	Hashtag9
TCGAAGTTCCTTATCA	Hashtag9
TCGAAGTTCGCAATTG	Negative
TCGACCTAGCACACAG	Hashtag9
TCGACCTGTCTTACTT	Hashtag9
TCGACCTGTGGTCCCA	Negative
TCGACCTGTTACAGCT	Negative
TCGACCTTCGAGAACG	Negative
TCGACCTTCGCATTGA	Negative
TCGACGGAGAAACTAC	Hashtag10
TCGACGGAGTGGTGGT	Negative
TCGACGGCAAACAGGC	Negative
TCGACGGCACTAACGT	Negative
TCGACGGCAGATCACT	Hashtag9
TCGACGGCATGAGGGT	Hashtag10
TCGACGGTCAGCATTG	Negative
TCGACGGTCCCATAAG	Negative
TCGATTTAGGACGGAG	Hashtag9
TCGATTTAGTGACACG	Negative
TCGATTTGTCTGTTAG	Negative
TCGATTTTCGGTAGAG	Negative
TCGATTTTCGTAGAGG	Hashtag9
TCGATTTTCTTGGTGA	Negative
TCGCACTAGGCGTCCT	Negative
TCGCACTCAATGAAAC	Negative
TCGCACTCAGCTACAT	Negative
TCGCACTCAGTGGTGA	Hashtag9
TCGCACTCAGTTAGAA	Negative
TCGCACTGTAACGCGA	Hashtag9
TCGCACTGTCTCTCAC	Negative
TCGCACTGTTGCCAAT	Hashtag9
TCGCACTGTTTACGAC	Negative
TCGCAGGGTGACTATC	Hashtag9
TCGCAGGGTTCACGAT	Hashtag9
TCGCAGGTCAAGCCCG	Negative
TCGCAGGTCCACCTGT	Negative
TCGCAGGTCGATACTG	Negative
TCGCTCAAGGGTTAAT	Hashtag9
TCGCTCAGTACGAGCA	Hashtag10
TCGCTCAGTGCATTAC	Negative
TCGCTCAGTGGTCTCG	Hashtag9
TCGCTCATCCAGCACG	Negative
TCGCTCATCCGCAACG	Hashtag9
TCGCTCATCGAGCTGC	Hashtag9
TCGCTCATCGTACACA	Negative
TCGCTCATCTCTAGGA	Hashtag9
TCGCTCATCTTGAGCA	Negative
TCGCTTGAGAGCATAT	Negative
TCGCTTGAGGGCAAGG	Negative
TCGCTTGAGTAAACTG	Negative
TCGCTTGAGTAGAATC	Negative
TCGCTTGCAAGGCCTC	Negative
TCGCTTGCAATCTCGA	Hashtag9
TCGCTTGCAGATCATC	Hashtag9
TCGCTTGGTGTCTTGA	Negative
TCGGATAAGGCATCTT	Hashtag9
TCGGATAAGTAGTCAA	Hashtag9
TCGGATAAGTGGATTA	Negative
TCGGATACAACCCGCA	Hashtag9
TCGGATAGTCGGTGAA	Hashtag9
TCGGATATCCCGAGAC	Hashtag9
TCGGATATCTTCCTAA	Hashtag9
TCGGGACAGATGTTGA	Negative
TCGGGACAGTAGTCCT	Hashtag9
TCGGGACCAATCTCTT	Hashtag9
TCGGGACGTACCTGTA	Hashtag9
TCGGGACGTAGATCGG	Negative
TCGGGACTCAACTACG	Negative
TCGGGCAAGGTAAACT	Hashtag9
TCGGGCACACCTCAGG	Negative
TCGGGCATCTTACACT	Hashtag9
TCGGGTGAGATGATTG	Hashtag9
TCGGGTGAGCAACTCT	Negative
TCGGGTGAGCAGCGAT	Negative
TCGGGTGAGTAGGCCA	Negative
TCGGGTGCAATAACCC	Negative
TCGGGTGCAATGTCAC	Negative
TCGGGTGCACGTACTA	Negative
TCGGGTGGTCGATTAC	Negative
TCGGGTGGTGTACGCC	Negative
TCGGGTGGTTCACGAT	Negative
TCGGTCTAGGGCAGTT	Negative
TCGGTCTGTAAGAACT	Hashtag9
TCGGTCTTCGTCCTCA	Negative
TCGTAGAAGTCGAAAT	Negative
TCGTAGACAAAGCTCT	Hashtag9
TCGTAGACACAACGAG	Negative
TCGTAGAGTACCGTCG	Hashtag9
TCGTAGAGTATCGAAA	Negative
TCGTAGAGTCGTCAGC	Hashtag9
TCGTCCAAGATAGGGA	Negative
TCGTCCAGTGCAGATG	Hashtag9
TCGTCCAGTGTACAGG	Negative
TCGTGCTAGGTAAGGA	Negative
TCGTGCTGTCCACATA	Negative
TCGTGCTGTTGTACGT	Hashtag9
TCGTGCTGTTTGAAAG	Negative
TCGTGGGAGGGACCAT	Hashtag10
TCGTGGGCAATATCCG	Negative
TCGTGGGGTCGCCACA	Negative
TCGTGGGGTCTCGGGT	Negative
TCGTGGGGTTCTTGCC	Hashtag9
TCGTGGGGTTGCGAAG	Hashtag9
TCGTGGGTCAAGAAAC	Hashtag9
TCGTGGGTCCGAACGC	Hashtag9
TCTAACTAGTCAGCCC	Negative
TCTAACTCATTGGGAG	Negative
TCTAACTGTAGATTAG	Hashtag9
TCTAACTGTTAGAAGT	Negative
TCTAACTGTTCAACGT	Negative
TCTAACTTCACCCTTG	Hashtag9
TCTAACTTCTACACAG	Hashtag10
TCTACATAGCACTCTA	Hashtag9
TCTACATCAGTTAAAG	Negative
TCTACATGTCGACGCT	Negative
TCTACATGTCTACAAC	Hashtag9
TCTACATTCCCTCTTT	Negative
TCTACATTCTTACTGT	Hashtag9
TCTACCGAGATCGCCC	Negative
TCTACCGAGCCTCTCT	Negative
TCTACCGAGGTTCAGG	Hashtag10
TCTACCGAGTCGGCAA	Negative
TCTACCGCAGCACGAA	Negative
TCTACCGCAGCTGAAG	Hashtag9
TCTACCGCATCTCATT	Negative
TCTACCGTCCTGATAG	Negative
TCTACCGTCGTGCGAC	Negative
TCTATACAGGCAATGC	Negative
TCTATACGTACGACTT	Negative
TCTATCAAGACATCAA	Hashtag9
TCTATCAAGGCATCTT	Negative
TCTATCAAGGTAAGAG	Negative
TCTATCACAGACTGCC	Negative
TCTATCATCTGACAGT	Negative
TCTCACGAGACAGCTG	Negative
TCTCACGAGCCACAAG	Negative
TCTCACGAGCGTTACT	Hashtag9
TCTCACGCAAATCGGG	Negative
TCTCACGCACGCGTGT	Negative
TCTCACGCAGAGAGGG	Hashtag9
TCTCACGGTAGAGATT	Hashtag9
TCTCACGGTGTATTCG	Hashtag9
TCTCACGTCTTGGTGA	Hashtag9
TCTCAGCCAAAGAGTT	Negative
TCTCAGCTCCAAGCCG	Negative
TCTCAGCTCTGTGCTC	Negative
TCTCCGAAGAAGTCCG	Hashtag10
TCTCCGAAGGGTAATT	Hashtag9
TCTCCGACAAGAAATC	Negative
TCTCCGATCAAAGGTA	Negative
TCTCCGATCATAGGCT	Negative
TCTCTGGAGCAACTTC	Negative
TCTCTGGCAATACAGA	Negative
TCTCTGGGTCGTCATA	Negative
TCTCTGGGTCGTTGCG	Negative
TCTCTGGGTTGTTGTG	Negative
TCTCTGGGTTTGTGGT	Hashtag9
TCTGCCAAGAAATGGG	Negative
TCTGCCAAGCCGATCC	Hashtag9
TCTGCCAAGCTAATCC	Hashtag9
TCTGCCAAGGTCTTTG	Hashtag9
TCTGCCAAGTGAGGTC	Hashtag9
TCTGCCACAACCGCCA	Negative
TCTGCCATCAAAGGTA	Negative
TCTGGCTCACTTCAAG	Negative
TCTGGCTCAGTAGTTC	Hashtag9
TCTGGCTGTTAGAAAC	Hashtag10
TCTGTCGAGAGGTTAT	Negative
TCTGTCGCACGCAAAG	Negative
TCTGTCGCACGGCCAT	Negative
TCTGTCGCAGCCTTCT	Hashtag9
TCTGTCGGTTAGAAAC	Negative
TCTGTCGTCAAGCTGT	Negative
TCTGTCGTCCGGACTG	Negative
TCTGTCGTCGAGCACC	Negative
TCTTAGTAGACCTGGA	Hashtag9
TCTTAGTAGGTAGCAC	Negative
TCTTAGTCACAGTGAG	Hashtag9
TCTTAGTCAGCTACTA	Negative
TCTTAGTCAGGTAGTG	Negative
TCTTAGTCAGGTGACA	Hashtag9
TCTTAGTGTATCAGCT	Negative
TCTTAGTGTATTCTCT	Negative
TCTTCCTCAAGATGGC	Negative
TCTTCCTCACGGTAGA	Negative
TCTTCCTGTGAAGCTG	Negative
TCTTCCTTCTGTTGGA	Negative
TCTTGCGAGCCTCTCT	Negative
TCTTGCGCAATGTTGC	Negative
TCTTGCGGTACAGGTG	Negative
TCTTGCGGTTCTCCAC	Negative
TCTTGCGTCCACTAGA	Negative
TCTTTGAAGTAGGTTA	Negative
TCTTTGAAGTTAACGA	Hashtag10
TCTTTGACACGACGTC	Hashtag9
TCTTTGACAGTAGTGG	Hashtag9
TCTTTGAGTATGCTAC	Negative
TCTTTGATCTCATTAC	Negative
TGAACGTAGAGCTTTC	Negative
TGAACGTAGCATAGGC	Hashtag9
TGAACGTCAAGCGAAC	Negative
TGAACGTCACCTGCTT	Negative
TGAACGTGTGAGATTA	Negative
TGAACGTTCTAGTGTG	Negative
TGAACGTTCTGACAGT	Negative
TGAATCGGTCACTCAA	Negative
TGAATGCCATCCGGTG	Hashtag9
TGAATGCCATCTCATT	Negative
TGAATGCGTGTTCAGT	Negative
TGAATGCTCCGTGTAA	Negative
TGACAGTAGCTAAACA	Hashtag9
TGACAGTAGTGAACAT	Negative
TGACAGTCAGCTGAGA	Hashtag9
TGACAGTGTACAGAGC	Hashtag9
TGACAGTTCAAGTGTC	Negative
TGACAGTTCGGACAAG	Negative
TGACCCTAGGGCCCTT	Negative
TGACCCTAGTCATCCA	Hashtag9
TGACCCTCAATGAACA	Hashtag10
TGACCCTCAGCACACC	Hashtag9
TGACCCTGTACTAACC	Negative
TGACCCTGTAGAGACC	Hashtag9
TGACCCTGTCGTACTA	Negative
TGACCCTTCCGTAATG	Hashtag9
TGACCCTTCCTACAAG	Negative
TGACCCTTCGTTCTGC	Negative
TGACGCGAGGTTGTTC	Hashtag9
TGACGCGAGTACTCGT	Hashtag9
TGACGCGGTCATCGCG	Hashtag9
TGACGCGGTCGTGCCA	Negative
TGACGCGGTGTCTCCT	Negative
TGACGCGGTTACTCAG	Hashtag9
TGACTCCAGGCCTAGA	Negative
TGACTCCCAAGACCTT	Negative
TGACTCCGTTAGAGTA	Hashtag9
TGACTCCTCGATACGT	Negative
TGAGACTAGCATTTCG	Hashtag9
TGAGACTAGCTCGTGC	Hashtag9
TGAGACTCACGTTGGC	Hashtag9
TGAGACTCATTGGCAT	Negative
TGAGACTGTTACCTTT	Negative
TGAGACTTCACCATAG	Negative
TGAGCATAGCACGGAT	Negative
TGAGCATCAACATACC	Hashtag9
TGAGCATGTAGTCCTA	Negative
TGAGCATGTCGAAGCA	Negative
TGAGCATGTGAATTGA	Hashtag9
TGAGCATGTGTCCCTT	Hashtag9
TGAGCATGTGTGTGGA	Hashtag9
TGAGCATTCGTAGCCG	Negative
TGAGCGCCAATGTGGG	Negative
TGAGCGCCAGCTTCCT	Negative
TGAGCGCGTAAGACCG	Negative
TGAGCGCTCTCAACCC	Hashtag9
TGAGGAGAGATGTTCC	Negative
TGAGGAGAGCTGCCTG	Negative
TGAGGAGCAACCAGAG	Negative
TGAGGAGCAAGCCTGC	Negative
TGAGGAGCAATTAGGA	Negative
TGAGGAGGTCCCAAAT	Negative
TGAGGGAAGTACCATC	Negative
TGAGGGAGTATGTCAC	Hashtag10_Hashtag9
TGAGGGATCCATCCGT	Negative
TGAGGGATCGTAGGGA	Negative
TGAGGGATCTCTCTAA	Hashtag10_Hashtag9
TGAGGTTAGCCTGAGA	Hashtag9
TGAGGTTGTTTCCAAG	Negative
TGAGGTTTCAAGAATG	Negative
TGAGGTTTCAGTGCGC	Negative
TGAGGTTTCCTACGGG	Hashtag9
TGAGTCACACTGTGTA	Negative
TGAGTCACAGGCCTGT	Hashtag9
TGAGTCACAGGGACTA	Hashtag9
TGAGTCAGTACCTAAC	Negative
TGAGTCAGTCACCCTT	Negative
TGAGTCATCTAGTTCT	Hashtag9
TGATCAGAGAAATTGC	Negative
TGATCAGAGAAGCTGC	Hashtag9
TGATCAGAGCGCCTCA	Hashtag9
TGATCAGAGGACATCG	Negative
TGATCAGAGGTCGACA	Hashtag9
TGATCAGCACCATAAC	Hashtag10_Hashtag9
TGATCAGGTGATATAG	Negative
TGATCAGGTGGAATGC	Negative
TGATCAGTCGGATACT	Negative
TGATCAGTCTAGAGCT	Hashtag10
TGATCTTAGAGAAGGT	Negative
TGATCTTCACGCGGTT	Negative
TGATCTTTCAACTCTT	Hashtag9
TGATCTTTCGAGAAGC	Hashtag10
TGATCTTTCGGTTAGT	Negative
TGATCTTTCTCTCCGA	Negative
TGATGCAAGACTCTTG	Negative
TGATGCACACGCTGAC	Hashtag10_Hashtag9
TGATGCACACGTAACT	Negative
TGATGCACATGGGTCC	Hashtag9
TGATGCAGTGTATTCG	Negative
TGATGCATCCTTTAGT	Negative
TGATGGTAGTGATCGG	Negative
TGATGGTCACAGAGAC	Negative
TGATGGTGTTGCACGC	Hashtag9
TGATGGTTCAGTCATG	Hashtag9
TGATGGTTCCGAAATC	Hashtag9
TGATTCTAGCAGCCCT	Negative
TGATTCTAGCGCTTCG	Negative
TGATTCTAGCTGGTGA	Hashtag9
TGATTCTCAATGCAAA	Hashtag10
TGATTCTTCGACGAGA	Hashtag9
TGATTTCGTAGCTGTT	Negative
TGATTTCGTCACCTTC	Negative
TGATTTCGTCATCGCG	Negative
TGATTTCGTTCAACGT	Hashtag9
TGATTTCTCATTATCC	Hashtag10
TGCACGGAGGGAGATA	Negative
TGCACGGAGTGACACG	Negative
TGCACGGCATTCACAG	Negative
TGCACGGTCCATTGTT	Negative
TGCAGATCAACGAGGT	Hashtag9
TGCAGATCATTCAGCA	Hashtag9
TGCAGATGTGACCTGC	Hashtag9
TGCAGATTCCACTTCG	Negative
TGCAGATTCTGGTTGA	Hashtag9
TGCAGGCAGACATATG	Negative
TGCAGGCAGTAGTGCG	Negative
TGCAGGCAGTTTCGGT	Negative
TGCAGGCCAGACGATG	Hashtag9
TGCAGGCCATAGAGGC	Negative
TGCAGGCCATCTGGGC	Negative
TGCAGGCGTATCACCA	Negative
TGCAGGCGTCGAGCAA	Negative
TGCAGGCTCTACTTCA	Negative
TGCAGTAAGGCATTTC	Negative
TGCAGTACACATCCCT	Negative
TGCAGTAGTGAATAAC	Negative
TGCAGTAGTGATGAAT	Hashtag9
TGCAGTAGTTCTCGCT	Negative
TGCAGTATCCGTGTAA	Negative
TGCATCCAGCATGCGA	Negative
TGCATCCAGCGAACTG	Negative
TGCATCCAGTATAACG	Negative
TGCATCCCAACGAGGT	Hashtag9
TGCATCCCACTTTAGG	Negative
TGCATCCCAGTTTGGT	Negative
TGCATCCGTAGCTGCC	Negative
TGCATCCGTAGGACCA	Negative
TGCATCCGTCGCTTGG	Negative
TGCATCCGTCTCACAA	Negative
TGCATCCGTGGCTTGC	Negative
TGCATCCTCCACTGGG	Hashtag9
TGCATCCTCGAGCCTG	Hashtag9
TGCATGACAACTTGGT	Negative
TGCATGACAGGTGACA	Negative
TGCATGAGTTGGGACA	Negative
TGCATGATCACACGAT	Hashtag9
TGCATGATCTATGCCC	Hashtag9
TGCCGAGCACACGTGC	Negative
TGCCGAGCATTGTAGC	Hashtag9
TGCCGAGTCCACACAA	Negative
TGCCGAGTCTACTATC	Negative
TGCCGAGTCTTAGGAC	Negative
TGCGACGAGAGAGCCT	Negative
TGCGACGAGGACAAGA	Negative
TGCGACGCAAGTCCCG	Negative
TGCGACGGTAGATCGG	Negative
TGCGACGGTCGGTGAA	Negative
TGCGACGGTCGTCTCT	Negative
TGCGACGGTCGTTGCG	Negative
TGCGACGTCTCTGACC	Negative
TGCGATAAGGCACTAG	Negative
TGCGATAAGGTACAAT	Hashtag9
TGCGATACAGCATCTA	Hashtag9
TGCGATACATCTCCCA	Hashtag9
TGCGATACATTAGGAA	Negative
TGCGATAGTAGTAAGT	Negative
TGCGATAGTTATCCAG	Negative
TGCGATATCTGAGGCC	Negative
TGCGGCACATGGTGGA	Hashtag9
TGCGGCAGTGAGACCA	Negative
TGCGGCATCCCATAAG	Hashtag9
TGCGGCATCTACACAG	Hashtag9
TGCGGGTAGAGATTCA	Negative
TGCGGGTAGCGTTGTT	Negative
TGCGGGTAGGCCGCTT	Hashtag9
TGCGGGTAGTAGCATA	Negative
TGCGGGTCAAGCGGAT	Hashtag9
TGCGGGTTCCACGAAT	Negative
TGCGGGTTCGAGCCAC	Hashtag9
TGCTCCAAGTCTACCA	Hashtag9
TGCTCCACAAGAGTTA	Negative
TGCTCCACATCCGAAT	Negative
TGCTCCACATGCGTGC	Hashtag10
TGCTCCAGTAACATAG	Hashtag9
TGCTCCAGTTTCGTGA	Hashtag10
TGCTCGTCACAGTCGC	Hashtag10
TGCTCGTCAGCCCAGT	Hashtag9
TGCTCGTTCTAGTCAG	Hashtag9
TGCTGAAAGATTAGCA	Negative
TGCTGAAAGGATTTGA	Negative
TGCTGAAAGTATAACG	Negative
TGCTGAACAAATAGCA	Negative
TGCTTCGCACTGAGTT	Negative
TGCTTCGCATCGTGGC	Hashtag9
TGCTTCGGTCATATGC	Negative
TGCTTCGGTCGATGCC	Negative
TGCTTCGGTGATGGCA	Negative
TGCTTCGTCTTGCGCT	Hashtag10
TGCTTGCCATGAGTAA	Negative
TGCTTGCGTGCAGATG	Hashtag9
TGCTTGCGTTGCTCCT	Negative
TGCTTGCTCGGCCCAA	Negative
TGGAACTAGACGCATG	Hashtag9
TGGAACTCACGGCCAT	Hashtag9
TGGAACTCAGACTGCC	Negative
TGGAACTGTACGGATG	Hashtag9
TGGAACTTCAAACCTG	Hashtag9
TGGAACTTCCTACACC	Negative
TGGAGAGCATCAACCA	Hashtag9
TGGAGAGGTATCCCAA	Negative
TGGAGAGGTGGATTTC	Hashtag9
TGGAGAGTCTCTAGGA	Negative
TGGAGGAAGCCTGACC	Negative
TGGAGGACAAGCTGCC	Negative
TGGAGGACACCTGAAT	Negative
TGGAGGACAGCTGTAT	Hashtag9
TGGAGGATCCCGAGTG	Negative
TGGATCAAGCGTCTCG	Negative
TGGATCAAGGCACCAA	Hashtag9
TGGATCAAGGTTGGAC	Hashtag9
TGGATCACAGCGGTCT	Hashtag9
TGGATCAGTAGACTGG	Hashtag9
TGGATGTAGGAGACCT	Negative
TGGATGTAGGGTCTTT	Hashtag9
TGGATGTAGTCGGCAA	Negative
TGGATGTCAAGGCGTA	Negative
TGGATGTCACCATAAC	Negative
TGGATGTCACCCTGAG	Hashtag9
TGGATGTGTAGTCGTT	Negative
TGGATGTGTGACTCGC	Negative
TGGATGTGTTAACCTG	Negative
TGGATGTTCATCACAG	Hashtag9
TGGATGTTCCCTCTCC	Negative
TGGATGTTCGATGCTA	Negative
TGGATGTTCTTTCCAA	Negative
TGGCGTGAGACATAAC	Negative
TGGCGTGAGCAGCCTC	Hashtag9
TGGCGTGAGTGCCCGT	Negative
TGGCGTGCAACCTATG	Negative
TGGCGTGCACACCTGG	Hashtag9
TGGCGTGGTAGACGTG	Negative
TGGCGTGGTTTGTTGG	Negative
TGGCGTGTCGTACCTC	Negative
TGGGAAGAGGCCCACT	Negative
TGGGAAGCAACAGCTT	Negative
TGGGAAGGTAGCGCCT	Hashtag10
TGGGAAGGTGACATCT	Hashtag9
TGGGAAGGTTAATGAG	Negative
TGGGAAGGTTGAAGTA	Negative
TGGGAGAAGAAACCAT	Negative
TGGGAGAAGCCTCACG	Negative
TGGGAGACAATTTCGG	Negative
TGGGAGAGTGAGAGGG	Negative
TGGGAGAGTGGCCCAT	Hashtag9
TGGGAGAGTGTTCATG	Negative
TGGGAGATCAGCCTCT	Negative
TGGGAGATCCATGATG	Negative
TGGGAGATCCTACTGC	Negative
TGGGAGATCGTCCATC	Negative
TGGGATTAGCTACGTT	Hashtag10
TGGGATTAGGCGAACT	Negative
TGGGATTAGGTTCCAT	Negative
TGGGATTGTACGCGTC	Negative
TGGGATTGTGCCCTTT	Hashtag9
TGGGATTTCACCTGGG	Hashtag9
TGGGCGTAGTAGGATT	Negative
TGGGCGTCAACCCTCT	Negative
TGGGCGTCAGTTAAAG	Hashtag9
TGGGCGTCATCGTGCG	Hashtag9
TGGGCGTGTGAGCGAT	Negative
TGGGCGTTCTTGCAAG	Negative
TGGGCTGCAAGGTCAG	Negative
TGGGCTGCACGTAGAG	Negative
TGGGCTGCACTACGGC	Negative
TGGGCTGGTTGGGTAG	Hashtag9
TGGGCTGTCCGCACGA	Negative
TGGGTTAAGGATACGC	Hashtag9
TGGGTTAAGTAGCAAT	Negative
TGGGTTACACAAAGCG	Hashtag9
TGGGTTACAGGTCAAG	Negative
TGGGTTAGTCATTCCC	Negative
TGGGTTAGTTCTCCAC	Hashtag9
TGGTACAAGACCAGAC	Negative
TGGTACAAGAGGTCAC	Negative
TGGTACAAGATGCTTC	Negative
TGGTACAAGCAGCAGT	Negative
TGGTACAAGTCGTCTA	Negative
TGGTACACAACATCGT	Negative
TGGTACAGTAACGCGA	Negative
TGGTACAGTCCCGCAA	Negative
TGGTACAGTGTCATTG	Hashtag9
TGGTACATCACACCGG	Negative
TGGTACATCTATCACT	Negative
TGGTACATCTGGACCG	Negative
TGGTAGTAGACGTCGA	Hashtag9
TGGTAGTAGGGCTTCC	Negative
TGGTAGTAGGTTGGAC	Negative
TGGTAGTCACATTGTG	Negative
TGGTAGTCACTCTAGA	Negative
TGGTAGTGTTGCGGAA	Hashtag9
TGGTAGTTCCCGTGTT	Hashtag9
TGGTAGTTCTCCTGTG	Hashtag9
TGGTAGTTCTGTTGGA	Hashtag9
TGGTGATAGAATTGCA	Hashtag9
TGGTGATAGCCGGAAT	Hashtag9
TGGTGATAGGTCGTCC	Negative
TGGTGATCACAAAGTA	Negative
TGGTGATCAGCTGCCA	Hashtag9
TGGTGATGTAGCCAGA	Negative
TGGTGATGTATCGTTG	Hashtag9
TGGTGATTCGTAATGC	Negative
TGGTGATTCTGCGAGC	Negative
TGGTTAGCAAGCGAGT	Negative
TGGTTAGGTACCTATG	Negative
TGGTTAGGTTCCTACC	Hashtag9
TGGTTAGTCACTCTTA	Negative
TGGTTAGTCATCTGTT	Negative
TGTAACGAGACCACGA	Negative
TGTAACGAGGTGTGAC	Negative
TGTAACGAGTGTTCAC	Negative
TGTAACGCAATACCTG	Negative
TGTAACGCATTCTCCG	Hashtag9
TGTAACGTCGTAACAC	Hashtag9
TGTAACGTCTTCTGTA	Hashtag10_Hashtag9
TGTAACGTCTTGATTC	Hashtag9
TGTAAGCAGGCCACCT	Negative
TGTAAGCAGTAGCAAT	Negative
TGTAAGCCACCAATTG	Hashtag9
TGTAAGCCAGACGCTC	Negative
TGTAAGCGTTCTCACC	Hashtag10
TGTACAGCAAGACAAT	Negative
TGTACAGGTCCGAAAG	Hashtag9
TGTACAGGTCTAACGT	Negative
TGTACAGGTTTAGAGA	Negative
TGTACAGTCTCGGGAC	Hashtag9
TGTAGACAGACCTTTG	Negative
TGTAGACAGATGGCGT	Negative
TGTAGACAGCTTTCCC	Hashtag9
TGTAGACAGTTCGCAT	Negative
TGTAGACGTACAAGCG	Hashtag9
TGTAGACGTCAAATCC	Hashtag9
TGTAGACGTTCCTACC	Negative
TGTAGACTCCGACAGC	Negative
TGTAGACTCCGCGAGT	Hashtag9
TGTCAGAAGCAATAGT	Negative
TGTCAGAAGCTACGTT	Hashtag9
TGTCAGAAGGCTAGCA	Negative
TGTCAGAAGTCCCGGT	Negative
TGTCAGACACTGTGAT	Negative
TGTCAGACATACAGGG	Hashtag9
TGTCAGATCTAGTACG	Negative
TGTCAGATCTCACTCG	Hashtag9
TGTCCACCATCCGGTG	Negative
TGTCCACGTAACAGGC	Negative
TGTCCCATCGCCGAGT	Negative
TGTCCTGAGAGGTCGT	Negative
TGTCCTGAGTAATACG	Hashtag9
TGTCCTGAGTGCTCAT	Negative
TGTCCTGGTACCGGAA	Hashtag9
TGTCCTGTCCGCGAGT	Negative
TGTGAGTCAACCGTGC	Negative
TGTGAGTCAATTCGTG	Hashtag9
TGTGAGTCATAAGCGG	Hashtag9
TGTGAGTTCATCTGTT	Negative
TGTGAGTTCGACGACC	Negative
TGTGAGTTCTTAGGAC	Hashtag9
TGTGATGCATAGATGA	Hashtag9
TGTGATGGTCAGATTC	Negative
TGTGATGGTCAGCGTC	Negative
TGTGCGGAGCAGAAAG	Negative
TGTGCGGAGGTCACCC	Negative
TGTGCGGCAAATCGTC	Hashtag9
TGTGCGGCACGGATCC	Hashtag9
TGTGCGGCAGCTGTCG	Hashtag9
TGTGCGGCAGCTTCCT	Negative
TGTGCGGCAGTGTACT	Hashtag10
TGTGCGGCATGACGGA	Hashtag9
TGTGCGGGTCCCGTGA	Negative
TGTGCGGGTGGCTTGC	Negative
TGTGCGGTCCTACACC	Hashtag9
TGTGCGGTCTGCTAGA	Hashtag9
TGTGGCGAGAAACCAT	Hashtag9
TGTGGCGAGGTAATCA	Negative
TGTGGCGCATGACAAA	Negative
TGTGGCGGTCCCTAAA	Negative
TGTGGCGGTCCTGGGT	Negative
TGTGGCGGTTAATCGC	Hashtag9
TGTGGCGGTTCGTAAC	Negative
TGTGGCGTCACGGTCG	Hashtag9
TGTGGCGTCAGCGCAC	Negative
TGTGTGAAGCCGATTT	Negative
TGTGTGAAGCGACTGA	Negative
TGTGTGAAGGGACTGT	Negative
TGTGTGACATCTCGTC	Negative
TGTGTGAGTATCGTTG	Negative
TGTGTGAGTGAATATG	Negative
TGTGTGATCATTGTTC	Negative
TGTGTGATCGCAGTCG	Negative
TGTGTGATCGTAACTG	Negative
TGTTACTAGACCGTTT	Negative
TGTTACTAGAGGCTGT	Hashtag9
TGTTACTAGCGTGAGT	Negative
TGTTACTAGCGTGCCT	Hashtag9
TGTTACTAGGGCAGGA	Negative
TGTTACTCAATAACGA	Negative
TGTTACTCAATTGCAC	Hashtag9
TGTTACTCAGACCGCT	Negative
TGTTACTGTAGGATAT	Hashtag9
TGTTACTTCCGTATAG	Negative
TGTTACTTCTTCTGGC	Negative
TGTTCATAGCTGCCAC	Negative
TGTTCATAGGTCCGAA	Negative
TGTTCATCACAGTGAG	Negative
TGTTCATGTGGTATGG	Negative
TGTTCATTCACCTCAC	Negative
TGTTCATTCCCATAAG	Hashtag9
TGTTCATTCGCTTGAA	Hashtag9
TGTTCATTCTAGTGTG	Negative
TGTTCCGCAACATCGT	Hashtag9
TGTTCCGCAGAGAATT	Hashtag9
TGTTCCGCAGAGCTAG	Negative
TGTTCCGGTGACTGAG	Negative
TGTTCCGGTTCTTGCC	Negative
TGTTCCGTCTGAGGTT	Negative
TGTTCTAAGTCACTGT	Negative
TGTTCTACAGCTATAC	Negative
TGTTCTACATCATCTT	Hashtag9
TGTTCTAGTGCTGATT	Negative
TGTTCTATCCATTGTT	Hashtag9
TGTTGAGCACATACTG	Negative
TGTTGAGCAGACAAGC	Hashtag9
TGTTGAGCAGGAACCA	Negative
TGTTGAGGTATACCTG	Negative
TGTTGAGGTCGAGTTT	Negative
TGTTGAGGTGGTTTGT	Negative
TGTTGAGGTTGAGGAC	Hashtag9
TGTTGAGGTTGGGATG	Hashtag9
TGTTGAGTCACAATGC	Hashtag9
TGTTGAGTCATCGACA	Negative
TGTTGAGTCCTCACCA	Negative
TGTTGGAAGACGGAAA	Negative
TGTTGGAAGCAATTAG	Hashtag9
TGTTGGAAGGAGATAG	Negative
TGTTGGAAGGATGAGA	Negative
TGTTGGAAGTAGCTCT	Hashtag9
TGTTGGACAAGCGCAA	Hashtag9
TGTTGGAGTTGTGCCG	Negative
TGTTGGATCCACGTAA	Negative
TGTTGGATCCTTCTGG	Negative
TGTTTGTTCACCCTTG	Negative
TGTTTGTTCCGTTTCG	Hashtag9
TTAATCCAGGCTTTCA	Hashtag9
TTAATCCCAACCGGAA	Hashtag10
TTAATCCCATCATGAC	Hashtag9
TTAATCCGTAAGCGGT	Negative
TTAATCCGTACTGACT	Hashtag9
TTAATCCGTTCGGCGT	Negative
TTACAGGCATCCTTCG	Negative
TTACAGGCATGCAGGA	Negative
TTACAGGGTCCCTCAT	Negative
TTACAGGTCGTAGTGT	Negative
TTACCATAGGGCAGGA	Negative
TTACCATCATAAGCGG	Negative
TTACCATCATTAAGCC	Negative
TTACCATGTGAATAAC	Negative
TTACCGCAGATGCCGA	Negative
TTACCGCAGCCTATCA	Hashtag9
TTACCGCAGGAAAGGT	Negative
TTACCGCAGGAGGTTC	Hashtag9
TTACCGCAGTCGGGAT	Negative
TTACCGCCACTCTGCT	Negative
TTACCGCCAGAGTTCT	Negative
TTACCGCGTAATACCC	Negative
TTACCGCGTACCGCGT	Negative
TTACCGCTCAGAGTTC	Negative
TTACCGCTCGACATTG	Negative
TTACGCCAGAGCAGTC	Negative
TTACGCCAGGACGCAT	Negative
TTACGCCAGTCGGCCT	Negative
TTACGCCAGTGCCTCG	Hashtag9
TTACGCCCATCCGAAT	Hashtag9
TTACGCCGTTGATCGT	Negative
TTACGCCTCCGTAATG	Hashtag9
TTACGTTAGAAGAACG	Negative
TTACGTTAGGACGCAT	Negative
TTACGTTAGTAAACTG	Hashtag10
TTACGTTGTCTTACAG	Hashtag9
TTACGTTTCAGTCAGT	Negative
TTACGTTTCGCCATAA	Hashtag10
TTACTGTAGCAACAAT	Negative
TTACTGTAGGGTACGT	Negative
TTACTGTCAAGTATAG	Negative
TTACTGTCATTCTTCA	Negative
TTACTGTGTAATACCC	Negative
TTACTGTTCACCTTAT	Negative
TTACTGTTCATTACGG	Hashtag9
TTACTGTTCCAAATGC	Negative
TTACTGTTCCCAAGCG	Negative
TTACTGTTCTACGGTA	Hashtag9
TTAGGCACAACTCGAT	Negative
TTAGGCACAAGAAACT	Negative
TTAGGCACAATGGCCC	Negative
TTAGGCACAGTAGATA	Negative
TTAGGCAGTTGGAGAC	Hashtag9
TTAGGCATCACTTTGT	Hashtag9
TTAGGCATCCCTCGAT	Negative
TTAGGCATCCTCGCAT	Hashtag9
TTAGGCATCTTACCAT	Negative
TTAGGGTAGATCACCT	Hashtag9
TTAGGGTCAACGTAAA	Negative
TTAGGGTCAATTGTGC	Negative
TTAGGGTGTACAGAAT	Negative
TTAGGGTGTTTCGTGA	Negative
TTAGTCTCACAACATC	Hashtag9
TTAGTCTCACCATATG	Negative
TTAGTCTCACCGGCTA	Hashtag10
TTAGTCTCACGCGCTA	Negative
TTAGTCTCAGACGGAT	Hashtag9
TTAGTCTCATGAGGGT	Negative
TTAGTCTGTACGGCAA	Hashtag9
TTAGTCTGTGGCTGCT	Hashtag9
TTAGTCTTCAAGATAG	Negative
TTAGTCTTCTCCGAGG	Negative
TTAGTCTTCTGATGGT	Hashtag10_Hashtag9
TTATTGCCAGAGTAAT	Hashtag9
TTATTGCCAGTGGCTC	Hashtag9
TTATTGCGTCGTAATC	Hashtag9
TTATTGCTCGCTGTCT	Negative
TTCAATCAGGGACTGT	Negative
TTCAATCCACTTGGCG	Negative
TTCAATCCAGGTTACT	Hashtag9
TTCAATCGTCCCGGTA	Negative
TTCAATCGTTGACTAC	Negative
TTCACCGAGCAGGGAG	Hashtag9
TTCACCGGTAAGGCCA	Negative
TTCACCGTCACTTATC	Negative
TTCACGCAGAAGGGAT	Negative
TTCACGCAGCGATGCA	Negative
TTCACGCAGTTTGGCT	Hashtag9
TTCACGCCAAATGGTA	Negative
TTCACGCCACCAGGTC	Negative
TTCACGCCATAGCTGT	Negative
TTCACGCCATCACAGT	Negative
TTCACGCCATCGCTCT	Hashtag9
TTCACGCGTAAGTCAA	Negative
TTCACGCGTCCATCTC	Hashtag9
TTCACGCGTCGACTGC	Hashtag9
TTCACGCTCCCAAGCG	Hashtag10
TTCACGCTCGGCATAT	Hashtag9
TTCACGCTCTCGAACA	Negative
TTCAGGAAGAGTGAAG	Negative
TTCAGGAAGCAGCACA	Negative
TTCAGGAAGTAAACTG	Hashtag9
TTCAGGACATTGCCGG	Negative
TTCAGGAGTACCTTCC	Negative
TTCAGGAGTATAATGG	Negative
TTCAGGATCGTCTCAC	Negative
TTCAGGATCTCGCTCA	Hashtag9
TTCATGTCAACATACC	Negative
TTCATGTCAATTGCTG	Negative
TTCATGTCACAAGTTC	Negative
TTCATGTCACCTAAAC	Hashtag9
TTCATGTGTATTAAGG	Hashtag9
TTCATGTGTCTAGTGT	Negative
TTCATGTGTTGTGTAC	Hashtag10
TTCATGTTCGGTCAGC	Negative
TTCATGTTCTCCTGCA	Hashtag9
TTCATTGCAAGGACAC	Negative
TTCATTGCAGCTGGTC	Negative
TTCATTGGTCCACACG	Negative
TTCATTGGTTAACCTG	Negative
TTCATTGGTTAGCGGA	Negative
TTCATTGGTTCGGCTG	Negative
TTCATTGTCAGTCTTT	Negative
TTCATTGTCGCTTGAA	Hashtag9
TTCCAATAGAATGTTG	Negative
TTCCAATCAACAGAGC	Negative
TTCCAATGTGCATCTA	Negative
TTCCAATGTTGCGGAA	Hashtag9
TTCCACGAGAGCGACT	Hashtag10
TTCCACGAGCAAGTGC	Negative
TTCCACGCACGACAGA	Negative
TTCCACGCAGAAGTGC	Negative
TTCCACGCATAGATCC	Negative
TTCCACGCATGGCCAC	Hashtag9
TTCCACGGTAATCAAG	Hashtag9
TTCCACGGTCTAGTGT	Hashtag9
TTCCACGGTTCCTACC	Negative
TTCCACGTCGACCAAT	Hashtag9
TTCCGGTAGAAACTCA	Hashtag9
TTCCGGTAGAAGCGAA	Negative
TTCCGGTAGCACTCGC	Negative
TTCCGGTAGTTGTACC	Hashtag9
TTCCGGTCAAGATCCT	Hashtag9
TTCCGGTCACAGAGCA	Negative
TTCCGGTGTGAAGCGT	Negative
TTCCGGTGTGGCTTGC	Negative
TTCCGGTGTGTTAGCT	Hashtag9
TTCCGGTTCATTTACC	Negative
TTCCGGTTCCGCACTT	Hashtag9
TTCCGTGAGCGTGCCT	Hashtag9
TTCCGTGCACCAATTG	Negative
TTCCGTGCACTTCAGA	Negative
TTCCGTGCATAATCCG	Hashtag9
TTCCGTGTCCGCAACG	Negative
TTCCGTGTCCGTAATG	Negative
TTCCGTGTCCTACCAC	Hashtag9
TTCCGTGTCCTGTACC	Hashtag9
TTCCGTGTCCTTATAC	Negative
TTCCGTGTCGATACGT	Negative
TTCCTAAGTGACTCGC	Negative
TTCCTAAGTTTACCAG	Negative
TTCCTAATCCACGGGT	Hashtag9
TTCCTAATCCTGGCTT	Negative
TTCCTCTAGATTGTGA	Hashtag9
TTCCTCTAGTACAACA	Hashtag10
TTCCTCTCAATCGCCG	Negative
TTCCTCTCAGGCATTT	Negative
TTCCTCTGTAAGATAC	Hashtag9
TTCCTCTTCAACACGT	Negative
TTCCTCTTCACATTGG	Negative
TTCCTCTTCAGAATAG	Hashtag9
TTCCTCTTCTGCAGCG	Negative
TTCCTTCAGAGGACTC	Negative
TTCCTTCAGAGTAACT	Hashtag9
TTCCTTCAGATCCCGC	Negative
TTCCTTCCAAGATTGA	Hashtag9
TTCCTTCCAAGTGGCA	Negative
TTCCTTCCAGACATCT	Hashtag9
TTCCTTCGTTCATCGA	Negative
TTCCTTCTCCACCCTA	Negative
TTCCTTCTCGGTGCAC	Hashtag9
TTCGATTAGCGAGTCA	Hashtag9
TTCGATTAGGCCTTGC	Negative
TTCGATTCATTCAGCA	Negative
TTCGATTGTCTCAGGC	Hashtag9
TTCGATTTCACGGACC	Negative
TTCGATTTCCTCAGAA	Hashtag9
TTCGATTTCTAGCAAC	Hashtag10
TTCGATTTCTGAGATC	Hashtag9
TTCGCTGGTATACCTG	Hashtag9
TTCGCTGGTCGAAACG	Hashtag9
TTCGCTGGTTAGGCTT	Negative
TTCGCTGGTTGTGGAG	Negative
TTCGCTGTCGAAGGAC	Hashtag9
TTCGCTGTCGGATACT	Hashtag9
TTCGGTCAGCTGGTGA	Negative
TTCGGTCCAACGGGTA	Negative
TTCGGTCCACCTCGTT	Negative
TTCGGTCCAGTTCACA	Negative
TTCGGTCGTAATTAGG	Negative
TTCGGTCGTAGACAAT	Hashtag10
TTCGGTCGTTCTGAGT	Hashtag9
TTCGGTCTCGGATAAA	Hashtag9
TTCGGTCTCGTTCGCT	Hashtag9
TTCTAACAGCCGTAAG	Negative
TTCTAACGTACACGCC	Negative
TTCTAACGTAGATGTA	Hashtag9
TTCTAACGTCATGACT	Hashtag9
TTCTAACGTCTGTGTA	Negative
TTCTAACTCACTCCGT	Hashtag9
TTCTAGTCACTCCGGA	Hashtag9
TTCTAGTCAGCATGCC	Negative
TTCTAGTCATTGGCAT	Negative
TTCTAGTGTCGGCCTA	Negative
TTCTAGTGTCTGTGCG	Hashtag9
TTCTAGTGTTAACAGA	Negative
TTCTAGTGTTCGTTCC	Negative
TTCTAGTTCATTGTGG	Negative
TTCTAGTTCGTAGAGG	Hashtag9
TTCTCTCAGGACTATA	Negative
TTCTCTCAGGCCCACT	Negative
TTCTCTCCAAAGTGTA	Hashtag10
TTCTCTCCAATCGCCG	Negative
TTCTCTCCAGCCTATA	Negative
TTCTCTCCAGCGAACA	Negative
TTCTCTCCATCATCTT	Hashtag9
TTCTCTCGTGGTCTGC	Hashtag9
TTCTGTAAGATGCTAA	Hashtag9
TTCTGTAAGCGTTCAT	Negative
TTCTGTAAGGCTCACC	Hashtag9
TTCTGTAAGGTGCGAT	Negative
TTCTGTAAGTACCGGA	Negative
TTCTGTACAATGTGGG	Negative
TTCTGTACAGCACACC	Negative
TTCTGTACAGCAGATG	Negative
TTCTGTACAGGCGTTC	Negative
TTCTGTACATCCTTCG	Hashtag9
TTCTGTAGTGATACTC	Negative
TTCTGTAGTGGACTAG	Negative
TTCTGTATCATTTACC	Hashtag9
TTCTGTATCATTTGTC	Negative
TTCTTCCAGGCATTTC	Negative
TTCTTCCCAAACGTGG	Negative
TTCTTCCCAAGCGCTC	Negative
TTCTTCCTCACCGGGT	Negative
TTCTTGAAGTGAACAT	Hashtag9
TTCTTGACAAAGAACT	Hashtag9
TTCTTGACAATAGGGC	Hashtag9
TTCTTGAGTGCAACAG	Hashtag9
TTGAACGCACGATTCA	Hashtag9
TTGAACGGTACACGTT	Hashtag9
TTGAACGTCTCCATAT	Hashtag9
TTGACCCAGAAGTGTT	Negative
TTGACCCAGCCTCCAG	Hashtag9
TTGACCCAGTGGAAAG	Hashtag9
TTGACCCCAACTGAAA	Hashtag9
TTGACCCCACAAGTGG	Hashtag9
TTGACCCCACACCTAA	Negative
TTGACCCCAGCAGTGA	Negative
TTGACCCGTCTTCATT	Negative
TTGACCCTCCCATTCG	Hashtag9
TTGAGTGCAATGTCAC	Hashtag9
TTGAGTGCAGCACAGA	Hashtag9
TTGAGTGGTGTTACAC	Negative
TTGAGTGGTTTACCAG	Hashtag9
TTGAGTGTCAAGCCAT	Negative
TTGATGGAGAAGTGTT	Negative
TTGATGGAGAGAATCT	Negative
TTGATGGAGCGACTGA	Negative
TTGATGGAGGCCTAGA	Negative
TTGATGGCAATTAGGA	Hashtag9
TTGATGGCACGCCAGT	Negative
TTGATGGCACGGGTAA	Hashtag9
TTGATGGGTGAGCGAT	Hashtag9
TTGATGGTCTGCTTTA	Negative
TTGCATTAGTTGGAGC	Hashtag9
TTGCATTCACGACGAA	Hashtag9
TTGCATTCACTAGAGG	Negative
TTGCATTGTAGGATAT	Hashtag9
TTGCATTTCATCGCCT	Negative
TTGCATTTCCTTCTTC	Negative
TTGCATTTCGAGATAA	Negative
TTGCATTTCTCGACGG	Negative
TTGCCTGAGTGCCAGA	Hashtag9
TTGCCTGCAATCCTAG	Hashtag9
TTGCCTGGTCCGTTTC	Hashtag9
TTGCCTGGTTCTCAGA	Hashtag9
TTGCCTGTCCCGAACG	Negative
TTGCCTGTCGCTGATA	Negative
TTGCCTGTCTAGCATG	Hashtag9
TTGCGTCAGATGATTG	Negative
TTGCGTCAGCAATTAG	Hashtag9
TTGCGTCCAATTTCCT	Hashtag9
TTGCGTCTCCACTGAA	Hashtag9
TTGCGTCTCTCTATAC	Negative
TTGCTGCAGGGTGAGG	Negative
TTGCTGCCAAGCGATG	Hashtag10
TTGCTGCCAGAACATA	Negative
TTGCTGCCAGATCATC	Negative
TTGCTGCGTCAAATCC	Negative
TTGCTGCGTTAATCGC	Hashtag9
TTGCTGCTCACCTACC	Hashtag9
TTGGATGAGATCACTC	Negative
TTGGATGCAACCAACT	Negative
TTGGATGCAGTCTGGC	Negative
TTGGATGGTCGGTGTC	Hashtag9
TTGGGATAGTCCCTAA	Hashtag10
TTGGGATAGTTGCATC	Negative
TTGGGATCATAGTCAC	Negative
TTGGGATTCATCGCCT	Hashtag9
TTGGGATTCATTACGG	Hashtag9
TTGGGATTCGCAATTG	Negative
TTGGGCGGTACTCCGG	Negative
TTGGGCGGTGGAACAC	Negative
TTGGGCGTCGGTCTGG	Negative
TTGGGTAAGTGGTTAA	Hashtag9
TTGGGTACAGTCCCGA	Hashtag10
TTGGGTAGTGTCCCTT	Negative
TTGGGTATCCCGAGAC	Hashtag9
TTGGTTTAGCGTTACT	Hashtag9
TTGGTTTCACTAGAGG	Negative
TTGGTTTCAGCAGACA	Negative
TTGGTTTGTTTGACAC	Negative
TTGGTTTTCTTAGTTC	Hashtag9
TTGTGGAAGCATGATA	Hashtag9
TTGTGGAAGCCGATCC	Hashtag9
TTGTGGAAGGAATTAC	Negative
TTGTGGACAACACTAC	Hashtag10
TTGTGGACAAGCTGTT	Negative
TTGTGGACATACAGCT	Negative
TTGTGGAGTCCGGCAT	Hashtag9
TTGTGGATCCTTCTGG	Negative
TTGTGTTCATCATGAC	Negative
TTGTGTTGTTACGCCG	Negative
TTGTGTTTCCAGTTCC	Negative
TTGTGTTTCCGCACTT	Negative
TTGTTCAAGACTAAGT	Negative
TTGTTCACACATAACC	Negative
TTGTTCACACCCATAA	Negative
TTGTTCACAGGATGAC	Hashtag9
TTGTTCAGTACGTACT	Negative
TTGTTCAGTAGAAACT	Negative
TTGTTCAGTCGGATTT	Negative
TTGTTCAGTGGACAGT	Negative
TTGTTGTAGTATGAAC	Hashtag9
TTGTTGTGTAAGATTG	Hashtag9
TTGTTGTGTGCGGTAA	Hashtag9
TTGTTGTTCGTACCTC	Negative
TTGTTTGAGAAGCGGG	Negative
TTGTTTGCAGTTGGTT	Negative
TTGTTTGGTTCCACAA	Negative
TTGTTTGTCAAGCTGT	Negative
TTTACCAAGCATATGA	Negative
TTTACCAAGGGAGGCA	Hashtag9
TTTACCACAAACTGCT	Hashtag9
TTTACCACACTCCACT	Hashtag9
TTTACCACAGTAACAA	Hashtag9
TTTACCAGTATGCGGA	Hashtag9
TTTACCAGTCTCAGAT	Hashtag9
TTTACCATCGAATGCT	Negative
TTTACCATCGCAGTGC	Negative
TTTACGTGTAACAGGC	Negative
TTTACGTGTTGTGCAT	Hashtag9
TTTACGTTCAACTGGT	Hashtag9
TTTACGTTCAACTTTC	Hashtag9
TTTACGTTCTTTCCGG	Negative
TTTACTGCACCGGAAA	Negative
TTTACTGCACGCACCA	Negative
TTTACTGCAGGCACAA	Negative
TTTACTGGTGGAACAC	Negative
TTTACTGTCCCGTGAG	Hashtag9
TTTACTGTCCGCTAGG	Hashtag9
TTTAGTCAGTCTCTGA	Negative
TTTAGTCCAAGTAGTA	Negative
TTTAGTCCATACAGAA	Negative
TTTAGTCCATCAACCA	Negative
TTTAGTCCATTGCCTC	Negative
TTTAGTCGTATACCTG	Hashtag9
TTTAGTCGTCCTCCTA	Negative
TTTAGTCGTCTCGCGA	Hashtag9
TTTAGTCGTGAGATTA	Negative
TTTAGTCGTGGACAGT	Hashtag9
TTTAGTCTCAATCTTC	Negative
TTTAGTCTCGAGTCTA	Negative
TTTAGTCTCGGTGCAC	Hashtag9
TTTATGCAGCAACTTC	Negative
TTTATGCAGCTATCTG	Negative
TTTATGCAGTATGACA	Negative
TTTATGCCATGAAAGT	Hashtag9
TTTATGCGTTAACCTG	Hashtag9
TTTATGCGTTTGGGAG	Hashtag9
TTTATGCTCTAGTGTG	Hashtag9
TTTCACAAGCACTTTG	Negative
TTTCACACAACCAACT	Negative
TTTCACACAAGCAGGT	Negative
TTTCACACATATCGGT	Negative
TTTCACAGTGTTGAGG	Negative
TTTCACATCACCCATC	Negative
TTTCACATCCATTTGT	Negative
TTTCACATCGTTCGCT	Hashtag9
TTTCAGTAGCGTCAAG	Hashtag9
TTTCAGTGTCCACACG	Negative
TTTCAGTGTCCCGCAA	Negative
TTTCAGTGTCGTTGGC	Negative
TTTCAGTGTGTATACC	Negative
TTTCAGTGTTGGACTT	Negative
TTTCAGTGTTTGGGTT	Negative
TTTCAGTTCTAGGCAT	Hashtag9
TTTCATGAGATGCAGC	Negative
TTTCATGAGTCACAGG	Negative
TTTCATGCAACGGTAG	Negative
TTTCATGCACATCCCT	Negative
TTTCATGCATCGAAGG	Negative
TTTCATGGTTCCGTTC	Negative
TTTCATGTCAAGGAGC	Negative
TTTCATGTCACGGAGA	Negative
TTTCATGTCGCTGATA	Negative
TTTCCTCAGGTAAGAG	Negative
TTTCCTCCACCACATA	Hashtag10
TTTCCTCGTAAGTTGA	Hashtag10
TTTCCTCTCATTGCTT	Negative
TTTCCTCTCCATTTGT	Negative
TTTCCTCTCTACTGAG	Negative
TTTCGATAGCACTTTG	Negative
TTTCGATAGGGACCAT	Negative
TTTCGATCACGCGTCA	Hashtag10
TTTCGATCAGCTGTGC	Negative
TTTCGATGTCCGGCAT	Hashtag9
TTTCGATGTTGCCAAT	Negative
TTTCGATTCACTTATC	Hashtag9
TTTCGATTCGAGCTGC	Hashtag9
TTTCGATTCGCTCCTA	Hashtag9
TTTCGATTCTCATAGG	Hashtag10
TTTCGATTCTCTTGCG	Negative
TTTGACTCAAACGTGG	Hashtag9
TTTGACTCAAATGAAC	Hashtag9
TTTGACTCAAGACTGG	Hashtag9
TTTGACTCAGTACTAC	Negative
TTTGACTCATGTTACG	Negative
TTTGACTGTCCGATCG	Negative
TTTGACTTCCCGTAAA	Negative
TTTGACTTCCGTCCTA	Hashtag10
TTTGATCAGAGCATTA	Hashtag9
TTTGATCAGATAGGGA	Hashtag9
TTTGATCCAATGAGCG	Hashtag9
TTTGATCGTAACACGG	Negative
TTTGATCGTGTCTCCT	Negative
TTTGGAGAGCAGGTCA	Negative
TTTGGAGAGGGCAGGA	Negative
TTTGGAGCAACAGCTT	Negative
TTTGGAGCATGATCTG	Negative
TTTGGAGGTCGTATGT	Negative
TTTGGAGGTGAGAGGG	Hashtag9
TTTGGAGTCCATTGCC	Hashtag9
TTTGGAGTCGACCAAT	Negative
TTTGGAGTCGGCTGGT	Hashtag9
TTTGGTTAGGCTTCCG	Hashtag9
TTTGGTTAGTGTTGTC	Negative
TTTGGTTCAGCATGCC	Hashtag9
TTTGGTTTCAAGTGGG	Negative
TTTGGTTTCACCTTGC	Hashtag9
TTTGGTTTCCATAGGT	Negative
TTTGTTGAGATTGAGT	Hashtag9
TTTGTTGAGCCTGACC	Hashtag9
TTTGTTGAGGAGCAAA	Hashtag9
TTTGTTGCAGGATTCT	Hashtag9
TTTGTTGGTACCCGCA	Negative
TTTGTTGGTATAGGGC	Hashtag9
TTTGTTGGTCACAGAG	Negative
TTTGTTGGTGCAACGA	Hashtag9
TTTGTTGGTTATGTCG	Negative
TTTGTTGTCATCTATC	Hashtag9
TTTGTTGTCCCTCTAG	Hashtag9
TTTGTTGTCGGTCGGT	Negative
TTTGTTGTCTTTCGAT	Hashtag9
