cells	sample
AAACCCAAGCGTATGG	Negative
AAACCCACAAGAGGCT	Negative
AAACCCACACCAGACC	Negative
AAACCCACAGAGCCCT	Negative
AAACCCACAGCGTACC	Negative
AAACCCAGTCCAAAGG	Negative
AAACCCATCCTTGAAG	Negative
AAACGAACACTACGGC	Negative
AAACGAACATACCATG	Negative
AAACGAATCGGAATGG	Negative
AAACGCTAGCGTCTGC	Hashtag6
AAACGCTAGGTAGCAC	Hashtag6
AAACGCTCACTGTCCT	Negative
AAACGCTCATGTTCAG	Hashtag6_Hashtag8
AAACGCTTCACACCCT	Hashtag6
AAACGCTTCATCGCAA	Negative
AAACGCTTCCTGCTAC	Negative
AAACGCTTCTACTGAG	Hashtag6
AAAGAACCATAGGTAA	Hashtag6
AAAGAACGTAGCGATG	Negative
AAAGGATAGGTTACCT	Hashtag6
AAAGGATAGTCAGCCC	Hashtag6
AAAGGATCACAGCCAC	Negative
AAAGGATCACTCTCGT	Negative
AAAGGATCAGCTCTGG	Hashtag6
AAAGGATGTCATCCGG	Negative
AAAGGATTCCACAGCG	Hashtag8
AAAGGATTCTGCGGAC	Negative
AAAGGGCCAATACGAA	Negative
AAAGGGCGTCACAGTT	Negative
AAAGGGCGTCCTGAAT	Negative
AAAGGTACATAGCTGT	Negative
AAAGGTAGTTCAGGTT	Negative
AAAGGTATCCGAACGC	Hashtag6
AAAGTCCAGCTATCCA	Negative
AAAGTCCGTACCCGAC	Negative
AAAGTCCTCTCCAAGA	Negative
AAAGTGAAGGCTTAGG	Hashtag6
AAAGTGACACAACGAG	Hashtag6
AAAGTGACACGCACCA	Hashtag6
AAAGTGAGTTCTCCTG	Hashtag6_Hashtag8
AAAGTGAGTTGTCATG	Negative
AAAGTGATCACGGGCT	Negative
AAAGTGATCCAATCCC	Negative
AAAGTGATCGAGCACC	Negative
AAAGTGATCTCGCCTA	Negative
AAATGGAAGAGTCTTC	Hashtag6
AAATGGAAGCACGATG	Negative
AAATGGACAGTAACCT	Hashtag6
AAATGGACATTGGATC	Hashtag6
AACAAAGAGACTGTTC	Negative
AACAAAGAGAGGTGCT	Hashtag6_Hashtag8
AACAAAGAGAGTATAC	Negative
AACAAAGCAAGGCGTA	Hashtag6_Hashtag8
AACAAAGCAGCGTGCT	Negative
AACAAAGGTTTAGTCG	Negative
AACAACCCACGACAGA	Negative
AACAACCCACGTTCGG	Negative
AACAACCGTCAGATTC	Hashtag6
AACAACCGTCCCTGTT	Hashtag6
AACAACCTCATGGATC	Negative
AACAACCTCCGTGGCA	Negative
AACAACCTCGTCTACC	Negative
AACAAGACAAATGCTC	Negative
AACAAGAGTAAGTTAG	Hashtag6_Hashtag8
AACAAGAGTACTCGCG	Hashtag8
AACAAGAGTAGAATGT	Hashtag6
AACAAGAGTGATTAGA	Negative
AACAAGATCCATCTAT	Hashtag6
AACACACAGGTAGACC	Hashtag6_Hashtag8
AACACACAGTCCCGGT	Negative
AACACACCAGGAATAT	Hashtag6
AACACACGTCCTACAA	Negative
AACAGGGAGATTCGAA	Hashtag8
AACAGGGCACACAGCC	Negative
AACAGGGCAGACCTGC	Negative
AACAGGGGTAGTATAG	Negative
AACAGGGGTGGTAACG	Negative
AACAGGGTCGTCTAAG	Hashtag6
AACCAACGTCACTTAG	Negative
AACCAACTCATGCATG	Negative
AACCACAAGTCTAGAA	Negative
AACCACAAGTGCTCAT	Negative
AACCACACAATCGAAA	Negative
AACCACACACGGTGAA	Hashtag6
AACCACACAGCTAACT	Hashtag6
AACCACAGTCATCAGT	Negative
AACCACAGTGATTCAC	Negative
AACCACAGTGCATACT	Hashtag6
AACCACAGTGGCTCTG	Negative
AACCATGAGCTGTCCG	Hashtag6
AACCATGCACCTATCC	Negative
AACCATGCATGACGTT	Hashtag6
AACCATGGTAGGATAT	Hashtag6
AACCATGTCTGGTTGA	Negative
AACCCAAAGCTGACAG	Hashtag6_Hashtag8
AACCCAACACTAGGTT	Hashtag6
AACCCAACATGTCTAG	Negative
AACCCAATCCTTCTGG	Negative
AACCCAATCTGTCGCT	Negative
AACCTGAAGGGTACAC	Negative
AACCTGAAGTGCGCTC	Hashtag6
AACCTGAGTCGTCGGT	Negative
AACCTGATCTTAGGAC	Negative
AACCTTTAGCGCCATC	Negative
AACCTTTAGGAGAATG	Hashtag6
AACCTTTCAAATGAGT	Negative
AACCTTTCAAGTGGAC	Negative
AACCTTTGTAGAGCTG	Hashtag6
AACCTTTGTCTCACAA	Negative
AACGAAAAGAGGATGA	Negative
AACGAAAAGGTACCTT	Negative
AACGAAACATGACAGG	Hashtag6_Hashtag8
AACGAAAGTATAGGAT	Hashtag6
AACGAAAGTGACCGAA	Negative
AACGGGAAGCAGATAT	Negative
AACGGGACAGCGACAA	Negative
AACGGGAGTATGGAGC	Hashtag6
AACGGGAGTTCCAAAC	Negative
AACGGGATCGCTGTCT	Hashtag6
AACGTCAGTATGCAAA	Negative
AACGTCAGTTGGTGTT	Hashtag6_Hashtag8
AACGTCATCAAGAATG	Hashtag6
AACTTCTAGCCATTGT	Negative
AACTTCTAGGTCCCGT	Negative
AACTTCTCAAATCAGA	Negative
AACTTCTCAGTGTGCC	Negative
AACTTCTCATTGCAAC	Hashtag6_Hashtag8
AACTTCTGTGGCTTAT	Negative
AACTTCTGTGGGAGAG	Negative
AAGAACAAGAAGAGCA	Negative
AAGAACAAGACTGTTC	Hashtag8
AAGAACATCACGACTA	Negative
AAGAACATCGGAGTAG	Hashtag6
AAGACAAAGCGAGAAA	Negative
AAGACAACATGAGATA	Hashtag6
AAGACAAGTACCGTCG	Hashtag8
AAGACAATCAGGAGAC	Negative
AAGACAATCATGCATG	Negative
AAGACAATCGACGCTG	Hashtag6
AAGACTCAGTTCAACC	Hashtag6_Hashtag8
AAGACTCCAGTTGTTG	Negative
AAGACTCGTTGAAGTA	Negative
AAGACTCTCATCCTGC	Negative
AAGATAGAGCCTCATA	Hashtag6
AAGATAGAGGCACTCC	Negative
AAGATAGTCGAGAGAC	Negative
AAGATAGTCGCGATCG	Hashtag6
AAGCATCAGCAACCAG	Hashtag6
AAGCATCAGTTCATGC	Negative
AAGCCATCAAGCAGGT	Hashtag6
AAGCCATCATACCATG	Hashtag6
AAGCCATGTAACATAG	Hashtag6
AAGCCATGTCACCTTC	Negative
AAGCGAGAGTAGTCTC	Hashtag6
AAGCGAGCAGTATGAA	Negative
AAGCGAGGTGGTACAG	Hashtag6
AAGCGAGTCAGCATTG	Hashtag6
AAGCGTTAGGTTCAGG	Hashtag6
AAGCGTTAGTCATTGC	Hashtag6_Hashtag8
AAGCGTTCAAAGAACT	Negative
AAGCGTTCACTAACGT	Negative
AAGCGTTCATCCAACA	Negative
AAGCGTTGTGGCTACC	Hashtag6
AAGCGTTTCAGTCACA	Hashtag6
AAGCGTTTCTACGCGG	Hashtag6
AAGCGTTTCTGGCCGA	Negative
AAGGAATCATCATTGG	Hashtag6
AAGGAATCATGTTCGA	Negative
AAGGAATGTCCAGGTC	Negative
AAGGTAAAGCGGGTTA	Negative
AAGGTAAAGTGCACAG	Hashtag6_Hashtag8
AAGGTAACACGCGTGT	Negative
AAGGTAACAGTTAGGG	Negative
AAGGTAAGTAGCGATG	Negative
AAGGTAAGTAGGAAAG	Negative
AAGGTAAGTTAAACAG	Negative
AAGGTAAGTTTGTTGG	Negative
AAGTACCCAGGACATG	Hashtag6
AAGTACCTCCTGTTGC	Negative
AAGTACCTCTTCCGTG	Negative
AAGTCGTAGGCACCAA	Negative
AAGTCGTAGGTCGTAG	Negative
AAGTCGTAGTGGCGAT	Hashtag6
AAGTCGTAGTTTGCTG	Negative
AAGTCGTGTGAAAGTT	Negative
AAGTCGTTCGCAGAGA	Hashtag6
AAGTCGTTCGGTATGT	Negative
AAGTGAACAACGCATT	Hashtag6
AAGTGAAGTCGACGCT	Negative
AAGTGAATCACCCTCA	Negative
AAGTTCGAGAATTGTG	Negative
AAGTTCGAGATTAGCA	Hashtag6_Hashtag8
AAGTTCGAGCGTGAGT	Hashtag6
AAGTTCGTCGGAAACG	Negative
AATAGAGAGGTGGGTT	Hashtag6
AATAGAGAGTTTGCTG	Hashtag6
AATAGAGCAAGGACAC	Negative
AATAGAGCACCGTCGA	Hashtag6
AATAGAGTCGAGCTGC	Negative
AATCACGGTAACAGTA	Negative
AATCACGGTCATCCCT	Negative
AATCACGGTTATTCCT	Negative
AATCGACGTCACTCTC	Negative
AATCGTGGTCCAGCGT	Negative
AATCGTGTCATCACTT	Negative
AATCGTGTCTCGGTAA	Negative
AATGAAGAGCGTGCCT	Negative
AATGAAGCAACAGCCC	Negative
AATGAAGCAATACCTG	Negative
AATGAAGCAGTCCCGA	Negative
AATGAAGGTCAACCTA	Hashtag6
AATGAAGTCGCTAGCG	Negative
AATGACCAGCGGGTTA	Negative
AATGACCAGGCTCCCA	Negative
AATGACCCAACTCGAT	Negative
AATGACCCACACGCCA	Hashtag6
AATGCCAGTCATACCA	Negative
AATGCCAGTGATCGTT	Negative
AATGGCTAGCGTCAGA	Negative
AATGGCTAGGATTTCC	Negative
AATGGCTAGTCTTCCC	Negative
AATGGCTCAAGTCGTT	Negative
AATGGCTGTGTCCTAA	Negative
AATGGCTGTTTCCCAC	Hashtag8
AATGGCTTCCTCTCTT	Hashtag6
AATTCCTAGAAATTCG	Negative
AATTCCTAGACCAAGC	Negative
AATTCCTAGAGCTGAC	Hashtag6
AATTCCTCATTGACCA	Hashtag6
AATTTCCAGAACCCGA	Negative
AATTTCCGTATAGGGC	Hashtag8
AATTTCCGTGTGCCTG	Hashtag6
AATTTCCGTTAGGGTG	Hashtag6
AATTTCCTCGCTCCTA	Negative
AATTTCCTCTATTCGT	Hashtag6
ACAAAGAAGATGTTAG	Hashtag6
ACAAAGACAAATGCTC	Negative
ACAAAGACAATTGCAC	Negative
ACAAAGAGTACCCACG	Negative
ACAAAGATCGCAGAGA	Hashtag6
ACAACCAAGGGCAAGG	Negative
ACAACCAAGTTCACTG	Negative
ACAACCAAGTTGGGAC	Negative
ACAACCACACCACTGG	Hashtag6_Hashtag8
ACAACCAGTTAAAGTG	Negative
ACAACCATCTACGCGG	Negative
ACAAGCTAGGGTAATT	Hashtag6
ACAAGCTCAGCTGCCA	Hashtag8
ACAAGCTCAGTGTATC	Hashtag8
ACAAGCTTCAGCTGTA	Hashtag6
ACAAGCTTCTTGTTAC	Negative
ACACAGTCAGCTGTTA	Hashtag6_Hashtag8
ACACCAAAGGTTTACC	Negative
ACACCAACAATGTTGC	Hashtag6
ACACCAACAGCGACAA	Negative
ACACCAAGTACCGGCT	Negative
ACACCAAGTGTCCAAT	Negative
ACACGCGAGTCAACAA	Hashtag6
ACACGCGGTCTGTGCG	Negative
ACACGCGGTGCCGTAC	Negative
ACACTGAAGGCACAAC	Hashtag6
ACACTGAAGGCCCGTT	Hashtag6
ACACTGACAAGAATAC	Negative
ACACTGAGTCAACCTA	Negative
ACACTGAGTGCGTTTA	Hashtag8
ACAGAAACACGCGCTA	Hashtag6
ACAGAAAGTCGTTTCC	Negative
ACAGAAAGTGCTCGTG	Negative
ACAGAAAGTGGACTGA	Hashtag6
ACAGAAAGTGGTTTAC	Negative
ACAGCCGAGGCGTTAG	Hashtag6
ACAGCCGCAGCATACT	Negative
ACAGCCGGTACGAGCA	Negative
ACAGCCGGTCGAAACG	Negative
ACAGCCGGTGAGTAAT	Negative
ACAGCCGTCTCATTAC	Negative
ACAGGGACAAGTGATA	Hashtag8
ACAGGGACACACAGCC	Negative
ACAGGGAGTAGGCTGA	Negative
ACAGGGAGTTGCCGAC	Hashtag6
ACATCCCAGCGCAATG	Negative
ACATCCCAGCTTACGT	Negative
ACATCCCGTTTACCAG	Negative
ACATCGAAGAACTTCC	Hashtag6
ACATCGACACGCGTGT	Hashtag8
ACATCGACACTTGTCC	Negative
ACATCGATCCTGGGAC	Negative
ACATCGATCTCGCCTA	Negative
ACATGCAAGAAACCAT	Hashtag6
ACATGCACAATAGAGT	Negative
ACATGCACACTTTATC	Negative
ACATGCAGTGTTATCG	Negative
ACATGCAGTTCGAACT	Negative
ACATTTCCAAGTGCAG	Negative
ACATTTCCATTACTCT	Hashtag6
ACATTTCTCATCGACA	Hashtag6
ACATTTCTCTCATTTG	Negative
ACCAAACAGTGTAGTA	Negative
ACCAAACCACGACCTG	Negative
ACCAAACCACGCTGTG	Negative
ACCAAACGTCCAGTTA	Negative
ACCAAACTCCTTATGT	Hashtag6
ACCAACACAAAGCAAT	Negative
ACCAACACAAGAGTAT	Hashtag6
ACCAACAGTATCTCGA	Negative
ACCAACAGTGATTCTG	Negative
ACCAACAGTTTGTTCT	Negative
ACCAACATCCATAGAC	Negative
ACCAACATCGTAGTGT	Negative
ACCACAAAGAGAGGGC	Hashtag6
ACCACAAAGCTTTCCC	Negative
ACCACAAAGTCGAAAT	Negative
ACCACAAGTTTCACAG	Hashtag6
ACCATTTAGCTGTGCC	Negative
ACCATTTGTGCTAGCC	Negative
ACCATTTTCAGCCTTC	Negative
ACCATTTTCGTGCACG	Negative
ACCCAAAAGCATAGGC	Negative
ACCCAAAGTGTTGAGG	Hashtag6_Hashtag8
ACCCTCAAGCTGCCTG	Negative
ACCCTCACATGGGTTT	Negative
ACCCTCAGTGCAATGG	Negative
ACCCTCAGTGGATGAC	Negative
ACCCTCATCAATCCGA	Hashtag6
ACCCTCATCACTACTT	Negative
ACCCTCATCTAGCCAA	Negative
ACCCTCATCTGATGGT	Negative
ACCCTTGAGATGGTCG	Negative
ACCCTTGGTGTAAACA	Negative
ACCCTTGTCCTCTCGA	Negative
ACCGTTCCATTGAGGG	Hashtag6
ACCGTTCGTCTGCGCA	Negative
ACCGTTCGTGGCCCAT	Negative
ACCGTTCGTTTGCAGT	Negative
ACCGTTCTCACCGCTT	Negative
ACCTACCCAGCATACT	Hashtag6
ACCTACCGTGCATGAG	Negative
ACCTACCTCTGCGATA	Hashtag6
ACCTGAATCTGATGGT	Hashtag6
ACCTGAATCTGGCCGA	Negative
ACCTGTCAGACCAACG	Negative
ACCTGTCAGATTGCGG	Hashtag6
ACCTGTCAGCCTCCAG	Negative
ACGATCAAGGTCACAG	Hashtag6
ACGATCAAGTACTCGT	Negative
ACGATCACATGGTACT	Negative
ACGATCAGTCACGACC	Negative
ACGATCAGTGGCTGAA	Hashtag6_Hashtag8
ACGATGTAGCTATCCA	Negative
ACGATGTCAACTGGTT	Hashtag6
ACGATGTTCACGTAGT	Hashtag8
ACGCACGAGCCAGAGT	Negative
ACGCACGAGTTAGTGA	Negative
ACGCACGGTGGAGAAA	Hashtag6
ACGCACGGTTGTCTAG	Negative
ACGCACGTCACTTATC	Negative
ACGCACGTCTCGAGTA	Hashtag6
ACGGAAGCAAGATGTA	Hashtag6_Hashtag8
ACGGAAGTCAAGCCGC	Negative
ACGGAAGTCCTCTAAT	Negative
ACGGAAGTCGTGCATA	Hashtag6_Hashtag8
ACGGGTCCACCTCAGG	Negative
ACGGTCGAGATCCCGC	Negative
ACGGTCGAGTAATCCC	Negative
ACGGTCGCACAACGCC	Hashtag6
ACGGTCGTCATCGGGC	Negative
ACGGTCGTCCGGTTCT	Negative
ACGGTCGTCCTCGATC	Negative
ACGGTCGTCGGCCAAC	Hashtag6
ACGGTTACAGCGAGTA	Negative
ACGGTTATCGCCAATA	Negative
ACGGTTATCGTCTAAG	Negative
ACGTAACAGCCAAGGT	Negative
ACGTAACAGTCACAGG	Negative
ACGTAACAGTCATGAA	Hashtag6
ACGTAACCAGTTTGGT	Hashtag6
ACGTAACGTCATGCAT	Hashtag8
ACGTAACGTCTTACTT	Negative
ACGTACAAGTGAGCCA	Negative
ACGTACACACACGGTC	Hashtag6_Hashtag8
ACGTACATCAGGTAAA	Negative
ACGTACATCGCTTGAA	Hashtag6
ACGTAGTAGGCCACCT	Negative
ACGTAGTAGTGGATAT	Hashtag6
ACGTAGTCACAGTCGC	Hashtag6
ACGTAGTTCAGCAATC	Hashtag6
ACGTTCCAGGTTAGTA	Hashtag8
ACGTTCCCAGGATCTT	Hashtag6
ACGTTCCCATTACTCT	Hashtag6
ACGTTCCGTAACACGG	Hashtag8
ACTACGACAATACGAA	Hashtag6_Hashtag8
ACTATCTCACGGGTAA	Hashtag6
ACTATCTCAGAATGTA	Negative
ACTATGGGTGGAATGC	Negative
ACTATGGGTTGCTCAA	Hashtag6
ACTATGGTCCATTGTT	Negative
ACTATGGTCCGTGACG	Hashtag6
ACTATTCAGGTCGTGA	Hashtag8
ACTCCCAAGATGAAGG	Negative
ACTCCCACAGGAAGTC	Negative
ACTCTCGAGCTACAAA	Negative
ACTCTCGCACGCGCAT	Negative
ACTCTCGGTAACACCT	Negative
ACTCTCGGTGCAATGG	Negative
ACTCTCGGTGCCGTAC	Hashtag6
ACTCTCGTCCATGAGT	Negative
ACTCTCGTCTTCCCGA	Negative
ACTGATGAGAAGTCCG	Hashtag6
ACTGATGCACTCCTGT	Hashtag6
ACTGATGCAGGATCTT	Hashtag6
ACTGATGGTACCCGAC	Negative
ACTGATGGTGAGGATC	Negative
ACTGATGGTGTCTTGA	Negative
ACTGATGGTTCCTAAG	Negative
ACTGATGGTTCGATTG	Hashtag6
ACTGATGTCAATCCAG	Hashtag6_Hashtag8
ACTGCAAAGCGGGTTA	Hashtag6_Hashtag8
ACTGCAACAGCGTGCT	Negative
ACTGCAACATGTTTGG	Negative
ACTGCAATCACTCCGT	Negative
ACTGTCCAGAAGTATC	Negative
ACTGTCCAGGGCTGAT	Hashtag8
ACTGTCCAGTTGAAGT	Negative
ACTGTCCCACCCTAAA	Hashtag6
ACTGTCCCACTGGAAG	Negative
ACTGTCCCAGGTGAGT	Negative
ACTGTCCGTACCAATC	Hashtag6
ACTGTCCGTAGTGTGG	Negative
ACTGTGAGTGGAATGC	Hashtag6
ACTGTGAGTTCTGACA	Negative
ACTGTGATCCATCCGT	Hashtag6
ACTTAGGAGACGATAT	Hashtag6
ACTTAGGCACCTGTCT	Negative
ACTTAGGCAGCGGTCT	Hashtag6
ACTTAGGCAGTTAGGG	Negative
ACTTAGGGTAACGCGA	Negative
ACTTAGGGTGTTTGCA	Negative
ACTTAGGGTTAAGAAC	Negative
ACTTAGGGTTTCTATC	Negative
ACTTATCCAATCTCGA	Hashtag6
ACTTATCCACTTGAAC	Negative
ACTTATCGTGGTTTAC	Negative
ACTTCCGAGCGTCTGC	Negative
ACTTCCGAGGTACTGG	Hashtag8
ACTTCCGAGGTCCCTG	Negative
ACTTCCGCAAGCCCAC	Negative
ACTTCCGCAAGTCCCG	Hashtag6
ACTTCCGCATCCTAAG	Hashtag6
ACTTCCGGTTGGACTT	Hashtag6
ACTTCCGTCCATCTAT	Negative
ACTTCCGTCGAGAGAC	Negative
ACTTCGCAGCTGGAGT	Negative
ACTTCGCAGTACTGTC	Negative
ACTTCGCCACTACCGG	Hashtag6
ACTTCGCTCAAGAGTA	Negative
ACTTCGCTCGTTCCCA	Negative
ACTTCGCTCTAACGCA	Negative
ACTTCGCTCTCATGCC	Negative
ACTTTCAAGGCCTTGC	Negative
ACTTTCAAGTCGAGGT	Negative
ACTTTCACAAACCATC	Negative
ACTTTCACACGGCCAT	Negative
ACTTTCATCGTCTAAG	Negative
ACTTTGTAGTTGCCTA	Negative
ACTTTGTCATGCGGTC	Negative
ACTTTGTGTGGAGAAA	Hashtag6
AGAAATGAGTCAGAGC	Negative
AGAAATGCAGCCCACA	Negative
AGAAATGCAGCCGTCA	Hashtag6
AGAAATGGTCCTGGTG	Negative
AGAACAACAATACGCT	Negative
AGAACAACACGCGTCA	Hashtag6
AGAACAACACTACGGC	Negative
AGAACAATCAGAGCGA	Hashtag6
AGAACAATCCGGTAAT	Hashtag6
AGAACAATCGAACACT	Hashtag6_Hashtag8
AGAACCTAGCTGAGCA	Negative
AGAACCTAGTAGATCA	Negative
AGAACCTAGTGACACG	Hashtag6
AGAACCTGTGAAGCTG	Negative
AGAAGCGAGCTGTTAC	Hashtag6
AGAAGCGGTAGTCGTT	Hashtag6_Hashtag8
AGAAGCGGTGTTGAGG	Hashtag8
AGAAGCGTCAGCACCG	Negative
AGAAGTAAGCTAGATA	Hashtag6_Hashtag8
AGAAGTACATGATGCT	Negative
AGAAGTATCACCATAG	Hashtag6
AGACAAAGTAGAGTTA	Hashtag6
AGACAAAGTGGACAGT	Hashtag6
AGACAAATCCAACTGA	Negative
AGACAAATCCACAGGC	Negative
AGACAAATCTACGGTA	Negative
AGACACTAGCGAAACC	Negative
AGACACTCAGACCAAG	Negative
AGACACTGTGATACCT	Hashtag6_Hashtag8
AGACACTTCAAAGACA	Negative
AGACACTTCCGTGGTG	Hashtag6
AGACACTTCGCACTCT	Negative
AGACAGGAGCGGGTAT	Hashtag6
AGACAGGAGGAATCGC	Negative
AGACAGGTCAGTGCGC	Hashtag6
AGACCATGTACAACGG	Hashtag6
AGACCATGTCTCGCGA	Hashtag6
AGACCATGTGCCGGTT	Negative
AGACCATTCATGAAAG	Hashtag6
AGACCATTCTGCCTCA	Negative
AGACCCGAGCCTATTG	Negative
AGACCCGGTGGCTTAT	Negative
AGACCCGGTTTCGACA	Negative
AGACCCGTCACCGCTT	Negative
AGACCCGTCTGTGCAA	Negative
AGACTCAAGGCTTCCG	Hashtag6
AGACTCAAGGGAACAA	Negative
AGACTCACAGTTGAAA	Negative
AGACTCAGTTCGAGCC	Negative
AGACTCATCTTCACAT	Hashtag6
AGAGAATCAACATACC	Negative
AGAGAATCAGACACAG	Negative
AGAGAATCATAACCCA	Negative
AGAGAATCATCAGTGT	Negative
AGAGAATGTATCGAAA	Negative
AGAGAATTCGACATAC	Hashtag8
AGAGAGCCAAGAAATC	Negative
AGAGAGCTCCAGTGTA	Negative
AGAGAGCTCCATCTCG	Negative
AGAGCAGAGCTCACTA	Negative
AGAGCAGAGTCATGGG	Hashtag6
AGAGCAGCACTGCGTG	Hashtag6
AGAGCAGTCCGTCAAA	Hashtag6
AGAGCCCCAACTTGGT	Negative
AGAGCCCCAGGGATAC	Negative
AGAGCCCGTGCCCGTA	Negative
AGAGCCCTCTAGACCA	Negative
AGATAGAAGTTGAAAC	Negative
AGATAGACATTACGGT	Hashtag6
AGATAGAGTGCCCAGT	Negative
AGATAGAGTTGCTAGT	Negative
AGATAGATCACCCATC	Negative
AGATAGATCCGTGGCA	Negative
AGATCCAAGCGACCCT	Negative
AGATCCACAGTCCCGA	Negative
AGATCCAGTTAGAGTA	Negative
AGATCCATCGGTAAGG	Negative
AGATCGTAGCAAGCCA	Hashtag6_Hashtag8
AGATCGTCATGGGATG	Hashtag6
AGATCGTGTGGCTACC	Negative
AGATCGTGTGTCCGTG	Negative
AGATCGTTCCTCATAT	Negative
AGATCGTTCTCCGATC	Negative
AGATGAAAGGATTTAG	Hashtag6
AGATGAACAATACCTG	Negative
AGATGAAGTACTGACT	Negative
AGATGAAGTCATCACA	Negative
AGATGCTCAACGGCCT	Negative
AGATGCTCATCATCCC	Negative
AGATGCTGTGAGTAGC	Negative
AGCATCAAGTACCATC	Negative
AGCATCAAGTCACTCA	Hashtag6
AGCATCACATCAGCGC	Negative
AGCATCAGTGAGACCA	Hashtag8
AGCATCATCAAGTCGT	Negative
AGCCAATAGGCCGCTT	Negative
AGCCAATGTACCCGAC	Negative
AGCCAATTCTCTATGT	Negative
AGCCACGCACAAGCTT	Negative
AGCCACGTCAACGAGG	Negative
AGCCACGTCCGGTAGC	Negative
AGCCACGTCTACCCAC	Negative
AGCCAGCAGTAAGCAT	Negative
AGCCAGCGTTACACAC	Negative
AGCCAGCTCCGGCAGT	Negative
AGCCAGCTCCTATTGT	Negative
AGCGATTAGGTAGCAC	Negative
AGCGATTGTATCAGCT	Hashtag6
AGCGATTTCGTCGATA	Negative
AGCGCCAAGACCAAGC	Negative
AGCGCCAAGCTGAAAT	Negative
AGCGCCACATTCTGTT	Hashtag6
AGCGCTGAGCCGTTAT	Negative
AGCGCTGGTGAAAGTT	Negative
AGCGCTGTCCAACTAG	Hashtag6
AGCGTATCAGCCGTTG	Negative
AGCGTATGTCTAACGT	Hashtag6
AGCGTATGTGCCTTTC	Hashtag6
AGCGTATGTTCAAACC	Hashtag6
AGCGTATTCCGTGTCT	Hashtag8
AGCGTCGAGCATATGA	Negative
AGCGTCGAGGACGCAT	Hashtag6
AGCGTCGGTTTGGAGG	Negative
AGCTACACAATGTTGC	Negative
AGCTACAGTCCGTTTC	Negative
AGCTACATCAAGGACG	Negative
AGCTACATCGCTCTCA	Hashtag6
AGCTCAAAGTGCTCAT	Hashtag6_Hashtag8
AGCTCAACAATGTTGC	Negative
AGCTCAACACTATGTG	Negative
AGCTCAATCGGTCGAC	Hashtag6
AGCTTCCAGAGTCAAT	Negative
AGCTTCCAGGCCATAG	Negative
AGCTTCCCACTCGATA	Hashtag6
AGCTTCCGTAACATAG	Negative
AGCTTCCGTCGCATCG	Hashtag6
AGCTTCCTCGAGATGG	Negative
AGCTTCCTCTTCGATT	Hashtag6
AGGAAATGTAGCCAGA	Negative
AGGAAATGTCGTGGAA	Hashtag6
AGGAAATGTGCAACAG	Hashtag6_Hashtag8
AGGAAATTCTTCTAAC	Negative
AGGAATACAACGACAG	Negative
AGGAATACAGATTCGT	Hashtag6_Hashtag8
AGGAATAGTCGTACTA	Negative
AGGAATAGTTCGAGCC	Hashtag6_Hashtag8
AGGACGAAGACATAGT	Negative
AGGACGAAGGATGTTA	Hashtag6
AGGACGAAGTCTGCAT	Negative
AGGACGAGTTGGAGGT	Negative
AGGACGATCATTGAGC	Negative
AGGACGATCTAAGGAA	Negative
AGGACTTAGATACAGT	Negative
AGGACTTCAAAGGGCT	Hashtag6
AGGACTTCACACTGGC	Negative
AGGACTTCATGGAGAC	Negative
AGGACTTGTCCCTCAT	Negative
AGGACTTGTCGTAATC	Hashtag6
AGGACTTGTCGTCTCT	Hashtag6
AGGACTTTCGCATTGA	Hashtag6
AGGACTTTCTGACCCT	Hashtag6_Hashtag8
AGGACTTTCTGTAAGC	Negative
AGGAGGTCAGGCCTGT	Negative
AGGAGGTTCTATTGTC	Hashtag6
AGGATAACAAGATCCT	Hashtag6
AGGATAACACGGAAGT	Hashtag6
AGGATAAGTGAGGCAT	Hashtag6
AGGATAAGTTAAGGGC	Negative
AGGATAAGTTACGCCG	Negative
AGGATAAGTTGCGAAG	Negative
AGGATAAGTTTACCTT	Negative
AGGATCTGTTACCCAA	Negative
AGGATCTTCTCATTTG	Negative
AGGCATTAGCATGATA	Negative
AGGCATTAGCGCCGTT	Hashtag8
AGGCATTAGTGGACTG	Hashtag6
AGGCATTCACGGCGTT	Hashtag6
AGGCATTGTATCGAGG	Hashtag6
AGGCATTGTGCAGTGA	Negative
AGGCATTGTGGCGTAA	Hashtag8
AGGCATTTCCGTCCTA	Negative
AGGCATTTCGATGCTA	Negative
AGGCCACAGGTGCGAT	Hashtag6
AGGCCACAGTCGGCCT	Negative
AGGCCACCATTAAGCC	Negative
AGGCCACGTCAGGAGT	Hashtag6
AGGCCACTCGATCCAA	Negative
AGGCCACTCTGAGCAT	Negative
AGGCTGCAGGCCTTCG	Negative
AGGCTGCCATTAAGCC	Negative
AGGGAGTAGGCGCTTC	Negative
AGGGAGTCAAGTGGGT	Hashtag6
AGGGCCTCATCAGTGT	Negative
AGGGCCTGTGCATGAG	Negative
AGGGCTCAGTGTTGAA	Negative
AGGGCTCGTCCTCCAT	Hashtag6
AGGGCTCGTTTGGCTA	Negative
AGGGCTCTCTGATGGT	Hashtag6
AGGGTCCAGTCCTGCG	Hashtag6
AGGGTCCTCGCGGTAC	Negative
AGGGTGAAGGTCCAGA	Hashtag6
AGGGTGACAAGAGATT	Hashtag6
AGGGTGATCGGTTCAA	Hashtag6_Hashtag8
AGGGTTTCACCAGCTG	Hashtag6
AGGGTTTCATCCTTGC	Negative
AGGGTTTTCCTGGTCT	Hashtag6
AGGTAGGAGTGGAAGA	Negative
AGGTAGGGTTGACGGA	Negative
AGGTAGGTCCGAACGC	Negative
AGGTAGGTCGGACTTA	Negative
AGGTAGGTCTCAGGCG	Hashtag6
AGGTCATAGACTCATC	Negative
AGGTCATAGCAAGTGC	Hashtag8
AGGTCATCAGCATGCC	Negative
AGGTCATGTGGCTTGC	Negative
AGGTCATGTGGTCTTA	Negative
AGGTCTACACCAGGTC	Negative
AGGTCTAGTCCCGCAA	Negative
AGGTCTATCTTCCTAA	Negative
AGGTCTATCTTCGGAA	Hashtag6
AGGTGTTCACGGATCC	Negative
AGGTGTTGTTCGGCCA	Negative
AGGTGTTTCTTAGGAC	Hashtag6
AGGTTACAGACGATAT	Negative
AGGTTACCAAGAAACT	Negative
AGGTTACCACAACGAG	Negative
AGGTTACCATGAAGCG	Negative
AGGTTACGTAGCCCTG	Hashtag6
AGGTTACTCTGCGTCT	Hashtag6
AGGTTACTCTTCCACG	Hashtag6
AGGTTGTAGGATTTGA	Hashtag6
AGGTTGTAGGCGTTGA	Hashtag6
AGGTTGTAGTGAGTGC	Hashtag6
AGGTTGTCAGAACCGA	Negative
AGGTTGTCATGAGGGT	Negative
AGGTTGTGTAAGCTCT	Hashtag6_Hashtag8
AGGTTGTGTGGACCAA	Negative
AGGTTGTTCCAGCCTT	Negative
AGTAACCAGACTTCCA	Negative
AGTAACCCAATACGAA	Negative
AGTAACCTCCTACGAA	Hashtag6
AGTACCAAGAAGCGGG	Negative
AGTACCACACTTGAGT	Hashtag6
AGTACCATCACCTCTG	Negative
AGTACCATCTAGAACC	Negative
AGTACCATCTTGTGCC	Negative
AGTACTGAGCCATCCG	Hashtag6_Hashtag8
AGTACTGAGGTGCCAA	Negative
AGTACTGGTTATAGAG	Hashtag6_Hashtag8
AGTAGCTCAACAGCCC	Negative
AGTAGCTGTCCATAGT	Negative
AGTAGCTTCACCATGA	Hashtag6
AGTAGCTTCGACCCAG	Hashtag6
AGTAGCTTCTCAGAAC	Negative
AGTAGCTTCTGCGATA	Hashtag6_Hashtag8
AGTAGTCGTCCAATCA	Negative
AGTAGTCGTGTTCATG	Negative
AGTCAACCAAGGCAAC	Negative
AGTCAACCAATGTGGG	Negative
AGTCAACCATCATCTT	Negative
AGTCAACCATGACGGA	Negative
AGTCAACTCCTTGGAA	Hashtag6
AGTCACAAGCACTCGC	Negative
AGTCACAAGTACGTCT	Negative
AGTCACAGTGCTGTCG	Negative
AGTCATGAGAATACAC	Hashtag6
AGTCATGCACAGACGA	Hashtag6_Hashtag8
AGTCATGCACAGCCTG	Hashtag6
AGTCATGCAGCGACCT	Negative
AGTCTCCAGAATTGTG	Negative
AGTCTCCCACATCATG	Negative
AGTCTCCCAGAAGTTA	Hashtag6
AGTCTCCCAGCTTCGG	Hashtag6
AGTCTCCGTCAGGAGT	Hashtag6
AGTCTCCGTTTGAACC	Negative
AGTCTCCTCCTCACCA	Negative
AGTGACTAGCAAATCA	Negative
AGTGACTCATGCTGCG	Hashtag6_Hashtag8
AGTGACTGTCTCACGG	Negative
AGTGACTGTGACGCCT	Hashtag6
AGTGACTGTGTTAACC	Negative
AGTGATCAGGTCTTTG	Negative
AGTGATCCAGCAGTAG	Negative
AGTGATCGTACCCGAC	Hashtag6
AGTGATCGTTCGGACC	Negative
AGTGATCTCTCCTACG	Negative
AGTGCCGAGAGAGGTA	Negative
AGTGCCGAGGCTAACG	Negative
AGTGCCGCAAGCGCAA	Negative
AGTGCCGGTAGACAAT	Negative
AGTGCCGGTCACGCTG	Negative
AGTGCCGTCGAACTCA	Negative
AGTGCCGTCGTCACCT	Negative
AGTGTTGAGATCACTC	Hashtag6
AGTGTTGAGATCCCAT	Negative
AGTGTTGAGGTCACCC	Negative
AGTGTTGCAACCAGAG	Negative
AGTGTTGCACTTCATT	Hashtag6
AGTGTTGGTAACTAAG	Negative
AGTGTTGGTCGGTAAG	Negative
AGTTAGCAGCTGAAGC	Negative
AGTTAGCCAGCTGAGA	Negative
AGTTAGCCATTAGGAA	Negative
AGTTAGCTCCTAGCGG	Negative
AGTTCCCGTCCTACGG	Negative
AGTTCCCGTTACCCTC	Negative
AGTTCGAAGGAACATT	Hashtag6
AGTTCGACAAGGTCGA	Negative
AGTTCGACAGATCACT	Negative
AGTTCGACAGCGTAGA	Negative
AGTTCGACAGCTTCCT	Negative
AGTTCGAGTGACTGAG	Negative
ATACCGAAGTAACCGG	Negative
ATACCGACAACGGTAG	Negative
ATACCGACATCCTTCG	Hashtag6
ATACCGACATGTTACG	Hashtag6
ATACCGAGTAGTGATA	Negative
ATACCTTCACCTTCGT	Hashtag6
ATACCTTGTATCGGTT	Negative
ATACTTCTCGGCTTGG	Negative
ATAGACCGTCCTACAA	Hashtag6_Hashtag8
ATAGAGAAGGACAACC	Hashtag6
ATAGAGACATGACAAA	Hashtag6
ATAGAGAGTACTTGTG	Negative
ATAGAGAGTCACCTTC	Negative
ATAGGCTCAACTGATC	Negative
ATAGGCTCATCAGTGT	Hashtag6
ATAGGCTTCATCGCAA	Negative
ATAGGCTTCCAAGAGG	Negative
ATAGGCTTCGGTCAGC	Negative
ATAGGCTTCTGTCGCT	Negative
ATATCCTAGTAGGATT	Hashtag6
ATATCCTAGTGGCCTC	Negative
ATATCCTCACTGCATA	Hashtag6
ATATCCTTCACGGACC	Negative
ATCACAGAGGCCTAAG	Hashtag6_Hashtag8
ATCACAGGTACGTGTT	Negative
ATCACAGGTGCATTAC	Negative
ATCACAGGTGGCCCAT	Negative
ATCACAGGTTGCTCCT	Negative
ATCACAGTCCGACGGT	Hashtag6
ATCACGACACCTTCCA	Hashtag6_Hashtag8
ATCACGACATCTTTCA	Hashtag6
ATCACGACATGACTCA	Negative
ATCACGATCAAGTTGC	Hashtag6
ATCACGATCAATCTTC	Hashtag6
ATCACTTAGTGAGTTA	Negative
ATCACTTGTATTTCCT	Negative
ATCACTTTCAGATGCT	Negative
ATCACTTTCCACTTCG	Negative
ATCAGGTAGCTAAGTA	Hashtag6
ATCAGGTCAACCGACC	Negative
ATCAGGTCATCCCGTT	Negative
ATCAGGTGTCCTTGTC	Negative
ATCAGGTGTTAGGGTG	Hashtag6
ATCAGGTTCTAACACG	Negative
ATCATTCAGGCCTTGC	Negative
ATCATTCGTCCACAGC	Negative
ATCATTCTCGAGAAAT	Negative
ATCCACCGTAACACCT	Negative
ATCCACCTCTGCACCT	Negative
ATCCATTCAGAACTAA	Negative
ATCCATTGTCTTACTT	Hashtag6
ATCCATTTCAGTCTTT	Hashtag8
ATCCCTGCAAGGCTTT	Negative
ATCCCTGCAAGTATCC	Negative
ATCCCTGCACAAACGG	Negative
ATCCCTGCACGGTGTC	Hashtag6
ATCCCTGCAGTTCCAA	Negative
ATCCCTGGTCCACGCA	Negative
ATCCCTGGTTTGTGGT	Negative
ATCCGTCAGGTAAGTT	Negative
ATCCGTCCAGATTCGT	Negative
ATCCGTCGTCCTGAAT	Hashtag6
ATCCTATAGCACGGAT	Negative
ATCCTATCAGTCTACA	Negative
ATCCTATCATCCTTGC	Hashtag6_Hashtag8
ATCCTATTCAAGGAGC	Negative
ATCGATGAGGCGAACT	Negative
ATCGATGAGTTTCGGT	Negative
ATCGATGGTAACGGTG	Negative
ATCGCCTAGGATTTCC	Negative
ATCGCCTAGTAACAGT	Negative
ATCGCCTAGTACAACA	Hashtag6
ATCGCCTCAGACATCT	Negative
ATCGCCTCATGGATCT	Negative
ATCGCCTGTACGTGAG	Hashtag6_Hashtag8
ATCGCCTGTGGGCTTC	Negative
ATCGCCTGTGGTTTGT	Hashtag6
ATCGCCTTCAACGAGG	Negative
ATCGCCTTCATCTACT	Negative
ATCGCCTTCCAGTGTA	Negative
ATCGCCTTCGATAACC	Hashtag6
ATCGCCTTCGTTCCTG	Hashtag6
ATCGGATAGAGCAACC	Hashtag6
ATCGGATAGGACTAAT	Negative
ATCGGATCAATAGTGA	Negative
ATCGGATGTCGCTTGG	Hashtag6
ATCGGATTCCGCAACG	Negative
ATCGGATTCGTGACTA	Hashtag6
ATCGGATTCTCATTAC	Negative
ATCGGCGAGGATGAGA	Hashtag8
ATCGGCGAGTACAGAT	Hashtag6
ATCGGCGTCAGACCCG	Negative
ATCGGCGTCCGATGCG	Negative
ATCGGCGTCCTCTAGC	Negative
ATCGGCGTCGTCAAAC	Negative
ATCGGCGTCTTACGGA	Hashtag6_Hashtag8
ATCGTAGGTATCGAGG	Hashtag6
ATCGTCCAGGTCGCCT	Hashtag6
ATCGTCCCAACAAGAT	Hashtag6
ATCGTCCCACAGAAGC	Negative
ATCGTCCCACGTCGGT	Negative
ATCGTCCTCTGTCGCT	Negative
ATCGTGATCCCTCTAG	Hashtag6
ATCGTGATCGAGCCTG	Negative
ATCGTGATCGTAGGGA	Negative
ATCTCTAAGATTTGCC	Negative
ATCTCTAAGCAACTTC	Negative
ATCTCTAAGGACTTCT	Hashtag6
ATCTCTAAGGAGAGGC	Hashtag6
ATCTCTACAAATGATG	Negative
ATCTCTAGTCCGATCG	Hashtag6_Hashtag8
ATCTCTAGTGGGTTGA	Negative
ATCTCTATCTACACAG	Negative
ATCTCTATCTTAGTTC	Negative
ATCTTCAAGAAATCCA	Negative
ATCTTCAAGTATGGAT	Hashtag6_Hashtag8
ATCTTCACATACTGTG	Negative
ATCTTCAGTCGCGTTG	Negative
ATCTTCAGTCTCGGGT	Negative
ATCTTCATCCTCACGT	Negative
ATCTTCATCCTTCTAA	Negative
ATCTTCATCTCCGAGG	Hashtag6_Hashtag8
ATGAAAGCAATCGCAT	Negative
ATGAAAGCACCTATCC	Hashtag6
ATGAAAGGTACTGTTG	Negative
ATGAAAGGTGACGTCC	Negative
ATGAAAGGTTACCTTT	Negative
ATGAAAGTCAAGTGTC	Negative
ATGACCAAGTTTCGAC	Hashtag6
ATGACCACACGGCCAT	Negative
ATGACCACAGACAAGC	Negative
ATGAGGGAGCACACAG	Hashtag6
ATGAGGGAGGAGTCTG	Hashtag8
ATGAGGGCAACGGCTC	Negative
ATGAGGGCACTGAATC	Negative
ATGAGGGGTGCCCGTA	Negative
ATGAGGGGTGTTTCTT	Hashtag8
ATGAGGGTCTATACGG	Negative
ATGAGTCCAATTGCAC	Negative
ATGAGTCCACCCGTAG	Negative
ATGAGTCCACGTTGGC	Negative
ATGAGTCCAGGAACCA	Negative
ATGAGTCGTACCAGAG	Negative
ATGAGTCTCGGTAGAG	Negative
ATGCATGAGCTAGAGC	Negative
ATGCATGCAATTTCTC	Negative
ATGCATGGTACAGTAA	Negative
ATGCATGGTACATTGC	Hashtag6
ATGCATGGTCTAGGCC	Negative
ATGCCTCAGCATCCCG	Negative
ATGCCTCCACCTCGTT	Negative
ATGCCTCGTACAGAAT	Negative
ATGCCTCGTACGGCAA	Hashtag6
ATGCCTCTCAATCTCT	Negative
ATGCCTCTCATATGGC	Hashtag6
ATGCCTCTCATGGATC	Negative
ATGCCTCTCGCGCCAA	Negative
ATGCGATGTGCTCCGA	Hashtag6
ATGCGATGTTCGTTCC	Hashtag6
ATGCGATTCACTACTT	Negative
ATGCGATTCCGGACGT	Hashtag6
ATGCGATTCCTCGCAT	Hashtag6
ATGGAGGAGGTGATCG	Hashtag8
ATGGAGGCAACTTGCA	Negative
ATGGAGGGTCTCCTGT	Hashtag6
ATGGATCCAGGCGAAT	Negative
ATGGATCGTACTGCGC	Hashtag6_Hashtag8
ATGGGAGAGTCTACCA	Hashtag6
ATGGGAGAGTGCAACG	Negative
ATGGGAGCAACGGGTA	Hashtag6_Hashtag8
ATGGGAGCAGGTGAGT	Hashtag8
ATGGGAGGTAGCGAGT	Hashtag6
ATGGGAGGTATGCTTG	Hashtag6
ATGGGAGTCAAAGACA	Hashtag6
ATGGGTTAGACGTCGA	Negative
ATGGGTTAGGTACAAT	Negative
ATGGGTTCAAGCACAG	Hashtag6
ATGGGTTCACACCGAC	Negative
ATGGGTTTCACGGGCT	Negative
ATGGGTTTCCAGTGCG	Negative
ATGGGTTTCTCTAGGA	Negative
ATGGTTGTCGAGTTGT	Hashtag6
ATGGTTGTCTTCCTAA	Hashtag8
ATGTCCCAGCAACAGC	Negative
ATGTCCCTCAATGTCG	Negative
ATGTCCCTCACGACTA	Negative
ATGTCTTAGCCTAGGA	Negative
ATGTCTTAGGTTGTTC	Negative
ATGTCTTCAGGGACTA	Negative
ATGTCTTTCGGTGTAT	Hashtag6
ATGTCTTTCGTAACCA	Hashtag6
ATTACCTAGCATGATA	Hashtag6_Hashtag8
ATTACCTAGTTGTCGT	Hashtag6_Hashtag8
ATTACCTTCTCCCATG	Hashtag6
ATTACCTTCTTCTAAC	Negative
ATTACTCAGAATAACC	Negative
ATTACTCCACGAGGTA	Hashtag6
ATTACTCTCATGAAAG	Negative
ATTATCCAGAATAGTC	Negative
ATTATCCAGGGCAATC	Hashtag8
ATTATCCCAGATCATC	Hashtag6
ATTATCCCAGATCCAT	Negative
ATTATCCGTAATTGGA	Hashtag8
ATTATCCGTCCGGATC	Negative
ATTCACTAGAAGCGAA	Hashtag6_Hashtag8
ATTCACTCAGAGGAAA	Negative
ATTCAGGAGGACAGCT	Hashtag6_Hashtag8
ATTCATCAGATAGCAT	Negative
ATTCATCAGGGATCAC	Negative
ATTCATCAGGTATTGA	Negative
ATTCATCCACAAATCC	Hashtag6
ATTCATCGTCAATCTG	Negative
ATTCATCTCCTCGCAT	Hashtag8
ATTCCATAGGTACAAT	Hashtag6
ATTCCATAGTGCAACG	Hashtag6
ATTCCATTCACCCTCA	Negative
ATTCCATTCAGCAATC	Negative
ATTCCCGAGGCTTTCA	Hashtag6
ATTCCCGCATGCTGCG	Negative
ATTCCCGCATTGGCAT	Negative
ATTCCCGGTAGACACG	Hashtag6
ATTCCCGGTGGCTTAT	Negative
ATTCCTAAGTAGTCAA	Negative
ATTCCTACAACCACGC	Negative
ATTCCTAGTGCGTCGT	Negative
ATTCCTAGTGCTCTCT	Negative
ATTCCTAGTTGTGGCC	Negative
ATTCGTTAGGACAGTC	Negative
ATTCGTTCAATTTCTC	Negative
ATTCGTTTCATCCTAT	Hashtag6
ATTCTACGTCCGAAGA	Hashtag6
ATTCTACGTGTTGCCG	Negative
ATTCTTGAGTTCAACC	Negative
ATTCTTGCACTCATAG	Hashtag6
ATTCTTGCAGTTTCAG	Negative
ATTCTTGGTACAACGG	Hashtag8
ATTCTTGGTCCGAAAG	Hashtag6
ATTCTTGTCAAAGAAC	Negative
ATTCTTGTCGTCTCAC	Hashtag6_Hashtag8
ATTCTTGTCTGTAACG	Hashtag6
ATTGGGTCAGGAACCA	Negative
ATTGGGTTCGGTAGGA	Negative
ATTGTTCTCTCCAATT	Negative
ATTTACCAGACTCGAG	Negative
ATTTACCAGACTCTAC	Negative
ATTTACCAGCAACAGC	Hashtag6
ATTTACCCAAGCTGTT	Negative
ATTTACCCACGCGCTA	Negative
ATTTACCCATCCTTCG	Negative
ATTTACCTCCATTGCC	Negative
ATTTCACAGCTTTCTT	Negative
ATTTCACAGTGCACTT	Negative
ATTTCACCAGCGACAA	Negative
ATTTCACCAGTGCCTG	Negative
ATTTCTGAGACATAAC	Negative
ATTTCTGAGAGACAAG	Hashtag6_Hashtag8
ATTTCTGAGTACGTCT	Negative
ATTTCTGCACTAGAGG	Hashtag6
ATTTCTGCAGTTGGTT	Negative
ATTTCTGGTTCATCGA	Negative
CAAAGAAGTACGACTT	Negative
CAACAACAGACATGCG	Negative
CAACAACAGGTCGACA	Negative
CAACAACAGTTGCTCA	Negative
CAACAACAGTTGTAAG	Negative
CAACAACCAAACCGGA	Negative
CAACAACGTTCAGGTT	Negative
CAACAACTCTCTCGAC	Hashtag6
CAACAGTCAAAGAACT	Negative
CAACAGTGTACTCGTA	Hashtag6
CAACAGTGTATGGTTC	Negative
CAACCAAAGAAGTGTT	Hashtag6
CAACCAAAGTTGAAGT	Hashtag6
CAACCAACAAAGGCGT	Negative
CAACCAAGTAGCTTTG	Negative
CAACCAAGTATCTCGA	Negative
CAACCAATCAATGCAC	Negative
CAACCAATCCGTCAAA	Negative
CAACCAATCGCCAGTG	Hashtag6
CAACCTCAGACTCAAA	Hashtag6
CAACCTCAGCGTGTTT	Hashtag6
CAACCTCCATTGAGCT	Hashtag6
CAACCTCTCAGCGGAA	Hashtag6
CAACCTCTCCCGATCT	Negative
CAACCTCTCCGTACGG	Negative
CAACCTCTCGCAGATT	Hashtag6
CAACCTCTCGCTGACG	Hashtag8
CAACGATAGAAATTCG	Hashtag6
CAACGATAGATTAGAC	Hashtag8
CAACGATCAGAGGGTT	Hashtag6
CAACGATTCTAGGCCG	Hashtag6
CAACGGCCACGTAACT	Hashtag6
CAACGGCGTAGATCCT	Negative
CAACGGCTCCGAAATC	Hashtag6
CAAGACTAGGGTCACA	Negative
CAAGACTCAAGTCCCG	Hashtag6
CAAGACTCACGTACAT	Hashtag6
CAAGACTCACTACCGG	Hashtag6
CAAGACTCACTTCCTG	Negative
CAAGACTGTACGTGTT	Hashtag6
CAAGACTGTAGTTAGA	Negative
CAAGACTGTTACCTTT	Negative
CAAGACTTCCCTATTA	Negative
CAAGAGGAGCTGGCTC	Negative
CAAGAGGAGTATTGCC	Negative
CAAGAGGGTTCCGCTT	Negative
CAAGAGGTCACCATAG	Hashtag6
CAAGAGGTCACCCATC	Hashtag6
CAAGAGGTCGGTCTAA	Hashtag6
CAAGAGGTCTCAATCT	Hashtag6
CAAGAGGTCTCGACGG	Negative
CAAGCTAAGCATGTTC	Negative
CAAGCTAAGTGAGTGC	Negative
CAAGCTAGTAACAGGC	Hashtag8
CAAGCTAGTCATCCGG	Negative
CAAGCTATCTATCGCC	Negative
CAAGGGAAGGGCAGAG	Negative
CAAGGGACAAGGCTTT	Negative
CAAGGGAGTGTAAACA	Negative
CAAGGGAGTTATGGTC	Negative
CAATACGTCTATCGCC	Negative
CAATCGAAGATACCAA	Negative
CAATCGACACCCTTAC	Hashtag6
CAATCGACATACCATG	Negative
CAATCGACATTCCTAT	Hashtag6
CAATCGAGTATCGTGT	Negative
CAATCGAGTTGCTCCT	Hashtag6
CAATCGATCACCCATC	Hashtag6
CAATCGATCGTCAGAT	Negative
CAATGACCAACATACC	Negative
CAATGACGTGCGGCTT	Hashtag6_Hashtag8
CAATGACTCATTCGTT	Hashtag6
CAATGACTCCTCTGCA	Negative
CAATTTCAGATAACAC	Negative
CACAACAAGAGATGCC	Hashtag6
CACAACAAGGGCTGAT	Negative
CACAACACATGTTCAG	Hashtag6
CACAACAGTGTTTGCA	Hashtag6
CACAACATCTGTACAG	Negative
CACACAAAGCAACAGC	Hashtag6
CACACAACAAGTGCTT	Negative
CACACAACACGTAGAG	Hashtag6
CACAGATAGTGCAGGT	Hashtag6
CACAGATCAGTCTGGC	Hashtag6
CACAGATGTATCTTCT	Negative
CACAGATGTCACCTTC	Hashtag6
CACAGATTCCGTAGTA	Negative
CACAGATTCTAGCAAC	Hashtag6
CACAGATTCTGTGCAA	Hashtag8
CACAGGCGTATTCCTT	Negative
CACAGGCGTGTTGAGG	Negative
CACAGGCTCAGCCTTC	Negative
CACAGGCTCCACACAA	Hashtag6
CACAGGCTCGGTGTAT	Hashtag6_Hashtag8
CACATGACACCGGCTA	Hashtag8
CACATGAGTATGATCC	Negative
CACATGAGTCCAGCGT	Negative
CACATGAGTGCATTAC	Hashtag6
CACATGATCATACGGT	Negative
CACATGATCCCACAGG	Hashtag6
CACATGATCGTTAGAC	Negative
CACCAAAAGTACAGCG	Negative
CACCAAAGTTTGCAGT	Negative
CACCGTTAGACCTTTG	Negative
CACCGTTAGCAAGCCA	Negative
CACCGTTGTAGCTGAG	Negative
CACCGTTTCGGAATTC	Hashtag6
CACGAATAGATAGCTA	Hashtag6
CACGAATAGGATATAC	Negative
CACGAATGTCTAACGT	Negative
CACGAATGTCTCCTGT	Hashtag6
CACGAATTCGCAACAT	Hashtag6
CACGGGTAGCACGGAT	Negative
CACGGGTCACACCAGC	Negative
CACGGGTCATCCTATT	Hashtag6
CACGGGTGTCAGTTTG	Hashtag8
CACGGGTGTCCATCTC	Negative
CACGGGTGTGGTCTAT	Hashtag6_Hashtag8
CACGGGTTCGACACCG	Negative
CACGTGGAGTCGGGAT	Hashtag8
CACGTGGCAACCAACT	Negative
CACGTGGCACCCTAGG	Negative
CACGTGGGTATCTCGA	Negative
CACGTGGGTTAAACCC	Negative
CACGTTCCAGACTCTA	Negative
CACTAAGAGGTGCTAG	Negative
CACTAAGCAGTGTGCC	Negative
CACTAAGGTAACTGCT	Negative
CACTAAGGTACGAGCA	Negative
CACTGAAAGGTCTACT	Negative
CACTGAAAGTGGCGAT	Hashtag6
CACTGAAGTTCAATCG	Hashtag6
CACTGAAGTTCCGCTT	Negative
CACTGAAGTTGTGCCG	Negative
CACTGGGAGAATTCAG	Hashtag6
CACTGGGAGCCTCACG	Negative
CACTGGGAGTGGAATT	Hashtag6
CACTGGGCAGATCACT	Negative
CACTGGGGTCATGGCC	Hashtag6
CACTGTCAGATCGGTG	Hashtag6
CACTGTCCACGCCACA	Hashtag8
CACTGTCCATTGTGCA	Hashtag8
CACTGTCGTGGCTGCT	Hashtag6
CACTGTCTCAAGTCTG	Hashtag6_Hashtag8
CACTGTCTCGAAGCCC	Negative
CACTGTCTCGCGTTTC	Hashtag8
CACTTCGAGTATCTGC	Negative
CACTTCGAGTCACTAC	Hashtag6
CACTTCGGTGTTACTG	Negative
CACTTCGTCATCTCTA	Negative
CACTTCGTCCCTCATG	Negative
CAGAGCCAGAATCCCT	Negative
CAGAGCCAGTTGGCTT	Negative
CAGAGCCCATTGTGCA	Negative
CAGAGCCGTAACGATA	Hashtag6
CAGAGCCGTAAGGTCG	Hashtag6
CAGAGCCTCTCTCGCA	Negative
CAGATACAGGTTCCAT	Negative
CAGATACCACAGGATG	Negative
CAGATACGTGTGACCC	Negative
CAGATCAAGAATTTGG	Hashtag6
CAGATCAGTCCAGGTC	Negative
CAGATCATCATCGTAG	Hashtag6
CAGATTGAGTTCATCG	Negative
CAGATTGGTAATCAAG	Negative
CAGATTGTCCACGGAC	Negative
CAGATTGTCGAAGTGG	Hashtag8
CAGCAATAGAAATTCG	Negative
CAGCAATCAACTGATC	Hashtag6_Hashtag8
CAGCAATCACGCGGTT	Negative
CAGCAATCACTCCTTG	Negative
CAGCAATCATCAGCGC	Hashtag6
CAGCAATGTGGACTAG	Negative
CAGCAATGTTGACTGT	Negative
CAGCACGCATTGACTG	Negative
CAGCACGGTCGTCTCT	Hashtag6
CAGCACGTCAAAGACA	Negative
CAGCAGCAGAGGTGCT	Hashtag6_Hashtag8
CAGCAGCAGGAGGTTC	Hashtag6
CAGCAGCGTGCAACGA	Hashtag6
CAGCCAGAGCATGAAT	Negative
CAGCCAGAGCTCGCAC	Hashtag6
CAGCCAGCATTCACAG	Hashtag6
CAGCCAGGTACAAAGT	Negative
CAGCCAGTCCAAGCCG	Negative
CAGCGTGAGAAATTCG	Negative
CAGCGTGAGGCGTCCT	Negative
CAGCGTGGTAACTAAG	Negative
CAGGCCAAGCAGCCTC	Negative
CAGGCCAGTAAGTTGA	Negative
CAGGCCAGTCAAAGAT	Negative
CAGGCCAGTCGCGGTT	Negative
CAGGCCAGTGGACCAA	Negative
CAGGCCATCTGCATAG	Hashtag6
CAGGGCTAGGGTTAGC	Negative
CAGGGCTCAAGTATCC	Negative
CAGGGCTGTGCAACAG	Hashtag8
CAGGTATAGTTTGTCG	Hashtag8
CAGGTATCACTAACGT	Negative
CAGGTATGTGCATTTG	Negative
CAGTGCGAGCATTTGC	Negative
CAGTGCGCAGTGAGCA	Hashtag6
CAGTGCGCATAGGCGA	Negative
CAGTTAGAGTGGCAGT	Hashtag6
CAGTTAGCAAATGCGG	Negative
CAGTTAGCATGGAAGC	Negative
CAGTTAGGTCTTAGTG	Hashtag6
CAGTTAGGTTCTCTAT	Negative
CAGTTAGTCGAGCACC	Negative
CAGTTAGTCGGCTGTG	Negative
CAGTTCCGTCATTGCA	Hashtag6
CATACAGGTGTCCGTG	Hashtag6_Hashtag8
CATACCCAGATCACCT	Negative
CATACCCAGTGATGGC	Negative
CATACCCGTCGACGCT	Hashtag6
CATACCCTCCTCGCAT	Negative
CATAGACAGAATCGTA	Negative
CATAGACAGCATGATA	Negative
CATAGACCATGGCTAT	Negative
CATAGACGTGCACATT	Negative
CATAGACTCAAGGTGG	Negative
CATCAAGAGCAGCCTC	Hashtag6_Hashtag8
CATCAAGAGGCTTCCG	Negative
CATCAAGCAAATACAG	Hashtag8
CATCAAGGTACCCGCA	Negative
CATCAAGGTACTGCCG	Hashtag8
CATCAAGTCGTGGGAA	Negative
CATCCACAGGAGGCAG	Hashtag6
CATCCACAGTGCACTT	Hashtag6
CATCCACCAGCAGAAC	Hashtag6
CATCCACGTTTGGAGG	Hashtag6
CATCCACTCGATCCAA	Hashtag8
CATCCCAAGACGCCAA	Negative
CATCCCAAGAGCCTGA	Negative
CATCCCACAATGGGTG	Hashtag6
CATCCCAGTGGCACTC	Negative
CATCCGTTCTGAGATC	Negative
CATCGCTAGGTAGTAT	Hashtag6
CATCGCTCAGACCTAT	Negative
CATCGCTGTACAATAG	Hashtag6
CATCGGGAGATTGAGT	Hashtag6
CATCGGGAGTACCATC	Hashtag6_Hashtag8
CATCGGGCACTCTAGA	Negative
CATCGGGGTTAACAGA	Hashtag6
CATCGGGTCCTCATAT	Negative
CATCGGGTCGGAAACG	Negative
CATCGTCCAATACGAA	Negative
CATCGTCGTATACGGG	Negative
CATCGTCGTCTTGAGT	Negative
CATCGTCTCAAAGGAT	Negative
CATCGTCTCATCGCCT	Hashtag6
CATCGTCTCCAGCCTT	Negative
CATCGTCTCCCGATCT	Negative
CATCGTCTCCTATGGA	Negative
CATCGTCTCTACCTTA	Hashtag6_Hashtag8
CATGAGTAGGACAGCT	Hashtag6
CATGAGTCACGCTGAC	Negative
CATGAGTTCCGAAATC	Negative
CATGAGTTCGTAATGC	Hashtag6
CATGCAAAGCGGTAAC	Negative
CATGCGGCAATGGCAG	Negative
CATGCGGCACGACAAG	Hashtag6_Hashtag8
CATGCGGGTGGCTACC	Negative
CATGCGGTCCGTCACT	Negative
CATGCGGTCGGAAGGT	Negative
CATGCTCAGCGTCGAA	Hashtag6_Hashtag8
CATGCTCAGTTGTCAC	Negative
CATGCTCGTGCTCTTC	Negative
CATGCTCTCGGCAGTC	Negative
CATGGATAGGTTGACG	Negative
CATGGATCAGAACCGA	Hashtag6
CATGGATGTTCGGGTC	Negative
CATGGATTCACATACG	Hashtag8
CATGGATTCACGTAGT	Hashtag8
CATGGATTCATTCGTT	Negative
CATGGTACAATCGCGC	Negative
CATGGTACACCAGGTC	Negative
CATGGTATCGCATGAT	Negative
CATTCATAGCGTATAA	Negative
CATTCATCAAGTTCCA	Negative
CATTCATCATGGACAG	Hashtag6
CATTCCGCACGTCATA	Hashtag6
CATTCCGGTAGACTGG	Negative
CATTCCGTCGAAATCC	Negative
CATTCTAAGTACCGGA	Hashtag6
CATTCTACAGACACAG	Hashtag6
CATTCTACAGTACTAC	Negative
CATTCTAGTATGGTTC	Hashtag6_Hashtag8
CATTCTATCAGAGCGA	Hashtag6
CATTCTATCTAAACGC	Negative
CATTGAGAGCGACTGA	Hashtag6_Hashtag8
CATTGAGCAATGGCCC	Hashtag6
CATTGAGCAGCGTGAA	Negative
CATTGAGGTACGTGAG	Hashtag6
CATTGAGGTATTGAGA	Negative
CATTGAGGTCATCTAG	Negative
CATTGAGGTTCGGCGT	Negative
CATTGCCAGGCACCAA	Negative
CATTGCCCAGCTCATA	Negative
CATTGCCTCCCGAGGT	Negative
CATTGTTAGATCACTC	Negative
CATTGTTGTCGTACTA	Hashtag6
CATTGTTTCACCTGTC	Hashtag6
CATTGTTTCGTCTAAG	Hashtag8
CATTGTTTCTTTCGAT	Hashtag6
CATTTCACATAGTCAC	Hashtag6
CATTTCAGTTCCGGTG	Negative
CCAAGCGAGCCTCACG	Negative
CCAAGCGCAAACCGGA	Hashtag6_Hashtag8
CCAAGCGCATGACGTT	Negative
CCAAGCGGTGGTTCTA	Negative
CCAAGCGTCAGGAAAT	Hashtag6
CCAAGCGTCGCAGTTA	Hashtag6
CCAATTTAGGGACCAT	Negative
CCAATTTGTATTTCTC	Hashtag6
CCACAAAAGTTGAAGT	Negative
CCACAAAGTGTGTGTT	Hashtag6
CCACAAAGTTGGTGTT	Hashtag6
CCACACTCAAGTGGTG	Hashtag6
CCACACTCAGTCAACT	Hashtag6_Hashtag8
CCACACTCATTAGGCT	Negative
CCACACTGTCTGTGGC	Negative
CCACACTGTGATACTC	Negative
CCACACTGTTCTAACG	Negative
CCACACTTCCCAGGCA	Negative
CCACACTTCCCAGTGG	Negative
CCACCATAGTGCTACT	Negative
CCACCATCATACTTTC	Negative
CCACCATGTCTTTATC	Negative
CCACCATGTGTCATGT	Negative
CCACCATTCGATAACC	Negative
CCACGAGAGTAACAGT	Negative
CCACGAGCATTGGCAT	Negative
CCACGAGGTCGTCATA	Negative
CCACGAGGTGGACTGA	Negative
CCACGAGGTTCTCACC	Negative
CCACGAGTCGACCACG	Hashtag8
CCACGAGTCGACCATA	Negative
CCACGAGTCTCATTGT	Negative
CCACGTTAGCACCGAA	Negative
CCACGTTAGGCCATAG	Negative
CCACGTTTCATGCCCT	Negative
CCACTTGAGTTCCATG	Negative
CCACTTGGTAATGTGA	Hashtag6
CCACTTGTCCATGAGT	Hashtag8
CCATAAGAGCAAATGT	Hashtag8
CCATAAGAGCGCTGAA	Negative
CCATAAGAGTTGCGAG	Hashtag6
CCATAAGCAGATCCAT	Negative
CCATAAGCATTAAGCC	Negative
CCATAAGGTGTACAGG	Negative
CCATAAGTCGTTCGCT	Hashtag6
CCATCACAGTGCCAGA	Negative
CCATCACTCATCACCC	Negative
CCCAACTAGGTAGTAT	Hashtag6
CCCAACTCATTGTCGA	Negative
CCCATTGAGAATTGTG	Hashtag6
CCCATTGAGCTGGAGT	Hashtag8
CCCATTGGTCCTCATC	Hashtag6
CCCGAAGAGTAAAGCT	Hashtag6_Hashtag8
CCCGAAGAGTGGCCTC	Hashtag6
CCCGAAGGTACGACTT	Negative
CCCGAAGGTCCTGTTC	Negative
CCCGAAGTCATATGGC	Negative
CCCGGAAGTGATACAA	Negative
CCCTAACAGAGAGGTA	Negative
CCCTAACAGTCACAGG	Negative
CCCTAACCATGGAGAC	Negative
CCCTCAAAGCCTTCTC	Negative
CCCTCAAGTGAGAACC	Negative
CCCTCAATCTCCGAGG	Negative
CCCTCTCAGAAGGTAG	Hashtag6
CCCTCTCCAAATCGGG	Negative
CCCTGATAGAATCCCT	Hashtag6
CCCTGATAGAGGTTAT	Negative
CCCTGATAGCGCAATG	Negative
CCCTGATCACAACGCC	Hashtag6
CCCTGATGTTCAATCG	Negative
CCCTGATTCAGAGTGG	Hashtag6
CCCTGATTCCAGCAAT	Hashtag6
CCCTGATTCTGACGCG	Hashtag8
CCCTTAGAGCCTCTGG	Negative
CCCTTAGGTTGAATCC	Negative
CCCTTAGTCCAGCTCT	Negative
CCGAACGAGTACTGGG	Hashtag6
CCGAACGCATCGCTAA	Negative
CCGAACGGTCGTAATC	Negative
CCGAACGTCATAGAGA	Hashtag6_Hashtag8
CCGATCTAGATCCGAG	Negative
CCGATCTAGGTGGCTA	Hashtag8
CCGATCTCAATTGTGC	Hashtag6
CCGATCTGTCACAGAG	Negative
CCGATCTGTGGCGCTT	Negative
CCGATGGAGGCAATGC	Negative
CCGCAAGAGCGAGTCA	Negative
CCGCAAGGTCATGACT	Negative
CCGCAAGTCGTTTACT	Negative
CCGCAAGTCTACGCGG	Negative
CCGGACAAGACGCCAA	Negative
CCGGACAAGACGGTTG	Negative
CCGGACAAGCCAACCC	Negative
CCGGACACAATTGCGT	Negative
CCGGACAGTCCTGTCT	Hashtag6
CCGGACATCGGACGTC	Negative
CCGGACATCGGCATTA	Hashtag6
CCGGGTAAGAGTGGCT	Hashtag8
CCGGGTACAACTCCAA	Hashtag6
CCGGGTATCACACCCT	Hashtag8
CCGGGTATCAGTCTTT	Negative
CCGGTAGAGCGTGTTT	Hashtag6
CCGGTAGCAACAGATA	Negative
CCGGTAGCAGCATCTA	Hashtag6_Hashtag8
CCGGTAGCATACAGAA	Hashtag6
CCGGTAGGTCCTCAGG	Negative
CCGGTAGTCTTGAGCA	Hashtag6
CCGGTGAAGCTACGTT	Negative
CCGGTGAAGCTGACTT	Hashtag6_Hashtag8
CCGGTGACAGACCTAT	Negative
CCGGTGACATTGAAGA	Negative
CCGGTGAGTCTTGCGG	Negative
CCGGTGAGTGGACAGT	Negative
CCGGTGATCACCTCAC	Negative
CCGTAGGAGTGCTAGG	Hashtag6
CCGTAGGCACAGCTGC	Negative
CCGTAGGGTCCACGCA	Hashtag6
CCGTAGGGTTTGGAGG	Hashtag6
CCGTAGGTCCATTGGA	Negative
CCGTAGGTCGCCCAGA	Negative
CCGTAGGTCTGAGAGG	Hashtag6
CCGTGAGAGAGCAGCT	Negative
CCGTGAGCAAAGGAGA	Negative
CCGTGAGCAAATGAAC	Hashtag6
CCGTGAGCAGCCTACG	Negative
CCGTGAGGTCAGTCGC	Negative
CCGTGAGGTCATTGCA	Negative
CCGTGAGGTGAGAACC	Hashtag6
CCGTGAGTCCATTTGT	Negative
CCGTGAGTCGCCTCTA	Negative
CCTAACCAGGCGAAGG	Hashtag6_Hashtag8
CCTAACCGTATAGCTC	Negative
CCTAACCTCGTTGTTT	Negative
CCTAAGAAGCAAGCCA	Hashtag6_Hashtag8
CCTACGTGTACAGAGC	Negative
CCTACGTGTACGAGTG	Hashtag6
CCTACGTGTGAGCCAA	Hashtag6
CCTACGTGTTCAGCGC	Negative
CCTATCGAGCGACATG	Negative
CCTATCGAGCTCAGAG	Negative
CCTATCGCAACCGGAA	Negative
CCTATCGCACCTATCC	Hashtag6_Hashtag8
CCTATCGGTCTCACAA	Negative
CCTATCGGTCTGTCAA	Negative
CCTATCGTCACAAGGG	Hashtag6
CCTATCGTCGAAGCCC	Negative
CCTCAACAGTGCCTCG	Negative
CCTCAACGTCGTATTG	Negative
CCTCAACTCAGTGTGT	Negative
CCTCAACTCATAGAGA	Hashtag6
CCTCAACTCCCATGGG	Negative
CCTCAACTCTACACAG	Hashtag6
CCTCAACTCTCTGAGA	Hashtag6
CCTCACAAGGGCCCTT	Negative
CCTCACATCTTAGTTC	Hashtag6
CCTCACATCTTTCGAT	Hashtag6
CCTCAGTAGCTGGTGA	Hashtag6
CCTCAGTAGGTTCCGC	Negative
CCTCAGTAGTGCTAGG	Negative
CCTCAGTCACTGCACG	Hashtag8
CCTCAGTGTATGAAAC	Negative
CCTCATGAGAAGGCTC	Negative
CCTCATGAGCACTCAT	Negative
CCTCATGAGCATCAAA	Hashtag8
CCTCATGGTGAGATCG	Negative
CCTCATGGTGTATTCG	Negative
CCTCCAATCCTTATAC	Negative
CCTCCTCAGGCATCAG	Negative
CCTCCTCCAACACGAG	Negative
CCTCCTCCATCTGGGC	Negative
CCTCCTCTCGGTAAGG	Negative
CCTCTAGCATGTGGCC	Negative
CCTCTAGGTTATAGCC	Negative
CCTCTAGTCAGACCGC	Negative
CCTCTAGTCTTCGTAT	Negative
CCTCTCCAGAAGGTAG	Negative
CCTCTCCAGACCTTTG	Negative
CCTCTCCAGCACGGAT	Negative
CCTCTCCGTGAGCGAT	Negative
CCTCTCCTCGCTAAAC	Hashtag6
CCTGCATAGGGAGGCA	Hashtag6
CCTGCATCACTCCTTG	Hashtag6
CCTGCATCAGGAGGAG	Negative
CCTGCATGTATGCGGA	Hashtag6
CCTGCATTCACGATAC	Negative
CCTGCATTCACTTCTA	Hashtag6
CCTGTTGCATGCAGCC	Negative
CCTGTTGGTCCACTTC	Negative
CCTGTTGTCTGTTGGA	Hashtag8
CCTTCAGAGAATACAC	Negative
CCTTCAGGTGTTAACC	Negative
CCTTGTGAGCTGTACT	Negative
CCTTGTGAGGTTCCAT	Hashtag6
CCTTGTGGTAATTAGG	Hashtag8
CCTTGTGGTCAAGGCA	Negative
CCTTGTGGTGACACGA	Hashtag6
CCTTGTGTCCGTCAAA	Hashtag6
CCTTTGGCAACGCCCA	Negative
CCTTTGGCAACTTCTT	Negative
CCTTTGGCATCAGCAT	Hashtag6
CCTTTGGCATGAATAG	Hashtag6
CCTTTGGGTGGCCCAT	Hashtag6
CCTTTGGGTGTAGGAC	Hashtag6
CCTTTGGTCGCTTTAT	Hashtag6
CCTTTGGTCGTGCGAC	Negative
CGAAGGACAGTCGCTG	Hashtag6
CGAAGGACAGTTGTTG	Hashtag6
CGAAGGAGTTTACTGG	Hashtag6_Hashtag8
CGAAGTTAGGTACATA	Hashtag6
CGAAGTTAGGTGATCG	Negative
CGAAGTTCAAGTCGTT	Negative
CGAAGTTGTTCTCACC	Hashtag6
CGAAGTTTCGTTATCT	Hashtag6
CGAATTGCACGCACCA	Negative
CGAATTGGTGCCGAAA	Hashtag6_Hashtag8
CGAATTGGTGTTAACC	Hashtag8
CGAATTGTCAAGCTTG	Negative
CGACAGCAGGGAGAAT	Negative
CGACAGCCAGTGACCC	Negative
CGACAGCGTCTTCCGT	Hashtag6
CGACAGCGTGCCGTAC	Hashtag6
CGACAGCTCCCTTGGT	Hashtag6
CGAGAAGAGGTAGTCG	Negative
CGAGAAGGTACTGCGC	Negative
CGAGAAGGTTATCTTC	Hashtag6
CGAGAAGGTTCCATTT	Negative
CGAGAAGTCTGTGCAA	Hashtag6
CGAGGAAAGACATCCT	Hashtag8
CGAGGAAAGACGGATC	Hashtag6
CGAGGAAGTACACTCA	Negative
CGAGGCTAGAAGCGGG	Hashtag8
CGAGGCTCAGTCCGTG	Negative
CGAGTGCCACAAGTGG	Hashtag6
CGAGTGCCATTGGCAT	Negative
CGAGTGCGTGGATACG	Negative
CGAGTGCTCTCCGTGT	Hashtag6
CGAGTGCTCTTGGATG	Negative
CGAGTTAAGAGCTGCA	Negative
CGAGTTAAGGAGCAAA	Negative
CGAGTTAAGTAGGAAG	Hashtag8
CGAGTTACACCTAAAC	Negative
CGAGTTATCATGCCCT	Negative
CGAGTTATCATGTCAG	Hashtag8
CGATCGGAGTTAGAAC	Negative
CGATCGGGTGTCCGGT	Hashtag6
CGATCGGTCATGGGAG	Negative
CGATCGGTCCACACAA	Negative
CGATCGGTCGGTGAAG	Hashtag6
CGATGCGTCTCAACCC	Hashtag6
CGATGGCAGTCGCTAT	Hashtag6
CGATGGCCATGTCTAG	Hashtag6
CGATGGCTCATGGGAG	Negative
CGATGGCTCCGGCAGT	Negative
CGATGGCTCCTATTTG	Hashtag6
CGATGGCTCGGCTCTT	Hashtag6
CGCAGGTAGAGGCTGT	Negative
CGCAGGTCAAACTAAG	Negative
CGCAGGTCAACTGCCG	Negative
CGCAGGTGTCGTGGAA	Hashtag6
CGCAGGTTCTGTGCTC	Negative
CGCATAAAGTAACCGG	Negative
CGCATAAGTCGGTGTC	Hashtag6_Hashtag8
CGCATAAGTCTTAGTG	Negative
CGCATGGGTACTCCGG	Hashtag6
CGCATGGGTTGTAGCT	Negative
CGCATGGTCCGTATAG	Negative
CGCATGGTCCTTCTAA	Hashtag6
CGCCAGAAGTGTACAA	Negative
CGCCAGACACAGGATG	Hashtag6
CGCCAGACAGAGCTAG	Hashtag6
CGCCAGAGTCTCGACG	Negative
CGCCAGATCGTAGTCA	Negative
CGCCATTAGACATAGT	Hashtag6
CGCCATTAGCCGTCGT	Negative
CGCCATTAGCCTCATA	Negative
CGCCATTCAGGTGGAT	Negative
CGCCATTCATAGGTTC	Negative
CGCCATTGTCATACCA	Negative
CGCCATTGTCATGGCC	Hashtag6
CGCCATTGTGCCTACG	Negative
CGCCATTTCCTACCAC	Negative
CGCGTGAAGATGTTCC	Negative
CGCGTGAAGCCTCTCT	Hashtag6_Hashtag8
CGCGTGAAGGGCAATC	Hashtag8
CGCGTGACACGCGCAT	Negative
CGCGTGATCCGGCTTT	Negative
CGCGTGATCCTATTGT	Negative
CGCGTGATCTTGGTCC	Hashtag6
CGGAACCCACCTGAAT	Hashtag6
CGGAACCTCTACACAG	Negative
CGGAATTAGTGCAAAT	Negative
CGGAATTGTACAGTTC	Negative
CGGAATTTCCGCTGTT	Hashtag6
CGGACACAGTGCTCGC	Negative
CGGACACCATCCGAGC	Hashtag6
CGGACACTCACGGGCT	Negative
CGGACACTCACTGATG	Hashtag6
CGGACACTCATTTGTC	Negative
CGGACACTCGAGAAGC	Negative
CGGACACTCGCCAATA	Negative
CGGACACTCTCACGAA	Hashtag6
CGGAGAAAGCGACTGA	Hashtag6_Hashtag8
CGGAGAAAGGGAGGGT	Negative
CGGAGAAGTTTCGTAG	Negative
CGGCAGTAGCAATAAC	Negative
CGGCAGTAGCCAGAGT	Negative
CGGCAGTAGTAGATCA	Hashtag6_Hashtag8
CGGCAGTGTGCTCGTG	Negative
CGGCAGTTCCCAGTGG	Negative
CGGGACTCAAGATGGC	Negative
CGGGACTCACGTCGTG	Hashtag6
CGGGACTCATAGGAGC	Negative
CGGGACTCATGTGACT	Hashtag8
CGGGACTGTCTCTCTG	Hashtag6_Hashtag8
CGGGACTGTGTTCAGT	Negative
CGGGACTTCAAGCCCG	Negative
CGGGCATCAACAAAGT	Negative
CGGGCATCAAGTCGTT	Negative
CGGGCATCACCCTCTA	Hashtag6_Hashtag8
CGGGCATCACGCTGCA	Negative
CGGGCATTCAGCCCAG	Hashtag6
CGGGCATTCAGCGCGT	Negative
CGGGCATTCCCTCAAC	Hashtag6
CGGGTCAAGATAGTGT	Negative
CGGGTCAAGCTGAAGC	Negative
CGGGTCAAGGGCATGT	Negative
CGGGTCAAGTCTGTAC	Negative
CGGGTCACAATTTCGG	Negative
CGGGTCACACCCTCTA	Hashtag6
CGGGTCACAGAACGCA	Hashtag8
CGGGTCAGTAACCAGG	Negative
CGGGTCAGTATCGTTG	Hashtag6
CGGGTGTAGGCCTTGC	Negative
CGGGTGTGTACGCGTC	Negative
CGGGTGTGTATGGAGC	Hashtag6
CGGGTGTTCACCATGA	Hashtag6
CGGGTGTTCACGAACT	Hashtag6
CGGGTGTTCGCGCTGA	Hashtag8
CGGGTGTTCGGTCACG	Hashtag8
CGGTCAGCATAGAATG	Hashtag8
CGGTCAGTCTCCCAAC	Negative
CGTAAGTAGAGGGTAA	Negative
CGTAAGTAGATTGATG	Hashtag6
CGTAAGTAGGGTATAT	Hashtag6
CGTAAGTAGTTCTCTT	Hashtag6
CGTAAGTCACACCAGC	Negative
CGTAAGTCAGGTCTCG	Hashtag6
CGTAAGTCATATCTCT	Negative
CGTAAGTGTGAGACCA	Negative
CGTAAGTTCTTAGCAG	Hashtag6
CGTAATGCAGCAGAAC	Hashtag6
CGTAATGCATCGCTGG	Hashtag6
CGTCAAAAGGGCAGGA	Negative
CGTCAAACAAACTAAG	Hashtag8
CGTCAAACATTGACAC	Hashtag6
CGTCAAATCTCAGAAC	Hashtag6_Hashtag8
CGTCCATCAAAGAACT	Negative
CGTCCATCACTGTCGG	Negative
CGTCCATCAGCGCGTT	Negative
CGTCCATGTACCGTCG	Negative
CGTCCATGTGGCTAGA	Negative
CGTCCATGTGGTCTAT	Hashtag6
CGTGAATAGGTCGTAG	Negative
CGTGAATCACGGATCC	Negative
CGTGAATCATGTCTAG	Hashtag6
CGTGAATTCCGGTTCT	Negative
CGTGAATTCTGGCCAG	Negative
CGTGAATTCTTTGCTA	Negative
CGTGATAAGGCAGGGA	Negative
CGTGATAAGGCCTTCG	Negative
CGTGATACATCCTTCG	Hashtag6
CGTGCTTAGACGCCAA	Negative
CGTGCTTCAAGTGGAC	Negative
CGTGCTTCAGCTCGGT	Hashtag6
CGTGCTTTCCGTCAAA	Hashtag6
CGTGTCTCACGTAGTT	Negative
CGTGTCTGTATCGTTG	Negative
CGTGTCTTCCTCTTTC	Negative
CGTTAGAAGGCATCAG	Hashtag8
CGTTAGAGTAGTCGTT	Negative
CGTTAGAGTTAGGGAC	Negative
CGTTCTGCAGAGCCCT	Negative
CGTTCTGCAGCGTTGC	Negative
CGTTCTGCATGGCGCT	Negative
CGTTCTGGTCTGTGAT	Negative
CGTTGGGAGTTTCGAC	Hashtag8
CGTTGGGGTTCAACGT	Negative
CTAACCCCACACCGCA	Negative
CTAACCCCACATTGTG	Negative
CTAACCCCACCATAAC	Negative
CTAACCCTCAAACCTG	Negative
CTAACTTAGGAACATT	Hashtag6
CTAACTTCAAGACTGG	Negative
CTAACTTCAATCGCCG	Negative
CTAACTTGTAGTCTGT	Negative
CTAACTTGTCGAGTTT	Negative
CTAAGTGGTACACGTT	Hashtag6
CTAAGTGTCCCGAAAT	Negative
CTAAGTGTCGCCAGTG	Negative
CTAAGTGTCGTAGTGT	Negative
CTACAGAAGCACTCCG	Hashtag6
CTACAGAAGCTGACAG	Negative
CTACAGAAGGCATTTC	Hashtag6_Hashtag8
CTACATTCAAGTCGTT	Negative
CTACATTGTACGCTTA	Negative
CTACATTTCACCTCAC	Negative
CTACATTTCAGTGTCA	Negative
CTACCCAAGGCTCTAT	Hashtag6_Hashtag8
CTACCCACACAATCTG	Negative
CTACCCAGTTGGGATG	Negative
CTACCCATCCTACTGC	Hashtag6
CTACCCATCCTCTCTT	Negative
CTACCTGAGTTTGCTG	Negative
CTACCTGCACTTGAAC	Negative
CTACCTGGTACGCTAT	Negative
CTACCTGGTTCGATTG	Negative
CTACCTGTCACTGTCC	Hashtag6
CTACGGGAGATCCCAT	Hashtag6
CTACGGGAGGGCTAAC	Hashtag6
CTACGGGAGTTGGACG	Hashtag6
CTACGGGTCCGCGAGT	Negative
CTACGGGTCTATTGTC	Hashtag8
CTACTATGTAGTTACC	Negative
CTACTATGTGATGTAA	Hashtag6
CTAGACAAGCTTTCTT	Negative
CTAGACAGTTATTCTC	Negative
CTAGACAGTTGACGGA	Negative
CTAGACATCAGACCTA	Negative
CTAGGTAGTGTGTACT	Negative
CTAGGTAGTTACACTG	Negative
CTAGGTATCGTAATGC	Negative
CTATAGGAGGGACAGG	Negative
CTATAGGGTGCTCGTG	Negative
CTATAGGGTTCAGCGC	Negative
CTATAGGTCGGTTGTA	Hashtag6
CTATCCGCAAACAGGC	Negative
CTATCCGCAGATACCT	Hashtag6
CTATCCGTCTAAGCCA	Negative
CTATCCGTCTGCGAGC	Negative
CTATCTACAGCCATTA	Negative
CTATCTACATTCAGGT	Negative
CTATCTAGTGCCCGTA	Hashtag8
CTATCTATCCACGGAC	Hashtag6
CTATCTATCTCAAAGC	Hashtag6
CTCAACCAGTGCCAGA	Negative
CTCAACCCATCTAACG	Negative
CTCAACCGTAGCGCCT	Negative
CTCAACCGTTCCGCAG	Negative
CTCAACCTCTAGAACC	Hashtag6
CTCAAGAAGCCGAACA	Negative
CTCAAGAAGGCCCGTT	Negative
CTCAAGAAGTTACGTC	Negative
CTCAAGACAACAGTGG	Hashtag6
CTCAAGACAACGGCCT	Negative
CTCAAGACACAATCTG	Hashtag6_Hashtag8
CTCAAGAGTAGATGTA	Negative
CTCAAGAGTCTAGGCC	Negative
CTCAAGAGTTGTAAAG	Negative
CTCAATTAGAATTGCA	Hashtag6
CTCAATTAGTTGGAGC	Negative
CTCAATTCAAGTCGTT	Negative
CTCAATTGTCCCTGTT	Hashtag6
CTCAATTGTGCAACGA	Negative
CTCAATTGTTGTAGCT	Hashtag6
CTCAATTGTTTACTGG	Negative
CTCAATTTCCCTGTTG	Hashtag6
CTCACTGAGAAGTGTT	Negative
CTCACTGCATTCGGGC	Negative
CTCACTGGTCGAGATG	Hashtag6
CTCACTGTCCACACAA	Negative
CTCACTGTCTCTGAGA	Hashtag8
CTCAGAATCCGATTAG	Negative
CTCAGGGAGCACCTGC	Negative
CTCAGGGCAGGCATTT	Negative
CTCAGGGGTGACTAAA	Hashtag6
CTCAGGGGTGGAAATT	Negative
CTCAGGGTCAAAGGAT	Negative
CTCAGGGTCTCAACGA	Negative
CTCAGTCAGGCCTTCG	Negative
CTCAGTCGTTGCATCA	Negative
CTCAGTCTCAGCAATC	Negative
CTCATCGAGATACCAA	Negative
CTCATCGGTGATAGTA	Negative
CTCATCGGTGCGGATA	Hashtag6
CTCATGCAGGGTCACA	Negative
CTCATGCCACCAAAGG	Negative
CTCATGCTCACGGTCG	Negative
CTCATGCTCTGGGCAC	Negative
CTCATGCTCTTCCGTG	Hashtag6
CTCATTACACGACCTG	Negative
CTCATTACAGACACCC	Negative
CTCCAACAGAAGTCTA	Negative
CTCCAACAGTAAGAGG	Negative
CTCCAACAGTGCTCAT	Negative
CTCCACAAGCTGCCAC	Hashtag6
CTCCACACATCCTATT	Hashtag6
CTCCACAGTACAGAGC	Negative
CTCCACATCTAGACCA	Hashtag6
CTCCACATCTTACCGC	Negative
CTCCACATCTTAGCTT	Hashtag6
CTCCATGGTAGCTTGT	Negative
CTCCCAAGTCTTTCTA	Negative
CTCCCAATCAAATGAG	Negative
CTCCCTCAGTATAGAC	Negative
CTCCCTCCAAAGCACG	Negative
CTCCCTCCACGACGAA	Negative
CTCCGATCACCTTCGT	Hashtag6
CTCCGATGTACGGATG	Negative
CTCCGATTCTCTTCAA	Negative
CTCCGATTCTTAGCAG	Negative
CTCCTCCCACGTCGGT	Negative
CTCCTCCCAGACACAG	Negative
CTCCTCCGTTAGGGAC	Negative
CTCCTCCTCACTTATC	Hashtag6
CTCCTCCTCCCAGGCA	Negative
CTCCTCCTCGACCTAA	Negative
CTCCTCCTCGAGAATA	Hashtag8
CTCCTTTCAACAAGAT	Negative
CTCCTTTGTACTCGTA	Negative
CTCCTTTTCCTCGATC	Hashtag6_Hashtag8
CTCCTTTTCTGGGCCA	Negative
CTCGAGGAGAGGATGA	Negative
CTCGAGGAGATTAGTG	Negative
CTCGAGGAGGCGAAGG	Negative
CTCGAGGCAACGGCTC	Negative
CTCGAGGCAAGCGCTC	Hashtag6
CTCGAGGTCTCATTGT	Negative
CTCTCAGAGTTAACAG	Negative
CTCTCAGCAGCCCAGT	Hashtag6
CTCTCAGCAGGTGTTT	Hashtag6
CTCTCAGGTCTGCCTT	Negative
CTCTCAGTCTGCGGCA	Negative
CTCTCGAGTAATACCC	Negative
CTCTCGATCCCATTTA	Negative
CTCTCGATCGCTCCTA	Negative
CTCTGGTAGCGTTCCG	Negative
CTCTGGTGTAGGTGCA	Negative
CTCTGGTGTGTGTCGC	Negative
CTCTGGTTCAGACTGT	Negative
CTCTGGTTCGCTGATA	Hashtag6
CTCTGGTTCTATACGG	Hashtag6
CTGAATGAGCCGCACT	Hashtag6
CTGAATGCACAACGAG	Negative
CTGAATGCATAGCACT	Negative
CTGAATGCATCGTGGC	Hashtag6_Hashtag8
CTGAATGCATGTGGTT	Hashtag6
CTGAATGGTCACCGCA	Negative
CTGAATGGTGAGGAAA	Hashtag6
CTGAATGTCGTTCTCG	Negative
CTGAGCGGTAGCGCTC	Negative
CTGAGGCCACATATCG	Negative
CTGAGGCGTTGTGCAT	Hashtag6
CTGAGGCTCCCGATCT	Negative
CTGAGGCTCGCAATGT	Negative
CTGAGGCTCGTTCTCG	Negative
CTGAGGCTCTTCCCAG	Negative
CTGATCCAGGCAATGC	Negative
CTGATCCCACTCAAGT	Hashtag6
CTGATCCGTCTTACAG	Negative
CTGATCCGTTGGTGTT	Negative
CTGATCCTCCTCATAT	Negative
CTGATCCTCGCGTTTC	Hashtag6
CTGCAGGAGGCTCTCG	Hashtag8
CTGCAGGCAGAGAGGG	Negative
CTGCAGGCATTGACTG	Hashtag6_Hashtag8
CTGCAGGTCACACCGG	Negative
CTGCAGGTCCACCCTA	Hashtag6
CTGCATCAGAAACTCA	Hashtag6
CTGCATCAGACTAAGT	Hashtag6
CTGCATCAGCCAACCC	Negative
CTGCATCAGTCGAAGC	Hashtag6
CTGCATCGTTCCATTT	Negative
CTGCATCTCCGATGCG	Hashtag6
CTGCATCTCTCGACCT	Hashtag8
CTGCCATGTACCCGAC	Hashtag6
CTGCCATTCGTTCCTG	Negative
CTGCCTAAGCTCGACC	Negative
CTGCCTACAATCTCTT	Hashtag6
CTGCCTACAGAGTCTT	Hashtag6
CTGCGAGAGAGGATCC	Hashtag6_Hashtag8
CTGCGAGAGATTGAGT	Negative
CTGCGAGCAGCTACTA	Negative
CTGCGAGGTTCATCTT	Hashtag6
CTGCGAGTCCACGGGT	Hashtag6
CTGCTCACATGTTCGA	Negative
CTGCTCAGTCGCGGTT	Negative
CTGCTCATCAGAACCT	Negative
CTGGACGAGCTCGCAC	Hashtag6
CTGGACGCATACATCG	Hashtag6
CTGGACGGTAGGTTTC	Negative
CTGGACGGTCACCTTC	Hashtag6
CTGGACGGTGAGGAAA	Negative
CTGGCAGCAAGGCCTC	Negative
CTGGCAGCACAATGCT	Negative
CTGGCAGCACTAGGTT	Negative
CTGGCAGCAGGAGACT	Negative
CTGGTCTAGGTAAAGG	Hashtag6
CTGGTCTTCACGACTA	Negative
CTGGTCTTCCAGTTCC	Hashtag6
CTGTACCGTTCTCTAT	Negative
CTGTACCTCCTTCTAA	Negative
CTGTAGACAGTGAGCA	Hashtag6
CTGTAGAGTGACTCGC	Negative
CTGTAGAGTTAGAGTA	Negative
CTGTATTAGGTTCATC	Hashtag6
CTGTATTAGTATTCCG	Hashtag6_Hashtag8
CTGTATTCACTAGTAC	Negative
CTGTCGTAGCCTCACG	Negative
CTGTCGTAGTGACCTT	Negative
CTGTCGTGTGCCCACA	Negative
CTGTGAAAGATACAGT	Hashtag6_Hashtag8
CTGTGAAAGGTCATAA	Negative
CTGTGAACAGTTTCGA	Hashtag6
CTGTGAATCTCGGGAC	Negative
CTGTGAATCTTGATTC	Negative
CTGTGGGTCCGATCGG	Negative
CTTACCGAGGGAGGGT	Hashtag6
CTTACCGAGGTCTACT	Negative
CTTACCGCACAAGGTG	Negative
CTTACCGCACACAGAG	Hashtag6
CTTACCGCACCTGAAT	Negative
CTTACCGGTCGAGTGA	Hashtag6
CTTACCGTCACTTATC	Hashtag6
CTTAGGAAGGATTCCT	Negative
CTTAGGAAGGTTAGTA	Hashtag6
CTTAGGAAGTCACTGT	Negative
CTTAGGAGTGACATCT	Hashtag6
CTTAGGATCTTGGTCC	Negative
CTTCAATCACTAGGTT	Negative
CTTCAATGTCATCCCT	Hashtag6
CTTCAATGTGAGTTTC	Negative
CTTCAATTCGATACTG	Negative
CTTCAATTCGGCATTA	Hashtag6
CTTCCGAAGGTTCTAC	Hashtag6
CTTCCGAAGGTTGGAC	Hashtag8
CTTCCGACACACGCCA	Negative
CTTCCGACATACTGAC	Negative
CTTCCGAGTATCGATC	Negative
CTTCCGATCAGCGGAA	Hashtag6_Hashtag8
CTTCCGATCTATGCCC	Hashtag6
CTTCCTTGTATCTCGA	Negative
CTTCCTTGTCATAAAG	Negative
CTTCGGTAGCGGATCA	Negative
CTTCGGTAGTCCCAAT	Hashtag8
CTTCGGTCACTCATAG	Negative
CTTCGGTCAGAGTGTG	Hashtag6
CTTCGGTTCGAATCCA	Negative
CTTCGGTTCGGAGTAG	Negative
CTTCGGTTCGGTATGT	Hashtag8
CTTCGGTTCTACGCGG	Negative
CTTCTAAAGCCAAGGT	Negative
CTTCTAACATACTGAC	Negative
CTTCTAACATTCAGGT	Negative
CTTCTAAGTGACCGAA	Hashtag6
CTTCTAATCCAACCAA	Negative
CTTCTCTCAGCCTATA	Negative
CTTCTCTGTACAGTAA	Negative
CTTCTCTGTCACAGTT	Hashtag6
CTTGAGAGTTGCTGAT	Negative
CTTGAGATCCGTCACT	Hashtag6
CTTGATTAGATGTTAG	Negative
CTTGATTAGGGAGGAC	Negative
CTTGATTCAGTAGTGG	Hashtag6
CTTGATTCAGTATGAA	Negative
CTTGATTCATGACGTT	Hashtag6
CTTGATTGTGAACGGT	Hashtag6_Hashtag8
CTTGATTGTGTTCGAT	Negative
CTTGATTTCGTAGAGG	Negative
CTTTCAAAGGTCGTAG	Negative
CTTTCAACAAGCGAGT	Hashtag8
CTTTCAACATGCTGCG	Negative
CTTTCAAGTCTCGACG	Negative
CTTTCAAGTTATGACC	Hashtag8
CTTTCAATCTGGCTGG	Negative
CTTTCGGAGTAAGGGA	Hashtag6_Hashtag8
CTTTCGGCAAAGGAGA	Negative
GAAACCTAGAGAGAAC	Negative
GAAACCTAGAGTCAGC	Negative
GAAACCTAGCCTGCCA	Negative
GAAACCTCAGCTGTCG	Negative
GAAACCTGTGGCAGAT	Negative
GAAATGAAGCAACAAT	Negative
GAAATGACACCAACAT	Negative
GAAATGACAGCAGTGA	Negative
GAAATGATCAAGCGTT	Negative
GAAATGATCAGCTCTC	Negative
GAACACTAGGCACCAA	Negative
GAACACTCAGGAGGTT	Negative
GAACACTTCAACTTTC	Hashtag6
GAACACTTCACCTCAC	Hashtag6
GAACACTTCAGGAACG	Negative
GAACGTTCAGGACATG	Negative
GAACGTTGTCTAGTGT	Negative
GAACGTTTCTCCAAGA	Hashtag6
GAACTGTAGGGCAACT	Negative
GAACTGTTCGAATCCA	Hashtag6
GAAGAATAGACGCATG	Negative
GAAGAATCAAGAGGCT	Negative
GAAGAATGTTAAACCC	Negative
GAAGAATGTTAGGGAC	Negative
GAAGCCCCAAGGTCGA	Negative
GAAGCCCGTGACTGAG	Negative
GAAGCCCTCTCGTCAC	Negative
GAAGCGACATACCATG	Negative
GAAGCGACATTCTTCA	Hashtag6
GAAGCGAGTCGAACGA	Hashtag6
GAAGCGATCCAAACCA	Negative
GAAGCGATCCGCAACG	Negative
GAAGCGATCGCTTAAG	Hashtag6
GAAGGACAGTCGTTAC	Hashtag6
GAAGGACGTCACGACC	Hashtag6
GAAGGACGTTGGAGGT	Hashtag6
GAAGGACTCATAGCAC	Negative
GAAGGACTCCGCAACG	Negative
GAAGGACTCTGGGATT	Negative
GAAGGGTAGGTAGTCG	Hashtag6
GAAGGGTCAAAGGTTA	Negative
GAAGGGTCAAGCTACT	Negative
GAAGGGTCACCATATG	Negative
GAAGGGTTCAGCCCAG	Negative
GAAGTAAAGAGGACTC	Negative
GAAGTAAAGGACACTG	Negative
GAATAGAAGGTTAGTA	Hashtag6
GAATAGAAGTCTCTGA	Negative
GAATAGAGTAATGCGG	Negative
GAATAGAGTATCGAGG	Negative
GAATAGAGTGAGACGT	Negative
GAATAGATCAAATGAG	Negative
GAATAGATCGTGTGGC	Negative
GAATCACAGCCATTTG	Hashtag6
GAATCACAGCGCCTCA	Negative
GAATCACAGCGTGTCC	Negative
GAATCACAGCTTCTAG	Negative
GAATCACTCTGCTCTG	Negative
GAATCGTTCTGTGCGG	Hashtag8
GACACGCAGATGAAGG	Negative
GACACGCAGCGTGCTC	Negative
GACACGCAGGATTCAA	Negative
GACACGCGTACTCGAT	Negative
GACACGCGTATCAGGG	Negative
GACACGCGTCGCACAC	Negative
GACACGCTCCCAAGTA	Negative
GACACGCTCTCGCAGG	Negative
GACAGCCAGATACATG	Hashtag6
GACAGCCCAATACGAA	Negative
GACAGCCCATCAGCTA	Negative
GACAGCCCATTGAGCT	Negative
GACATCAAGATACTGA	Hashtag6
GACATCAGTGAATGTA	Negative
GACCAATAGTTGAAGT	Negative
GACCAATCAGCCCAGT	Negative
GACCAATGTGTTTACG	Negative
GACCAATTCACAGTGT	Negative
GACCCAGAGAAGAGCA	Negative
GACCCAGCAACCACAT	Negative
GACCCAGCACGGATCC	Negative
GACCCAGCATGACACT	Negative
GACCCAGGTAGGATAT	Negative
GACCCAGGTGCGGATA	Hashtag6
GACCCAGGTTATGTGC	Negative
GACCCAGTCTTGCAAG	Negative
GACCCTTAGGTGATCG	Negative
GACCCTTGTTCTCACC	Negative
GACCCTTGTTGACTAC	Negative
GACCCTTTCCAGCACG	Negative
GACCCTTTCGAGGCAA	Negative
GACCCTTTCTACGCGG	Hashtag6
GACCCTTTCTAGACAC	Hashtag6
GACCGTGCACAAGCTT	Negative
GACCGTGCACAGAGAC	Negative
GACCGTGCATGACAGG	Negative
GACCGTGGTGGATGAC	Negative
GACCGTGTCGAACCTA	Negative
GACCTTCAGGCCTGCT	Negative
GACCTTCCACGGATCC	Negative
GACCTTCTCAGTGTTG	Hashtag6_Hashtag8
GACCTTCTCCCATAGA	Negative
GACCTTCTCTTCGACC	Negative
GACGCTGAGACTAAGT	Hashtag6
GACGCTGAGCTACAAA	Negative
GACGCTGAGCTGACCC	Hashtag8
GACGCTGGTGAGCCAA	Negative
GACGTTAAGCCTATTG	Negative
GACGTTAAGGGTAATT	Negative
GACGTTACACGTACTA	Negative
GACGTTATCAAACTGC	Negative
GACGTTATCCCAATAG	Negative
GACTATGAGACGGAAA	Negative
GACTATGCACAGACGA	Negative
GACTATGTCAGACCGC	Hashtag6
GACTCAAAGCCATGCC	Negative
GACTCAAAGTCATACC	Negative
GACTCAACAACCGCTG	Negative
GACTCAACATCGCCTT	Negative
GACTCTCAGTACCATC	Hashtag6
GACTCTCAGTCACTGT	Negative
GACTCTCGTACCTGTA	Hashtag6
GACTCTCGTTAAGGGC	Negative
GACTGATAGGCAGGGA	Hashtag8
GACTGATCAACTAGAA	Negative
GACTGATCATTGCTTT	Negative
GACTGATGTAGGCAGT	Hashtag6
GACTGATGTGCTAGCC	Hashtag6
GACTTCCAGGCCTGAA	Negative
GACTTCCAGTGAGGCT	Hashtag6
GACTTCCCAGTTTGGT	Hashtag6
GACTTCCGTAGGAAAG	Hashtag6
GACTTCCGTCTACAAC	Negative
GACTTCCGTGGCCACT	Negative
GACTTCCGTTCATCTT	Negative
GAGAAATAGTCGAGGT	Negative
GAGAAATCAGCATCTA	Hashtag6
GAGAAATGTGCCTGAC	Negative
GAGAAATTCGAGTTGT	Hashtag6
GAGACCCAGCCGTTAT	Negative
GAGACCCAGCGTGCTC	Negative
GAGACCCAGGCTGGAT	Hashtag6
GAGACCCCACGTGTGC	Negative
GAGACCCCACTACAGT	Negative
GAGACCCCATCGCTCT	Negative
GAGACCCCATCTCCCA	Negative
GAGACCCTCGATTCCC	Negative
GAGACTTAGATTAGAC	Negative
GAGACTTAGCCTCAGC	Negative
GAGACTTCAGTAACCT	Negative
GAGACTTTCCGAAGGA	Negative
GAGACTTTCCGGTAGC	Negative
GAGACTTTCGATTGGT	Hashtag6_Hashtag8
GAGACTTTCTCTGGTC	Negative
GAGAGGTAGATTCGCT	Negative
GAGAGGTCACACGTGC	Negative
GAGAGGTCATGCCATA	Hashtag8
GAGAGGTTCGCTGACG	Negative
GAGATGGAGTTCATGC	Negative
GAGATGGCAACCCTAA	Negative
GAGATGGCAGATGCGA	Hashtag6_Hashtag8
GAGATGGTCGGTAACT	Negative
GAGCCTGAGCACCGAA	Negative
GAGCCTGAGCAGGGAG	Negative
GAGCCTGAGCGCCTCA	Negative
GAGCCTGGTTCGTTCC	Negative
GAGCCTGTCGTCGACG	Negative
GAGCCTGTCTGGCCAG	Hashtag6
GAGCTGCAGAGGGCGA	Negative
GAGCTGCAGTGTTCAC	Negative
GAGCTGCTCAAGGAGC	Negative
GAGCTGCTCCATATGG	Negative
GAGGCAAAGTCAGAGC	Negative
GAGGCAACAATACGAA	Hashtag6
GAGGCAAGTGATAGAT	Hashtag6
GAGGCCTAGCACTCAT	Negative
GAGGCCTCAGTTTGGT	Negative
GAGGCCTGTGAATTAG	Negative
GAGGCCTGTGTAACGG	Negative
GAGGCCTTCAGAGCAG	Negative
GAGGGATAGCAATAGT	Negative
GAGGGATAGGGTACGT	Negative
GAGGGATGTCATCTAG	Negative
GAGGGATTCATCGACA	Negative
GAGGGTAAGGTAAACT	Negative
GAGGGTACATTGAAAG	Negative
GAGGGTAGTACAATAG	Negative
GAGGGTAGTTGTTGTG	Negative
GAGGGTATCCTACACC	Negative
GAGTCATAGCTAAACA	Negative
GAGTCATTCACCTCTG	Negative
GAGTCTAAGGCATGCA	Negative
GAGTCTACACATTGTG	Negative
GAGTCTACACCCTCTA	Negative
GAGTCTAGTGGAACCA	Negative
GAGTCTATCACTGTCC	Negative
GAGTCTATCCCTCAAC	Negative
GAGTCTATCGCAGTTA	Negative
GAGTGAGAGATAGCTA	Negative
GAGTGAGAGTTTGTCG	Hashtag6
GAGTGAGGTGCCTACG	Negative
GAGTGAGTCGACGCTG	Negative
GAGTGAGTCTGAGAGG	Negative
GAGTGTTAGCTGACTT	Negative
GAGTGTTCAGACCAAG	Negative
GAGTGTTGTACTCCCT	Negative
GAGTGTTGTCGCATCG	Negative
GAGTTACCACGGCACT	Negative
GAGTTACCAGTCCCGA	Hashtag6
GAGTTACGTCCAAATC	Negative
GAGTTACGTCGTCTCT	Negative
GAGTTACTCGTCAGAT	Negative
GAGTTGTAGATGATTG	Hashtag6
GAGTTGTCAGCCTTCT	Negative
GAGTTGTCATCTTCGC	Negative
GAGTTGTTCATTACGG	Negative
GAGTTTGAGGTGCGAT	Negative
GAGTTTGCACGAAAGC	Negative
GAGTTTGGTCCTATAG	Negative
GAGTTTGGTGGATCGA	Negative
GAGTTTGTCTCGTGAA	Hashtag8
GATAGAAAGGCCTTGC	Negative
GATAGAAAGTGTAGAT	Negative
GATAGAACAGAAGTGC	Negative
GATAGAAGTATCGATC	Hashtag6_Hashtag8
GATAGAATCAAACTGC	Hashtag6
GATAGCTGTAGACAGC	Negative
GATAGCTGTTCGGGTC	Negative
GATAGCTTCGCAGTCG	Negative
GATCACAAGGTCGTCC	Hashtag8
GATCACAGTGGTCCCA	Negative
GATCACATCTGAGAGG	Negative
GATCAGTCACTGGAAG	Hashtag6
GATCAGTCAGAGAAAG	Hashtag6
GATCAGTGTACCATAC	Negative
GATCAGTGTTACGGAG	Negative
GATCAGTTCGGTTGTA	Negative
GATCATGAGTATCTGC	Hashtag6
GATCATGGTACAGCGA	Negative
GATCATGGTGAGAACC	Negative
GATCATGTCCTACAAG	Negative
GATCCCTAGGATGAGA	Negative
GATCCCTCATGGCACC	Negative
GATCCCTTCCATCTCG	Hashtag6
GATCCCTTCGGTAACT	Negative
GATCGTACAATCGCGC	Negative
GATCGTAGTCACAATC	Negative
GATCGTATCGAGAGCA	Negative
GATGACTAGATTTGCC	Negative
GATGACTAGGACAGCT	Negative
GATGACTCAATGCAAA	Negative
GATGACTCATCCTAAG	Negative
GATGACTCATTGTACG	Negative
GATGAGGAGCGCATCC	Hashtag6
GATGAGGAGGTATCTC	Negative
GATGAGGAGTTTAGGA	Hashtag6
GATGAGGCAGTGTGCC	Negative
GATGATCAGAACTCCT	Hashtag6
GATGATCAGTGCCAGA	Hashtag6
GATGATCCACAGTCCG	Negative
GATGATCGTACGGTTT	Negative
GATGATCGTATTGCCA	Hashtag6
GATGATCGTTCTCGTC	Negative
GATGATCTCAATCTTC	Negative
GATGCTAAGTACGTCT	Negative
GATGCTACAAGACAAT	Negative
GATGCTACACAAGCTT	Negative
GATGCTAGTATCTCGA	Negative
GATGCTATCATAGGCT	Negative
GATGCTATCTGTCTCG	Negative
GATGGAGCAGGTTCAT	Hashtag6
GATGGAGGTTGGCTAT	Negative
GATGTTGAGCAGCAGT	Negative
GATGTTGAGTAGGATT	Negative
GATGTTGCAGACATCT	Negative
GATGTTGGTTGTACGT	Negative
GATGTTGTCCCTCTTT	Negative
GATTCGACATATCTGG	Negative
GATTCGAGTACAGTCT	Hashtag6
GATTCGATCTTCCCAG	Hashtag6
GATTCTTAGTGATGGC	Negative
GATTCTTCATCATCCC	Hashtag6
GATTGGTCACTGGATT	Hashtag6
GATTGGTGTCTTGCTC	Negative
GATTGGTTCACCCTTG	Negative
GATTGGTTCCACCTCA	Negative
GATTTCTGTCGCATCG	Negative
GATTTCTTCCGCACGA	Negative
GATTTCTTCTGTGCAA	Hashtag8
GCAACATAGAGTTGTA	Negative
GCAACATGTCGCGGTT	Negative
GCAACATTCCCAGGCA	Negative
GCAACATTCCGAAATC	Negative
GCAACATTCTATTTCG	Negative
GCAACATTCTGAGGTT	Negative
GCAACCGAGTAGGTTA	Hashtag6
GCAACCGCAGCTCATA	Hashtag6
GCAACCGCAGTGGCTC	Negative
GCAACCGTCCCTCATG	Negative
GCAACCGTCGGCCAAC	Hashtag6
GCACATAGTCCGGTCA	Negative
GCACATAGTGCAGGAT	Negative
GCACATAGTGTCGCTG	Hashtag8
GCACATATCAAATAGG	Negative
GCACATATCACTACTT	Hashtag8
GCACGGTAGCAGAAAG	Negative
GCACGGTAGCTAAGTA	Negative
GCACGGTAGGCTTAGG	Hashtag6
GCACGGTAGGGACTGT	Hashtag6_Hashtag8
GCACGGTCAGCATTGT	Negative
GCACGGTGTTGGGTTT	Negative
GCACGTGAGTTCCTGA	Hashtag6
GCACGTGCATCCGAGC	Hashtag8
GCACGTGGTAGCTAAA	Negative
GCACGTGGTTGCTCCT	Negative
GCACGTGTCTTGAACG	Hashtag6
GCACTAAAGAGTTGCG	Negative
GCACTAAAGTCATACC	Negative
GCACTAACAGTATTCG	Negative
GCAGCTGGTGCGAACA	Hashtag6
GCAGCTGGTGGTTCTA	Hashtag6
GCAGCTGTCCAACCAA	Negative
GCAGGCTAGCAATTAG	Negative
GCAGGCTGTGAGACGT	Negative
GCAGGCTTCACGGACC	Hashtag6
GCAGGCTTCTACGCGG	Negative
GCAGTTAAGCTAATCC	Hashtag6
GCAGTTAAGGAACGCT	Negative
GCAGTTAAGGTCTACT	Hashtag8
GCAGTTACAGGTGGAT	Hashtag6
GCAGTTACATGTTCAG	Hashtag6
GCAGTTAGTTCCTAGA	Negative
GCAGTTATCAACGTGT	Hashtag8
GCATCGGAGTTCGCAT	Hashtag6
GCATCGGCAAGGTCAG	Negative
GCATCGGGTCCGGTGT	Negative
GCATCGGGTTGATGTC	Hashtag6_Hashtag8
GCATCGGTCTCCTGTG	Hashtag6
GCATCTCAGCCTCAAT	Negative
GCATCTCAGGTCTACT	Negative
GCATCTCGTGCCTATA	Negative
GCATGATTCATAGACC	Negative
GCATTAGAGTCACTGT	Negative
GCATTAGCAAAGCAAT	Hashtag6
GCATTAGCATACCGTA	Negative
GCATTAGGTCGTGGTC	Negative
GCATTAGTCCGCTAGG	Negative
GCATTAGTCGGCTGAC	Negative
GCATTAGTCTTTCTAG	Hashtag6_Hashtag8
GCCAACGAGACCAGAC	Hashtag6_Hashtag8
GCCAACGAGAGAATCT	Hashtag6
GCCAACGCAACGGTAG	Hashtag6_Hashtag8
GCCAACGGTCAAGTTC	Negative
GCCAACGGTGTAGGAC	Negative
GCCAGCAAGCCTTTGA	Hashtag6
GCCAGCAAGTGGAATT	Negative
GCCAGCAGTAGCTTTG	Negative
GCCAGGTCAACGACAG	Negative
GCCAGGTCACCCTGAG	Hashtag6
GCCAGGTCAGTGTATC	Negative
GCCAGGTCATGGATCT	Hashtag6
GCCAGGTGTGCCTGAC	Hashtag6
GCCAGGTTCCGTGGCA	Negative
GCCAGTGAGAAATTCG	Negative
GCCAGTGCAGCAATTC	Negative
GCCAGTGCAGCGACAA	Negative
GCCAGTGGTAACAGTA	Negative
GCCAGTGGTATAATGG	Negative
GCCAGTGGTCTAACTG	Negative
GCCAGTGGTGGTTTGT	Hashtag6
GCCAGTGGTGTACGCC	Negative
GCCATGGAGCTGTTCA	Negative
GCCATGGAGGTCCGAA	Negative
GCCATGGCACAACCGC	Negative
GCCATGGGTTCCTAGA	Negative
GCCATGGTCCTGCTAC	Negative
GCCATTCAGCAATTCC	Negative
GCCATTCAGTGCGACA	Negative
GCCATTCCAGACGGAT	Negative
GCCATTCGTCCGGCAT	Negative
GCCATTCGTGTCCGTG	Hashtag6
GCCATTCGTTCAACGT	Negative
GCCATTCGTTGAGAGC	Hashtag8
GCCATTCGTTTAGAGA	Negative
GCCATTCTCGGCGATC	Hashtag6
GCCCAGAAGGGATCGT	Negative
GCCCAGAAGTTACGGG	Negative
GCCCAGACACCATATG	Negative
GCCCAGACACCTCAGG	Negative
GCCCAGACAGAGGCTA	Negative
GCCCAGAGTCTTAGTG	Hashtag6
GCCCGAAAGTGGATAT	Negative
GCCCGAAGTAAGACCG	Hashtag6
GCCCGAATCACAACCA	Negative
GCCCGAATCCACACCT	Negative
GCCCGAATCGGATACT	Negative
GCCGATGCACTTCTCG	Negative
GCCGATGGTCTGCATA	Negative
GCCGATGGTGCTGCAC	Negative
GCCGATGGTTAGAAAC	Negative
GCCGATGGTTTCGCTC	Negative
GCCGATGTCAGGAAGC	Negative
GCCGTGAAGCGACAGT	Negative
GCCGTGACAACGCCCA	Negative
GCCGTGACAGGGACTA	Negative
GCCGTGACATCATTGG	Negative
GCCGTGAGTGACGTCC	Negative
GCCGTGATCTCCTACG	Negative
GCCTGTTAGCCTAGGA	Negative
GCCTGTTAGTAACCGG	Hashtag6
GCCTGTTGTATGCGGA	Negative
GCCTGTTGTGGATTTC	Negative
GCCTGTTTCCGAGCTG	Negative
GCGAGAAAGACCTCAT	Negative
GCGAGAAAGCGCTGCT	Hashtag6
GCGAGAAAGTAACGAT	Negative
GCGAGAACAAGATGGC	Negative
GCGAGAAGTATGAAAC	Negative
GCGAGAAGTATGGGAC	Negative
GCGAGAAGTCTATGAC	Hashtag6
GCGATCGAGAGTAACT	Negative
GCGATCGAGCGTATGG	Negative
GCGATCGAGGAAGTGA	Hashtag6
GCGATCGTCTGGACTA	Negative
GCGGAAAAGGGTTGCA	Hashtag6
GCGGAAACAAAGGAGA	Hashtag6
GCGGAAACACAAAGCG	Hashtag8
GCGGAAACACGTACAT	Hashtag6
GCGGAAACATACCATG	Negative
GCGGAAAGTATGTCTG	Hashtag8
GCGGAAAGTCAGTCGC	Hashtag6
GCGGAAAGTCTGTGAT	Negative
GCGGAAAGTCTTTCTA	Negative
GCGGAAAGTTAGGAGC	Hashtag6
GCGGATCAGAAACCAT	Negative
GCGTGCAAGTGGCAGT	Negative
GCGTGCATCGATAACC	Negative
GCGTTTCCAAGTTCCA	Negative
GCGTTTCCACCCTTGT	Negative
GCGTTTCGTATCCTCC	Negative
GCGTTTCGTCGAGCAA	Negative
GCGTTTCGTGGCTCTG	Hashtag6
GCTACAATCTCATAGG	Negative
GCTACCTAGCCTGACC	Negative
GCTACCTGTCCAGCCA	Negative
GCTACCTGTCGACTTA	Negative
GCTCAAAAGACTGAGC	Negative
GCTCAAAGTACACTCA	Hashtag6
GCTCAAATCCGGACGT	Negative
GCTGAATCACTTCCTG	Negative
GCTGAATTCAGGCGAA	Negative
GCTGAATTCTCCGCAT	Hashtag6
GCTGCAGAGAGAGTGA	Negative
GCTGCAGAGCACAAAT	Hashtag6
GCTGCAGAGCTCGACC	Negative
GCTGCAGCAACCGACC	Negative
GCTGCAGGTGTAGCAG	Hashtag6
GCTGCAGGTGTCGCTG	Hashtag6
GCTGCAGGTGTTTCTT	Negative
GCTGCAGTCCTCACCA	Negative
GCTGGGTAGTGGAATT	Negative
GCTGGGTCAGAGATTA	Negative
GCTGGGTTCGGACTGC	Negative
GCTGGGTTCTTGCAGA	Negative
GCTTCACAGATAGGGA	Negative
GCTTTCGAGGAGAGGC	Hashtag6
GCTTTCGTCACCCTGT	Negative
GCTTTCGTCAGCTGAT	Hashtag6
GCTTTCGTCGAGCACC	Negative
GCTTTCGTCTCGGTCT	Hashtag6
GCTTTCGTCTCTGAGA	Negative
GGAACCCCATTCTCTA	Negative
GGAACCCGTAGGTCAG	Negative
GGAACCCGTGAATTGA	Hashtag6
GGAACCCGTTTATGCG	Negative
GGAACCCTCACGGTCG	Negative
GGAACCCTCTCGGCTT	Negative
GGAAGTGAGACAACAT	Hashtag6
GGAAGTGCAGAGCCCT	Negative
GGAAGTGTCAAAGGTA	Negative
GGAAGTGTCGAGAGAC	Hashtag6
GGAAGTGTCTCTGGTC	Negative
GGAATCTAGGAAGTCC	Negative
GGAATCTAGGGTTAGC	Negative
GGAATCTCAAGCACAG	Hashtag6
GGAATCTCAGAGTTCT	Hashtag8
GGAATCTGTAATGTGA	Hashtag6_Hashtag8
GGAATCTTCATCTATC	Negative
GGAATGGAGCTCGAAG	Hashtag6
GGAATGGGTCTGTAGT	Hashtag8
GGAATGGGTGAATATG	Negative
GGAATGGGTGTCGATT	Hashtag6
GGACGTCAGTGGTCAG	Negative
GGACGTCCAATCAGCT	Negative
GGACGTCTCAACCTCC	Hashtag6
GGACGTCTCATTCATC	Negative
GGACGTCTCTAGATCG	Hashtag6
GGAGAACAGAGCTGAC	Negative
GGAGAACCACATATCG	Negative
GGAGAACGTAGCTGCC	Negative
GGAGAACGTGAAAGTT	Negative
GGAGATGAGCGTTAGG	Negative
GGAGATGCACTATCGA	Hashtag6
GGAGATGGTCCAATCA	Negative
GGAGATGGTCCCAAAT	Negative
GGAGATGGTCTCCTGT	Negative
GGAGATGGTGCCAAGA	Hashtag6
GGAGATGTCTCGCAGG	Negative
GGAGCAAAGCAGCACA	Negative
GGAGCAAGTCGACTGC	Negative
GGAGCAATCCATGATG	Hashtag6
GGAGCAATCCCTGGTT	Hashtag6
GGAGGATAGCGACAGT	Hashtag6
GGAGGATCAATCCAGT	Hashtag6
GGAGGATCACTTGTCC	Hashtag6
GGAGGATCAGGCATGA	Negative
GGAGGATCATTGTAGC	Negative
GGAGGATGTCAACCTA	Negative
GGAGGATTCTACTGCC	Hashtag8
GGAGGATTCTAGCCAA	Hashtag6
GGAGGTAAGCTAGAGC	Negative
GGAGGTAGTCACCCTT	Hashtag8
GGAGGTATCGTACACA	Negative
GGAGGTATCTCGTGGG	Negative
GGATCTAAGGCATTTC	Hashtag6_Hashtag8
GGATCTACAATGTTGC	Hashtag6
GGATCTAGTAGCTTAC	Negative
GGATCTATCTTTGCTA	Negative
GGATGTTCAACCTATG	Negative
GGATGTTGTAGGACTG	Negative
GGATGTTTCCCGAGAC	Hashtag6
GGCACGTAGCTTCATG	Hashtag6_Hashtag8
GGCACGTGTACACGCC	Hashtag6
GGCACGTGTGAGCAGT	Hashtag6
GGCAGTCAGCACACAG	Negative
GGCAGTCAGGGTACAC	Negative
GGCAGTCAGTACGAGC	Negative
GGCAGTCGTTGGGCCT	Negative
GGCGTCAAGACAACAT	Negative
GGCTGTGCAATTCGTG	Negative
GGCTGTGCATGGAGAC	Hashtag8
GGCTGTGGTCTTGCGG	Hashtag6
GGCTGTGTCAGGACAG	Negative
GGCTTGGAGACTGGGT	Negative
GGCTTGGAGGTTTGAA	Negative
GGCTTGGCAAGTCCCG	Negative
GGCTTGGCAATTGAGA	Hashtag6
GGCTTGGCATGGCGCT	Negative
GGCTTGGGTTATTCTC	Hashtag6
GGCTTGGTCGAACACT	Negative
GGCTTTCAGGATTACA	Negative
GGCTTTCAGTTTAGGA	Negative
GGCTTTCCAAAGGTTA	Negative
GGCTTTCCACTCTGCT	Negative
GGCTTTCGTGGGAGAG	Negative
GGGAAGTAGGATATAC	Negative
GGGAAGTCAACCGCTG	Hashtag6
GGGAAGTCAAGGACAC	Negative
GGGAAGTCAATAACGA	Negative
GGGAAGTGTACGGTTT	Negative
GGGAAGTTCCCGAACG	Negative
GGGACAAAGACTAAGT	Negative
GGGACAAAGTGCGACA	Hashtag6
GGGACAACACAGTCAT	Hashtag6
GGGACAACACCCATAA	Negative
GGGACAACACTGCTTC	Negative
GGGACAATCGTCGACG	Negative
GGGACCTAGCACTCCG	Hashtag6
GGGACCTCAGTAGAGC	Negative
GGGACCTGTACCCAGC	Negative
GGGACCTTCGCTAAAC	Negative
GGGACCTTCTTCCCAG	Hashtag6
GGGACTCCAAGACCTT	Hashtag6
GGGACTCCAGGGATAC	Hashtag6
GGGACTCGTGCAACGA	Negative
GGGACTCTCTCTCTTC	Hashtag6
GGGAGATAGCGAGGAG	Hashtag6
GGGAGATAGGGTTTCT	Negative
GGGAGATAGTCGCCCA	Negative
GGGAGATGTAGAATGT	Negative
GGGAGATGTATCGTTG	Negative
GGGAGATGTGCATACT	Negative
GGGAGATGTGTGTCGC	Negative
GGGAGTAAGTACCGGA	Negative
GGGAGTACATGTGGTT	Hashtag6
GGGAGTATCAACTGAC	Negative
GGGAGTATCCGGGACT	Negative
GGGATCCAGGATTCCT	Hashtag6
GGGATCCAGTATTAGG	Negative
GGGATCCAGTGAGCCA	Negative
GGGATCCTCACTGGGC	Hashtag6
GGGATCCTCATCACCC	Negative
GGGATGACACATCCCT	Hashtag6
GGGATGACATTAAAGG	Negative
GGGATGAGTGTTAGCT	Hashtag6
GGGATGATCAAGAAAC	Negative
GGGATGATCTAGTGAC	Negative
GGGATGATCTAGTGTG	Negative
GGGCCATAGAATAACC	Negative
GGGCCATGTCTACACA	Negative
GGGCGTTAGTAACAGT	Negative
GGGCGTTCAGGATTCT	Negative
GGGCGTTGTACGCTAT	Negative
GGGCGTTGTAGGCTCC	Hashtag6
GGGCGTTTCGCGTAGC	Hashtag6_Hashtag8
GGGCGTTTCGTGCGAC	Negative
GGGCTACAGGGCCAAT	Negative
GGGCTACAGTAAACAC	Negative
GGGCTACCATCTTCGC	Negative
GGGCTACGTAGCCAGA	Hashtag6
GGGCTACGTAGTATAG	Negative
GGGCTACTCAGTGTTG	Negative
GGGCTACTCTGTACAG	Negative
GGGCTCACAGGTCCCA	Negative
GGGCTCATCTGGCCTT	Hashtag6
GGGTAGAAGAGTGTTA	Negative
GGGTAGAAGTCGCCCA	Negative
GGGTAGAAGTTCACTG	Hashtag6
GGGTAGAGTGCTATTG	Negative
GGGTATTAGAGTGACC	Negative
GGGTATTAGTTCTACG	Negative
GGGTCACAGAAGTATC	Negative
GGGTCACAGGTGCCAA	Negative
GGGTCACGTAGTTAGA	Hashtag6
GGGTCACGTATCGCTA	Negative
GGGTCTGAGAGAACCC	Negative
GGGTCTGAGAGGCTGT	Negative
GGGTCTGCAATGTCTG	Hashtag6
GGGTCTGCACACCTGG	Negative
GGGTGAACAGTGTATC	Negative
GGGTGAACATGATGCT	Negative
GGGTGTCCAACACGTT	Negative
GGGTGTCTCCCAGGAC	Negative
GGGTTATAGACATACA	Negative
GGGTTATAGCGAATGC	Negative
GGGTTATAGTGTTGTC	Negative
GGGTTATTCAAGTAAG	Negative
GGGTTATTCGTACACA	Negative
GGGTTTAAGCGTCTCG	Negative
GGGTTTAGTGTCCTAA	Negative
GGGTTTATCACTGTTT	Negative
GGTAACTAGTCTTCGA	Negative
GGTAACTCACGGAAGT	Negative
GGTAACTCAGAAGTTA	Negative
GGTAACTGTATACCCA	Negative
GGTAACTGTATGGAAT	Negative
GGTAACTTCACTGATG	Hashtag6
GGTAACTTCCATTGCC	Negative
GGTAACTTCCGTGTCT	Hashtag6
GGTAACTTCGGCAGTC	Negative
GGTAACTTCTTCACGC	Negative
GGTAATCAGGTCACCC	Negative
GGTAATCAGTGCTACT	Negative
GGTAATCCAGAGACTG	Negative
GGTAATCCATTCTTCA	Negative
GGTAATCGTACTGCCG	Negative
GGTAATCTCGGCAGTC	Negative
GGTAGAGCAGTAGAGC	Negative
GGTAGAGGTAGATCCT	Negative
GGTAGAGGTCCTTAAG	Negative
GGTAGAGTCGAGCACC	Negative
GGTCACGGTATCGCAT	Hashtag8
GGTCACGGTCAGCGTC	Negative
GGTCACGGTCTCAGAT	Negative
GGTCACGTCATGCCCT	Negative
GGTCTGGAGCGTGTCC	Hashtag6
GGTCTGGCACCATAAC	Negative
GGTCTGGCAGACCATT	Hashtag6
GGTCTGGGTCAACCTA	Negative
GGTCTGGTCGAGCTGC	Negative
GGTCTGGTCGTAACAC	Negative
GGTCTGGTCTACTCAT	Negative
GGTGAAGCAAGAATGT	Negative
GGTGAAGCAAGCACAG	Negative
GGTGAAGCACTGTCCT	Negative
GGTGAAGCATATCTCT	Negative
GGTGAAGGTGCAACAG	Hashtag6
GGTGAAGTCCCGGTAG	Negative
GGTGAAGTCCTTGAAG	Negative
GGTGATTAGGTCGACA	Hashtag6
GGTGATTTCTTCACAT	Hashtag6
GGTGGCTCAAATGGTA	Negative
GGTGGCTCACAGAAGC	Negative
GGTGGCTGTACACGTT	Hashtag6
GGTGGCTGTCTTCATT	Negative
GGTGGCTTCAAGGTGG	Negative
GGTGGCTTCGCATGAT	Negative
GGTGGCTTCTATCGCC	Negative
GGTGTCGAGGCTAGCA	Negative
GGTGTCGCAGAACTAA	Negative
GGTGTCGCATTCTCCG	Negative
GGTGTCGGTCAAACGG	Negative
GGTGTCGGTGACTCTA	Hashtag6
GGTGTCGGTTGAAGTA	Negative
GGTGTTACAGGTCCGT	Negative
GGTGTTAGTTCATCTT	Hashtag6
GGTGTTATCACAACCA	Negative
GGTGTTATCACAAGGG	Negative
GGTTAACAGACCACGA	Hashtag8
GGTTAACAGAGTAACT	Negative
GGTTAACGTCTTAGTG	Negative
GGTTAACTCTCTAGGA	Hashtag6
GGTTCTCAGGATTACA	Negative
GGTTCTCCAGCAAGAC	Negative
GGTTCTCGTGTTCGTA	Negative
GGTTCTCTCCGTAGGC	Negative
GGTTGTAAGGCCTGAA	Negative
GGTTGTACAACAAGTA	Negative
GGTTGTACACATGAAA	Negative
GGTTGTAGTGCCTGCA	Hashtag6_Hashtag8
GTAACACAGTCATACC	Hashtag6
GTAACACCAGGAACCA	Negative
GTAACACGTCTAGATC	Negative
GTAACCAAGAGTTGAT	Hashtag6
GTAAGTCCACGCTGAC	Negative
GTAAGTCGTATGTCTG	Hashtag6
GTAAGTCGTCCAAAGG	Negative
GTAAGTCTCCGACATA	Negative
GTAATCGCAATCTCGA	Negative
GTAATCGCAGATTAAG	Negative
GTAATCGTCCGTTGAA	Negative
GTAATGCCAACGGCCT	Negative
GTAATGCGTGAGACGT	Negative
GTACAACAGTACTGGG	Negative
GTACAACCACAGCGCT	Negative
GTACAACCAGGGATAC	Negative
GTACAACCAGTCCCGA	Negative
GTACAACGTTGGGACA	Negative
GTACAACTCATTTGCT	Negative
GTACAACTCCCTCGAT	Negative
GTACAGTAGCGACATG	Hashtag6
GTACAGTAGGGAGATA	Negative
GTACAGTAGGTGGCTA	Negative
GTACAGTGTGAGTAGC	Negative
GTACAGTTCCTAAGTG	Negative
GTAGAAATCGCGTCGA	Negative
GTAGAGGGTACAGAGC	Negative
GTAGAGGTCGTTAGTG	Negative
GTAGATCAGCTGAAGC	Negative
GTAGATCAGGCTCACC	Negative
GTAGATCAGGTATTGA	Hashtag6
GTAGCTAAGAACTTCC	Negative
GTAGCTAAGAATCTAG	Negative
GTAGCTAAGGTATTGA	Hashtag6
GTAGCTACAGTTGTCA	Negative
GTAGCTACATAGTCGT	Negative
GTAGCTATCGGTAAGG	Hashtag6
GTAGGAGAGCAGTAAT	Negative
GTAGGAGAGCCATTGT	Negative
GTAGGAGAGCGTCTGC	Negative
GTAGGAGAGGGTCACA	Hashtag6
GTAGGAGGTGCGTTTA	Negative
GTAGGTTAGAAACCCG	Negative
GTAGGTTCAACGAGGT	Negative
GTAGGTTCAATAAGGT	Hashtag6
GTAGGTTCACGTAGAG	Negative
GTAGGTTCACTGATTG	Hashtag6
GTAGGTTCAGACCCGT	Negative
GTAGGTTTCATTGTTC	Negative
GTAGTACGTGCGCTCA	Negative
GTAGTACGTTGCATTG	Negative
GTATTGGAGATAACGT	Negative
GTATTGGTCGCTCTCA	Negative
GTATTGGTCGGTTCAA	Negative
GTATTTCAGGTTTACC	Negative
GTATTTCCACAAATCC	Negative
GTATTTCCAGTCGGAA	Negative
GTATTTCGTCTCAGAT	Negative
GTCAAACAGTGCCTCG	Hashtag6
GTCAAACAGTGGTGAC	Negative
GTCAAACCAAATCGGG	Hashtag6
GTCAAACCAATATCCG	Negative
GTCAAACGTAACGTTC	Negative
GTCAAACGTGCCGAAA	Negative
GTCAAACGTTAGGGTG	Negative
GTCAAGTCAAGCGGAT	Negative
GTCAAGTCATTGCTTT	Negative
GTCAAGTTCGCAGTTA	Hashtag6_Hashtag8
GTCAAGTTCGCTCCTA	Negative
GTCAAGTTCTGTCGCT	Negative
GTCACGGAGTAATCCC	Negative
GTCACGGAGTTAACGA	Negative
GTCACGGCACTTTATC	Negative
GTCACGGGTCAGGTGA	Negative
GTCACGGGTTTAAGGA	Hashtag6
GTCACTCAGTGCACTT	Negative
GTCACTCGTCGTTTCC	Negative
GTCACTCTCTTCCACG	Negative
GTCAGCGAGAGAATCT	Negative
GTCAGCGGTCGCATTA	Negative
GTCATCCAGCCGATAG	Negative
GTCATCCGTGGGCTCT	Negative
GTCATGAAGACCTCAT	Negative
GTCATGATCACGGGAA	Negative
GTCATGATCGCCATAA	Negative
GTCATGATCTCTTGCG	Hashtag6_Hashtag8
GTCATTTTCAAGGACG	Hashtag6
GTCATTTTCACTTATC	Negative
GTCCACTAGGCATTTC	Hashtag6
GTCCACTCACCTCTAC	Negative
GTCCACTCAGGGCTTC	Negative
GTCCACTGTCACTCTC	Negative
GTCCACTGTGATCGTT	Negative
GTCCACTGTGCAGATG	Negative
GTCCACTTCGGAAACG	Negative
GTCCCATCATGTGGCC	Negative
GTCCCATGTGAGTGAC	Negative
GTCCTCACAAGATCCT	Hashtag6
GTCCTCACAAGTCGTT	Hashtag6
GTCCTCATCCGATCTC	Hashtag6
GTCGAATAGTCAGGGT	Hashtag8
GTCGAATCAAATGAGT	Negative
GTCGAATCAAGTACCT	Hashtag6
GTCGAATCATACACCA	Negative
GTCGAATTCAAGTCGT	Negative
GTCGAATTCATCGTAG	Hashtag6
GTCGCGACAGGATCTT	Hashtag6_Hashtag8
GTCGCGACATAGCACT	Negative
GTCGCGAGTTGTGTAC	Hashtag6_Hashtag8
GTCGCGATCAAGAGTA	Negative
GTCGCGATCCCTCATG	Hashtag6
GTCGTAAAGGTAAAGG	Negative
GTCGTAAAGTCTGGTT	Negative
GTCGTAACAGACCAAG	Negative
GTCGTAAGTAACCCTA	Negative
GTCGTAAGTAGGTCAG	Negative
GTCGTAAGTGCAGGAT	Hashtag6
GTCGTAAGTTAAACAG	Negative
GTCGTAATCTCTCAAT	Negative
GTCGTTCAGGTCGAGT	Negative
GTCGTTCAGTATTAGG	Negative
GTCGTTCAGTATTGCC	Negative
GTCTACCAGAAACACT	Negative
GTCTACCCACTCCTTG	Negative
GTCTACCGTACTCCCT	Negative
GTCTACCGTGAGTTTC	Negative
GTCTAGAAGAAGCCAC	Negative
GTCTAGACAAAGGCAC	Negative
GTCTAGACACCCTATC	Hashtag6
GTCTAGAGTCTCAGGC	Negative
GTCTAGAGTTGTCCCT	Negative
GTCTCACAGCGCTTCG	Negative
GTCTCACAGTACAGAT	Negative
GTCTCACCAAGGTCGA	Negative
GTCTCACCACAAATAG	Negative
GTCTCACTCGCAATTG	Negative
GTCTGTCCAAGTTTGC	Negative
GTCTGTCCACTCCTTG	Negative
GTCTGTCTCTGTGCAA	Hashtag6
GTCTTTAAGACCTCAT	Negative
GTCTTTAAGGTGCAGT	Negative
GTCTTTACAAACGAGC	Negative
GTCTTTACAGGTACGA	Negative
GTCTTTAGTGCGTTTA	Negative
GTCTTTAGTGGTCCGT	Negative
GTCTTTATCCCTGTTG	Negative
GTCTTTATCTACGCGG	Negative
GTGACGCAGCGACCCT	Negative
GTGACGCAGGAGGTTC	Negative
GTGACGCCAACGGTAG	Negative
GTGACGCTCAGCTAGT	Negative
GTGACGCTCTTGCAGA	Negative
GTGAGCCCAAGCCTGC	Negative
GTGAGGAAGTCGGCCT	Negative
GTGAGGACACGTAGAG	Negative
GTGAGGAGTAAGTAGT	Hashtag6
GTGAGGAGTCACTACA	Negative
GTGAGGAGTGGTCTTA	Negative
GTGAGGATCTGATTCT	Hashtag6
GTGAGGATCTTTGATC	Hashtag6
GTGAGTTAGCATGGGT	Negative
GTGAGTTCAACATACC	Negative
GTGAGTTCATCCGTGG	Negative
GTGAGTTCATGGATCT	Hashtag6
GTGAGTTTCTGTAAGC	Negative
GTGATGTCAACCACAT	Negative
GTGATGTCAAGAGTAT	Negative
GTGATGTGTTCGGCCA	Negative
GTGATGTTCTGAGAGG	Hashtag6
GTGCACGAGCATGATA	Negative
GTGCACGCAAGGTACG	Negative
GTGCACGCATCTCATT	Negative
GTGCACGGTATGTCAC	Hashtag6
GTGCAGCAGTCTGTAC	Negative
GTGCAGCCAAGGCCTC	Negative
GTGCAGCGTTCGTGCG	Negative
GTGCAGCTCCACACCT	Negative
GTGCAGCTCCTCGATC	Negative
GTGCGTGCATATGGCT	Negative
GTGCGTGGTAGACGGT	Negative
GTGCGTGGTCACTTAG	Negative
GTGCTGGAGGAACGCT	Hashtag6
GTGCTGGAGTCTAGAA	Hashtag6
GTGCTGGCAACCAGAG	Negative
GTGCTGGGTCTATGAC	Negative
GTGCTTCAGCAATTAG	Negative
GTGCTTCAGCTACTAC	Negative
GTGCTTCAGCTCCCTT	Negative
GTGCTTCCAAATGATG	Negative
GTGCTTCCAACCAATC	Hashtag6
GTGCTTCCAATATCCG	Hashtag6
GTGCTTCCAGTGTGCC	Negative
GTGCTTCGTTGCTCAA	Negative
GTGGAAGAGACAGTCG	Negative
GTGGAAGAGTCTTCGA	Negative
GTGGAAGCACCCGTAG	Negative
GTGGAAGGTAATTAGG	Negative
GTGGAAGTCGTTCAGA	Hashtag6
GTGGAGACAATAGTCC	Hashtag6_Hashtag8
GTGGAGATCGCTTGCT	Negative
GTGGAGATCTACGGGC	Negative
GTGGAGATCTCAGAAC	Negative
GTGGCGTTCGTAGGGA	Negative
GTGGGAAAGGCTCTCG	Hashtag6
GTGGGAACATGTTTGG	Negative
GTGGGAATCACCATAG	Negative
GTGGGAATCGTAACAC	Negative
GTGGTTAAGCCTCTTC	Negative
GTGGTTAAGTCTGGTT	Negative
GTGGTTAGTATCACGT	Negative
GTGTAACAGGAACATT	Hashtag6
GTGTAACAGTGCTCGC	Negative
GTGTAACGTATACAGA	Negative
GTGTAACGTCACTAGT	Hashtag6
GTGTAACTCAACTGAC	Hashtag6
GTGTCCTAGTCTGCAT	Hashtag6
GTGTCCTGTAGTATAG	Negative
GTGTCCTGTGAATTGA	Negative
GTGTCCTTCGCTGATA	Negative
GTGTCCTTCTCCTGTG	Hashtag6
GTGTCCTTCTGGCTGG	Hashtag8
GTGTCCTTCTTTCTAG	Negative
GTGTGATCACTTCAAG	Negative
GTGTGATCATCGCTAA	Negative
GTGTGATTCACCTCAC	Negative
GTGTGATTCGAGAAGC	Negative
GTGTGGCGTGCGTCGT	Negative
GTGTGGCGTTCTTGTT	Hashtag6
GTGTTAGAGACGACGT	Negative
GTGTTAGTCCATCTCG	Negative
GTGTTAGTCCCATAGA	Negative
GTGTTAGTCTAGATCG	Negative
GTGTTCCGTTCGGACC	Negative
GTGTTCCTCGCGGTAC	Hashtag6
GTTACAGAGGGCGAGA	Negative
GTTACAGCATGATAGA	Negative
GTTACCCAGTAGACAT	Negative
GTTACCCCAGTGTATC	Negative
GTTACCCGTCAGCGTC	Hashtag8
GTTACGAAGGTCCGAA	Negative
GTTACGAGTAACTTCG	Hashtag6
GTTACGAGTACCAATC	Negative
GTTACGATCACGATCA	Negative
GTTACGATCGCACGAC	Negative
GTTAGACCAATGTGGG	Hashtag6_Hashtag8
GTTAGACTCATACGAC	Negative
GTTAGTGAGGAGACCT	Negative
GTTATGGAGTATGAAC	Negative
GTTATGGAGTGCAACG	Hashtag6
GTTATGGCAAGCTCTA	Negative
GTTATGGGTAACTGCT	Negative
GTTATGGGTCTTACTT	Hashtag6
GTTATGGTCCAATGCA	Negative
GTTATGGTCGCCAGTG	Negative
GTTATGGTCGCGAAGA	Negative
GTTCATTCAGGATTCT	Negative
GTTCATTTCGAACACT	Negative
GTTCCGTAGTCGTCTA	Negative
GTTCCGTCATGGGTTT	Negative
GTTCCGTTCCACGTAA	Negative
GTTCGCTCAGATTAAG	Negative
GTTCGCTCAGGCATTT	Negative
GTTCGCTCAGGCTACC	Negative
GTTCGCTTCACGAACT	Negative
GTTCGCTTCAGAACCT	Negative
GTTCGCTTCAGACAAA	Negative
GTTCTATGTAGACTGG	Hashtag6_Hashtag8
GTTGAACCACCACTGG	Negative
GTTGAACCATAACGGG	Hashtag6
GTTGAACCATTGACAC	Negative
GTTGAACGTCCAACGC	Negative
GTTGCGGAGTGATAAC	Negative
GTTGCGGCAGCAGATG	Negative
GTTGCGGCATGGAAGC	Negative
GTTGCGGGTTTACTTC	Negative
GTTGCGGTCAAGGCTT	Negative
GTTGCGGTCACCTGGG	Negative
GTTGCGGTCAGGTGTT	Negative
GTTGCGGTCATGGTAC	Negative
GTTGCTCGTAGCGCTC	Negative
GTTGTAGAGACCTCCG	Negative
GTTGTAGGTAACATCC	Negative
GTTGTAGGTGGCGTAA	Negative
GTTGTAGGTGTTGCCG	Negative
GTTGTAGTCAGGCGAA	Negative
GTTGTCCAGCTCGGCT	Negative
GTTGTCCGTAGATCCT	Negative
GTTGTCCGTAGGGTAC	Negative
GTTGTCCTCATGACAC	Negative
GTTGTCCTCGTAGCTA	Negative
GTTGTGAAGAAATTCG	Negative
GTTGTGAAGCACTAGG	Negative
GTTGTGAAGGCAGCTA	Negative
GTTGTGACAGAATCGG	Hashtag6
GTTGTGACATGCCGAC	Negative
GTTGTGAGTCTGCATA	Negative
GTTGTGAGTGTTAACC	Negative
GTTTACTAGAAGCTGC	Negative
GTTTACTAGAAGGCTC	Negative
GTTTACTCAATTCTTC	Negative
GTTTGGAAGATCGACG	Negative
GTTTGGACAAGATGTA	Negative
GTTTGGACACCGCTAG	Negative
GTTTGGACACCTTCGT	Negative
GTTTGGACATCGCTCT	Negative
GTTTGGAGTAATGATG	Negative
GTTTGGATCACCTACC	Negative
TAACACGGTACCTAAC	Negative
TAACACGGTTATGACC	Hashtag8
TAACACGTCGATTTCT	Hashtag8
TAACCAGCAGGTTCAT	Negative
TAACCAGCATGCGGTC	Negative
TAACCAGGTCTAACGT	Negative
TAACCAGTCCTGGTCT	Negative
TAACCAGTCTGAGAGG	Negative
TAACGACAGGTCGAGT	Negative
TAACGACCACCAGCTG	Negative
TAACGACGTCTGTGAT	Hashtag6
TAACGACGTGTGATGG	Hashtag6
TAACTTCCATTGCCGG	Negative
TAACTTCGTACGGATG	Negative
TAACTTCTCGGACCAC	Negative
TAAGCACCAATGCAGG	Negative
TAAGCACCACTTGAGT	Hashtag6
TAAGCACGTTCAAGGG	Negative
TAAGCACGTTTCGTAG	Hashtag6_Hashtag8
TAAGCACTCAACTGGT	Negative
TAAGCACTCTAAGCCA	Negative
TAAGCCAGTCGACTGC	Hashtag8
TAAGCCATCATCGCAA	Negative
TAAGCCATCATTCTTG	Negative
TAAGCCATCCAGCACG	Negative
TAAGCGTCAGACGCTC	Negative
TAAGCGTGTACCGTCG	Negative
TAAGCGTTCATTTCGT	Hashtag8
TAAGCGTTCTTGCGCT	Hashtag8
TAAGTCGAGTAGCCAG	Negative
TAAGTCGCAGCTCATA	Negative
TAAGTCGCATTGTACG	Hashtag8
TAAGTCGGTACCTAAC	Hashtag6
TAAGTCGGTGGATTTC	Hashtag6
TAAGTCGTCCACAGCG	Negative
TAATCTCCAATTGTGC	Negative
TAATTCCGTTCTTGCC	Negative
TAATTCCTCAGCGGAA	Negative
TAATTCCTCATGCAGT	Negative
TACAACGCAATTCTCT	Hashtag6
TACAACGCATCCCGTT	Negative
TACAACGCATTGCTGA	Negative
TACAACGGTTCCTACC	Negative
TACAACGTCGAAGAAT	Hashtag6
TACAACGTCGCCAGTG	Negative
TACACCCAGGCTATCT	Hashtag6
TACACCCCATGCCGGT	Negative
TACACCCGTGATTCAC	Negative
TACACCCGTTCGGCGT	Negative
TACACCCTCTTCCCAG	Negative
TACAGGTAGCTAATGA	Hashtag6_Hashtag8
TACAGGTAGTCCTACA	Hashtag8
TACAGGTCAACTGTGT	Negative
TACAGGTCACGGTGCT	Negative
TACAGGTCACGTATAC	Negative
TACAGGTCATGTTACG	Hashtag6
TACAGGTGTGCGACAA	Hashtag6
TACAGGTTCCGGTAGC	Negative
TACAGGTTCTAGTGAC	Negative
TACATTCAGCCATGCC	Negative
TACATTCAGTTGGCGA	Negative
TACATTCGTCCCGTGA	Negative
TACATTCGTTTGTGGT	Hashtag6_Hashtag8
TACCCACCAACTCGTA	Hashtag6
TACCCACCAGACCATT	Negative
TACCCACTCACAATGC	Negative
TACCCACTCGTTTACT	Hashtag6
TACCCGTAGAACTTCC	Negative
TACCCGTGTGCAGATG	Negative
TACCGAACAAAGAACT	Hashtag6
TACCGAACAAGAATGT	Negative
TACCGAAGTGCCCACA	Negative
TACCGAAGTTTAGAGA	Negative
TACCGAATCGAGATGG	Hashtag6
TACCGGGAGTATCCTG	Negative
TACCGGGCACTAGGTT	Hashtag6
TACCGGGCAGGGATAC	Hashtag6
TACCGGGTCATTCTTG	Negative
TACCTCGAGTGCAGCA	Hashtag6_Hashtag8
TACCTCGCAGGCTCTG	Negative
TACCTCGGTTCGCGTG	Negative
TACCTCGGTTTAGAGA	Negative
TACCTCGTCGCGCCAA	Negative
TACCTCGTCGGTAACT	Hashtag8
TACCTGCGTAATCAAG	Hashtag6
TACCTGCGTAGTGCGA	Hashtag6_Hashtag8
TACCTGCGTATCCTCC	Negative
TACGCTCAGTTCTCTT	Hashtag6
TACGCTCCACTGAGGA	Negative
TACGCTCCATCTTAGG	Hashtag6
TACGCTCGTGACTAAA	Negative
TACGCTCGTGCAAGAC	Negative
TACGCTCGTTCCCAAA	Negative
TACGGGCCACCAGCGT	Negative
TACGGGCGTTAGAGTA	Negative
TACGGGCTCCTGCTAC	Negative
TACGGGCTCTATTTCG	Negative
TACGGTACAGCTGAAG	Negative
TACGGTACAGTCCGTG	Negative
TACGGTAGTCCAGTTA	Negative
TACGGTATCTGTGCAA	Negative
TACGTCCAGCCTGTCG	Hashtag6
TACGTCCGTCGTACTA	Hashtag8
TACGTCCGTGTTGATC	Negative
TACGTCCTCGTAACAC	Negative
TACTGCCAGAGCCGTA	Negative
TACTGCCAGCAGGGAG	Negative
TACTGCCCAGACAAGC	Hashtag6
TACTGCCGTCGTTGGC	Hashtag8
TACTGCCTCAACTGAC	Negative
TACTGCCTCAGCGCAC	Hashtag6
TACTGCCTCTTACGGA	Hashtag6
TACTTACAGCTCGACC	Negative
TACTTACCAGACATCT	Negative
TACTTACCAGCTCCTT	Negative
TACTTACGTCGCCACA	Negative
TACTTCAAGCCACAAG	Negative
TACTTCACAAAGGCTG	Negative
TACTTCACAGGCGATA	Hashtag6
TACTTCACATGGAAGC	Negative
TACTTCAGTCTGTGTA	Hashtag6
TACTTCATCTAACACG	Negative
TACTTCATCTCAGTCC	Negative
TACTTCATCTTGGCTC	Hashtag6
TACTTGTTCCGATAAC	Negative
TAGACCAAGAGTAACT	Negative
TAGACCAAGATTGAGT	Negative
TAGACCAAGCGAAACC	Hashtag6
TAGACCACACCTCGTT	Negative
TAGACCACAGTCTGGC	Negative
TAGACCAGTCTAGGTT	Negative
TAGACCAGTGAATTGA	Negative
TAGACCAGTGCATGAG	Negative
TAGACCAGTGTTACTG	Negative
TAGACTGAGATTGATG	Negative
TAGACTGAGGCTAAAT	Negative
TAGACTGAGTGGACGT	Hashtag6_Hashtag8
TAGACTGCAGAAACCG	Negative
TAGACTGGTAATGCGG	Negative
TAGACTGGTCGCTGCA	Negative
TAGACTGTCCATTCGC	Hashtag8
TAGAGTCAGACTCCGC	Negative
TAGAGTCAGCAACTCT	Negative
TAGAGTCCATTGCCGG	Hashtag6
TAGAGTCGTTCGGTCG	Hashtag6
TAGATCGAGAGCAACC	Hashtag6
TAGATCGGTCATATGC	Negative
TAGATCGTCCGCGAGT	Negative
TAGCACACAGGAACCA	Hashtag6
TAGCACACATGCCGAC	Negative
TAGCACAGTACTGCGC	Negative
TAGCACAGTCATCTAG	Hashtag6
TAGGAGGAGACAGCTG	Hashtag6_Hashtag8
TAGGAGGAGCGTGCTC	Negative
TAGGAGGCAACACGAG	Negative
TAGGAGGCACCTTCCA	Negative
TAGGAGGCACGTTCGG	Negative
TAGGAGGCAGCGTGAA	Hashtag6_Hashtag8
TAGGGTTAGTACTGGG	Negative
TAGGGTTGTAGAAACT	Hashtag8
TAGGGTTGTATCACCA	Hashtag6
TAGGGTTTCAGCCTTC	Negative
TAGGGTTTCGAGAACG	Hashtag6
TAGGGTTTCGTTCTGC	Negative
TAGGTACGTACAACGG	Negative
TAGGTACTCATCTACT	Negative
TAGGTACTCCCTCTTT	Negative
TAGGTACTCTCCCATG	Negative
TAGGTACTCTTAGCTT	Negative
TAGGTTGAGACATACA	Negative
TAGGTTGAGCCGATTT	Hashtag8
TAGGTTGCAGGACATG	Hashtag6_Hashtag8
TAGGTTGGTAGCGAGT	Negative
TAGGTTGGTCTGTCAA	Hashtag6
TAGGTTGGTTATTCCT	Hashtag6
TAGGTTGTCAGTGCGC	Hashtag6
TAGGTTGTCTGAATCG	Negative
TAGTGCAAGAAACACT	Negative
TAGTGCAAGCCATGCC	Negative
TAGTGCACAGACCTGC	Hashtag8
TAGTGCAGTCAAGCGA	Hashtag6_Hashtag8
TAGTGCAGTTGACTAC	Hashtag6
TAGTGCATCTAACGCA	Hashtag6
TATACCTAGGGACACT	Negative
TATACCTCAAGAGATT	Hashtag6_Hashtag8
TATACCTTCCAAACCA	Negative
TATACCTTCTGCCTCA	Negative
TATATCCAGGTCGTCC	Negative
TATATCCCACAGCTGC	Negative
TATATCCCAGTAACGG	Hashtag6
TATATCCTCGGAGCAA	Negative
TATCAGGGTCCTTAAG	Negative
TATCAGGTCGATTCCC	Hashtag6
TATCCTAGTGACTGTT	Negative
TATCCTATCAGACCCG	Negative
TATCCTATCTATTCGT	Negative
TATCGCCAGGCTGTAG	Hashtag6
TATCGCCAGGTTACAA	Negative
TATCGCCAGTTCACTG	Negative
TATCGCCCAGAAGTGC	Hashtag6
TATCGCCGTCTTCCGT	Negative
TATCGCCGTGCAAGAC	Negative
TATCTGTAGTAACCTC	Negative
TATCTGTAGTTCCATG	Hashtag6_Hashtag8
TATCTGTGTCACTACA	Negative
TATCTGTGTCGTTATG	Hashtag6
TATCTGTGTGGTCTTA	Hashtag8
TATCTTGCAAGTTTGC	Negative
TATCTTGCAATAAGGT	Hashtag6
TATCTTGGTAGAGTTA	Negative
TATCTTGGTCAACCTA	Negative
TATCTTGGTCGTCATA	Negative
TATCTTGTCATTCGTT	Hashtag6
TATCTTGTCGCTACGG	Negative
TATCTTGTCTAGCCTC	Negative
TATCTTGTCTCGGGAC	Negative
TATGTTCCATTGGATC	Negative
TATGTTCGTAGTAAGT	Hashtag6_Hashtag8
TATGTTCGTTATGACC	Negative
TATTCCAAGAGCCCAA	Hashtag6
TATTCCACACTCTCGT	Hashtag6
TATTCCACATACCAGT	Negative
TATTCCACATGCTGCG	Negative
TATTCCACATGGATCT	Hashtag6
TATTCCAGTAAGTAGT	Negative
TATTCCAGTGTCATGT	Negative
TATTCCATCTGGGCGT	Hashtag6
TATTCCATCTGGTGCG	Negative
TATTGCTCAAATACGA	Negative
TATTGCTGTAAGGCCA	Hashtag6
TATTGCTGTATCCCTC	Negative
TATTGGGAGCAAATCA	Negative
TATTGGGCACAAATGA	Negative
TATTGGGCAGGTCAGA	Negative
TATTGGGGTCAGGTGA	Negative
TATTTCGCAGCCGTTG	Negative
TATTTCGGTCTAATCG	Negative
TCAAGACAGTCTACCA	Negative
TCAAGACCAACGAGGT	Hashtag6
TCAAGACCACAGTACT	Negative
TCAAGACCACGACGCT	Negative
TCAAGACGTTCGTGCG	Hashtag6_Hashtag8
TCAAGACGTTTCGGCG	Negative
TCAAGACTCGAGCACC	Hashtag6
TCAAGACTCTACTCAT	Negative
TCAAGCAAGCTCGGCT	Negative
TCAAGCATCGGACGTC	Negative
TCAAGTGAGAGATCGC	Negative
TCAAGTGAGATACGAT	Negative
TCAAGTGCACACGTGC	Hashtag6
TCAAGTGGTAACGCGA	Negative
TCAAGTGGTGTATTCG	Negative
TCAAGTGGTTTGAACC	Hashtag6
TCAATCTCACAAGCAG	Negative
TCAATCTCACACCTGG	Hashtag6
TCAATCTGTCTCGGAC	Hashtag6_Hashtag8
TCAATCTGTGCATGTT	Hashtag6
TCAATCTTCCTAGAGT	Negative
TCAATTCAGAGAGTGA	Negative
TCAATTCAGGAGAATG	Hashtag6
TCAATTCCACAGTCAT	Hashtag6
TCAATTCGTATTTCCT	Negative
TCACAAGAGAGGGCGA	Negative
TCACAAGCAACACAAA	Negative
TCACAAGCAATCAAGA	Hashtag6_Hashtag8
TCACAAGCAGGAGGTT	Hashtag6
TCACAAGTCTCCGAGG	Hashtag6
TCACACCAGCATACTC	Negative
TCACACCAGGGAGGGT	Negative
TCACACCAGTCTAGAA	Hashtag6
TCACACCCACAAGCAG	Negative
TCACATTCAGTGTATC	Hashtag6
TCACATTTCCCAACTC	Hashtag6
TCACATTTCGATTGAC	Hashtag6_Hashtag8
TCACGCTAGCTTCATG	Hashtag6
TCACGCTGTAGGGAGG	Hashtag6
TCACGCTTCAAGCCCG	Negative
TCACGGGAGGCAGGTT	Negative
TCACGGGGTCAACCAT	Negative
TCACTATCAAAGTGTA	Negative
TCACTATCAGAGGACT	Hashtag6
TCACTATCATCCTATT	Hashtag6
TCACTCGCAAAGACGC	Hashtag8
TCACTCGGTTAAAGTG	Negative
TCACTCGTCGCAATGT	Hashtag6_Hashtag8
TCAGCAACACGGCTAC	Negative
TCAGCAACATAATCCG	Hashtag6
TCAGCAACATAGAAAC	Hashtag6
TCAGCCTAGCAATTAG	Hashtag6
TCAGCCTAGTTGGCTT	Negative
TCAGCCTGTATCCCAA	Negative
TCAGCCTTCGAACTCA	Negative
TCAGCCTTCTCTGCCA	Negative
TCAGGGCCACGGTAGA	Hashtag6
TCAGGGCCAGTAGAGC	Negative
TCAGGTAAGCGTCGAA	Negative
TCAGGTAAGTTCCGTA	Negative
TCAGGTACACGGGTAA	Negative
TCAGGTAGTGATTAGA	Hashtag6
TCAGGTATCGCTGATA	Hashtag6
TCAGTCCAGACCTCCG	Hashtag6
TCAGTCCAGATCGCCC	Negative
TCAGTCCCAAAGCACG	Hashtag6
TCAGTCCTCATTACTC	Hashtag6
TCAGTGATCAAACCTG	Negative
TCAGTTTAGGCGCTTC	Negative
TCAGTTTAGTGAGGCT	Negative
TCAGTTTGTGGTAACG	Negative
TCATACTAGACCAAGC	Negative
TCATACTAGCGAGGAG	Negative
TCATACTGTCGCATCG	Hashtag6
TCATACTGTGAGCCAA	Hashtag6_Hashtag8
TCATACTTCCAGCTCT	Negative
TCATACTTCGGAATGG	Hashtag6_Hashtag8
TCATACTTCTCGCTTG	Negative
TCATATCAGCGGTAGT	Hashtag6
TCATATCCACTCTGCT	Hashtag6
TCATCATAGTGATAAC	Negative
TCATCATCACCGTCTT	Hashtag6
TCATCATGTGTGATGG	Hashtag6
TCATCATGTTATGTCG	Negative
TCATCATTCCTATTGT	Hashtag6
TCATCATTCGGAGTGA	Hashtag6
TCATCCGAGAATACAC	Negative
TCATCCGGTATCTCTT	Negative
TCATCCGGTCGATGCC	Negative
TCATCCGGTTCACCGG	Negative
TCATCCGTCCCACAGG	Negative
TCATGAGAGGATGAGA	Negative
TCATGAGCACACACTA	Hashtag6
TCATGCCCAGGCATGA	Hashtag8
TCATGCCGTGACTAAA	Hashtag6_Hashtag8
TCATGCCTCATCACTT	Negative
TCATGGAAGATGGGCT	Negative
TCATGGACAAATGCGG	Hashtag6_Hashtag8
TCATGGACAAGTGGAC	Hashtag6
TCATGGAGTATCGTAC	Hashtag6
TCATGGAGTGAATAAC	Negative
TCATGGATCCATCGTC	Negative
TCATGTTAGCATGTTC	Negative
TCATGTTAGGGATCAC	Negative
TCATGTTGTAGGGAGG	Negative
TCATGTTGTCATCAGT	Negative
TCATGTTGTGTCTTAG	Negative
TCATTACCAGAATCGG	Hashtag6_Hashtag8
TCATTACGTACCCGCA	Negative
TCATTACGTGATATAG	Negative
TCATTCAAGAATTGCA	Negative
TCATTCAAGCAACTTC	Hashtag6
TCATTCAAGCCGAATG	Hashtag6
TCATTCAAGCGTTAGG	Hashtag6
TCATTCACATAAGATG	Hashtag6
TCATTCAGTAATACCC	Negative
TCATTCAGTCACTCTC	Negative
TCATTCATCCTAGCGG	Negative
TCATTCATCTACACTT	Hashtag6
TCATTGTCATCAGTCA	Negative
TCATTGTCATGTTACG	Hashtag6
TCATTGTGTAGGCTCC	Negative
TCATTGTTCCATAGAC	Negative
TCATTTGAGACGCCAA	Negative
TCATTTGAGATACATG	Hashtag8
TCATTTGAGCCTGACC	Negative
TCATTTGAGGTGGGTT	Hashtag6
TCATTTGCAGTTCACA	Negative
TCATTTGGTTGCTGAT	Hashtag6
TCATTTGTCAGATGCT	Negative
TCATTTGTCGACACTA	Negative
TCCACCAAGACGCCCT	Negative
TCCACCAGTTGCTCCT	Hashtag6
TCCACGTGTTAAACAG	Negative
TCCACGTTCTCTTCAA	Negative
TCCAGAAAGATTGTGA	Hashtag6
TCCAGAAAGCCATTCA	Negative
TCCAGAAGTTAGGAGC	Hashtag6
TCCAGAAGTTGTGCCG	Hashtag6
TCCAGAATCGTTACCC	Negative
TCCAGAATCTCGTCAC	Negative
TCCAGAATCTTGTGCC	Negative
TCCATCGCACATAACC	Hashtag6
TCCATCGTCACACCCT	Negative
TCCATCGTCTCGCGTT	Negative
TCCATGCGTACAGTCT	Hashtag8
TCCATGCTCATTGCTT	Negative
TCCATGCTCGAGTGGA	Negative
TCCCACACAGTTGCGC	Hashtag6
TCCCACAGTAGCCCTG	Hashtag6
TCCCAGTAGCATGTTC	Negative
TCCCAGTCACAAATCC	Negative
TCCCAGTTCCATCTCG	Hashtag6_Hashtag8
TCCCAGTTCCTTATCA	Negative
TCCCAGTTCTCTGCCA	Negative
TCCCATGAGTAAATGC	Hashtag8
TCCCATGCAGTCTTCC	Negative
TCCCATGGTGCAAGAC	Negative
TCCCATGGTTGTATGC	Negative
TCCCATGTCGACACTA	Negative
TCCGAAACAACCTATG	Hashtag6
TCCGAAAGTACAGGTG	Negative
TCCGAAAGTGGTCTAT	Negative
TCCGAAAGTGTCTTCC	Negative
TCCGAAATCAAATAGG	Negative
TCCGAAATCTGCGGCA	Negative
TCCGATCAGACATCCT	Hashtag6
TCCGATCAGTGAGCCA	Negative
TCCGATCTCCGAACGC	Hashtag6_Hashtag8
TCCGGGAAGCGAAACC	Hashtag6_Hashtag8
TCCGGGAAGTGACCTT	Negative
TCCGGGAAGTGCTCGC	Negative
TCCGGGAGTAGTCGGA	Negative
TCCGGGATCAAACCTG	Hashtag6
TCCGGGATCACTGGGC	Hashtag6
TCCGTGTGTCACTTAG	Negative
TCCGTGTGTTGCTCCT	Hashtag6
TCCGTGTTCACCTGGG	Negative
TCCGTGTTCTGAGTCA	Negative
TCCTAATCATGACGGA	Negative
TCCTAATGTTGGGAAC	Negative
TCCTAATTCCGGCAGT	Negative
TCCTAATTCGGACAAG	Hashtag8
TCCTCCCAGAGAATCT	Negative
TCCTCCCAGATGACCG	Negative
TCCTCCCAGGAAGAAC	Hashtag6_Hashtag8
TCCTCCCAGTCACAGG	Negative
TCCTCCCGTGAATATG	Negative
TCCTCCCTCCCTTTGG	Negative
TCCTCGAAGATCGGTG	Negative
TCCTCGAAGCTTACGT	Hashtag6_Hashtag8
TCCTCGAAGGCTGGAT	Hashtag6
TCCTCGATCGCCACTT	Hashtag6
TCCTCGATCTCGCAGG	Negative
TCCTCGATCTGGGCAC	Hashtag6
TCCTCTTAGGAAGTCC	Negative
TCCTCTTAGTCATCGT	Negative
TCCTCTTCAAGTGACG	Negative
TCCTCTTCACCCTTAC	Negative
TCCTCTTCACTGGCGT	Negative
TCCTCTTCATCCTATT	Negative
TCCTGCAAGATCGACG	Negative
TCCTGCAAGTGATTCC	Hashtag6_Hashtag8
TCCTGCAGTCTACGTA	Hashtag8
TCCTGCAGTTAAGTCC	Negative
TCCTGCATCAGCTAGT	Negative
TCCTGCATCTCCTACG	Negative
TCCTTCTAGGCCTTCG	Hashtag6
TCCTTCTCATGATAGA	Negative
TCCTTCTCATTGTACG	Negative
TCCTTCTGTCAAAGTA	Negative
TCCTTCTGTCACTTAG	Negative
TCCTTCTGTGCGGCTT	Negative
TCCTTTCAGCCACAAG	Negative
TCCTTTCAGTCGAAGC	Negative
TCCTTTCCATGAAGCG	Negative
TCGAACAAGGAGCTGT	Hashtag6
TCGAACAAGGTCCGAA	Hashtag6_Hashtag8
TCGAACACAATCGAAA	Negative
TCGAACACAGAAATTG	Hashtag6
TCGAACACATCGAAGG	Hashtag6
TCGAACACATTGGCAT	Negative
TCGAACAGTGAGCAGT	Hashtag6_Hashtag8
TCGAACATCGATTGGT	Negative
TCGAACATCGCAAGAG	Negative
TCGAAGTAGATAGGGA	Negative
TCGAAGTAGCAGATAT	Hashtag8
TCGAAGTAGCGCCGTT	Negative
TCGAAGTCAACACAGG	Hashtag6
TCGAAGTCAACTGAAA	Negative
TCGAAGTGTACAACGG	Negative
TCGACCTAGGACAGTC	Negative
TCGACCTAGGTGGGTT	Hashtag6
TCGACCTCAAGCACCC	Negative
TCGACCTCATCCAATG	Negative
TCGACCTGTGTCTTGA	Hashtag6
TCGACCTTCGACGTCG	Hashtag6
TCGACCTTCGCCAGAC	Negative
TCGACGGGTAACATGA	Negative
TCGATTTCATTCCTCG	Negative
TCGATTTGTCTAGGCC	Negative
TCGATTTTCCACGGGT	Hashtag6
TCGATTTTCCGTAGTA	Negative
TCGATTTTCTTAAGGC	Negative
TCGCACTAGAATTGTG	Negative
TCGCACTAGTCACTAC	Negative
TCGCACTAGTGCTACT	Hashtag6
TCGCACTCACTGTCCT	Negative
TCGCACTGTTAAGACA	Negative
TCGCACTGTTAAGTCC	Negative
TCGCACTTCGTAGCCG	Negative
TCGCAGGGTTGATCGT	Negative
TCGCAGGTCAATCCGA	Negative
TCGCAGGTCACTTGTT	Negative
TCGCTCAAGAGAATCT	Negative
TCGCTCAAGCCGCTTG	Negative
TCGCTCAAGCGACTAG	Hashtag8
TCGCTCAGTACAAAGT	Hashtag6
TCGCTCAGTTGGGCCT	Hashtag6
TCGCTCATCAGCTGTA	Negative
TCGCTTGAGTAAGAGG	Hashtag8
TCGCTTGAGTGGTTAA	Hashtag6
TCGCTTGCACCCTTGT	Negative
TCGCTTGCAGTCTACA	Negative
TCGCTTGTCCCTTTGG	Negative
TCGGATAGTTGCAAGG	Negative
TCGGATATCCTAAACG	Hashtag6_Hashtag8
TCGGATATCTGGCCTT	Negative
TCGGGACAGTCGAAAT	Negative
TCGGGACAGTTCGGTT	Hashtag6
TCGGGACCACAGAAGC	Negative
TCGGGACTCTGCATAG	Hashtag6
TCGGGCAAGATCCCAT	Hashtag6
TCGGGCAAGGACAACC	Negative
TCGGGCACATCGATGT	Negative
TCGGGCAGTATAGCTC	Negative
TCGGGCAGTCTGATCA	Hashtag6
TCGGGCATCTACTGAG	Hashtag6
TCGGGTGAGACTTCCA	Negative
TCGGGTGAGATTGTGA	Hashtag6
TCGGGTGAGTGATAAC	Negative
TCGGGTGGTGGCAGAT	Negative
TCGGGTGTCATCGACA	Negative
TCGGGTGTCATGAAAG	Negative
TCGGGTGTCTGATGGT	Negative
TCGGTCTCAACCCTAA	Hashtag6
TCGTAGAAGCCAAGGT	Hashtag6
TCGTAGAAGGCAGGTT	Negative
TCGTAGAGTGTTGATC	Negative
TCGTAGATCCCGAACG	Negative
TCGTAGATCCTTCTTC	Hashtag6
TCGTCCAAGTCTGCAT	Negative
TCGTCCAGTGCAGGAT	Negative
TCGTGCTAGACTCTAC	Negative
TCGTGCTAGTGCAGCA	Negative
TCGTGCTCACCGTGAC	Negative
TCGTGCTGTCTGATAC	Negative
TCGTGCTTCAAGATAG	Negative
TCGTGCTTCACTAGCA	Hashtag6
TCGTGGGAGGTTAGTA	Negative
TCGTGGGAGTACAGAT	Negative
TCTAACTCAAGTCGTT	Negative
TCTAACTGTCGTATTG	Hashtag6_Hashtag8
TCTACATAGGCCTGAA	Hashtag8
TCTACATAGGTTCTAC	Hashtag6
TCTACATCAAATCGTC	Negative
TCTACATCAATACGAA	Hashtag6
TCTACATCATGTGCCG	Negative
TCTACATGTCGTGTTA	Negative
TCTACATGTGACCTGC	Hashtag6
TCTACATGTTATTCTC	Negative
TCTACATGTTGCCATA	Negative
TCTACATTCCAAACCA	Hashtag6
TCTACATTCCTAAACG	Negative
TCTACATTCGATGCAT	Negative
TCTACCGCAGTTGGTT	Negative
TCTACCGGTATTGCCA	Negative
TCTACCGTCGACGTCG	Hashtag6_Hashtag8
TCTATACGTACTGCCG	Hashtag6
TCTATACTCCTTATGT	Hashtag6
TCTATCAGTACGTGTT	Negative
TCTATCAGTCTGTGTA	Negative
TCTATCAGTGATAGAT	Hashtag6
TCTATCAGTGGCTGAA	Hashtag6
TCTATCAGTTACAGCT	Hashtag8
TCTATCATCAGCGCGT	Negative
TCTATCATCCCTAGGG	Hashtag6
TCTCACGCAAACCGGA	Negative
TCTCACGCAAGATTGA	Hashtag6_Hashtag8
TCTCACGCACCTGAAT	Negative
TCTCACGCAGTACTAC	Hashtag6
TCTCACGTCCTATTGT	Hashtag6
TCTCACGTCTGGGCAC	Hashtag6
TCTCAGCAGCCTGCCA	Negative
TCTCAGCAGTCCCAGC	Negative
TCTCAGCCAAGGTTGG	Negative
TCTCAGCGTACGCTTA	Negative
TCTCAGCGTATCCCAA	Hashtag6
TCTCAGCGTGACGCCT	Negative
TCTCCGACACCGAATT	Negative
TCTCCGACATTGGATC	Negative
TCTCCGAGTATTGGCT	Negative
TCTCCGAGTTTCGTAG	Negative
TCTCCGATCGAACCTA	Negative
TCTCCGATCTCATAGG	Negative
TCTCCGATCTCTAAGG	Hashtag6
TCTCTGGAGGATAATC	Negative
TCTCTGGGTCGCATTA	Hashtag6
TCTCTGGTCCCAGGAC	Negative
TCTCTGGTCCTCACCA	Hashtag6
TCTCTGGTCTCTCTTC	Hashtag6
TCTGCCAAGTACAACA	Negative
TCTGCCAAGTCTACCA	Negative
TCTGCCAGTTGCTCAA	Negative
TCTGCCATCCAACACA	Negative
TCTGCCATCGCTTAAG	Negative
TCTGCCATCTCTATGT	Negative
TCTGGCTCAATTCTTC	Hashtag6
TCTGGCTCAGAAGCTG	Negative
TCTGGCTTCATTGTTC	Hashtag6
TCTGTCGAGAATAGTC	Negative
TCTGTCGAGTTCTACG	Negative
TCTGTCGCAGGTAGTG	Hashtag8
TCTGTCGCATGGCACC	Hashtag6
TCTGTCGCATGTGGTT	Negative
TCTGTCGGTGTTTGCA	Negative
TCTGTCGTCAGCCTTC	Hashtag8
TCTGTCGTCCGCGATG	Hashtag6
TCTGTCGTCGCCGAGT	Hashtag6
TCTTAGTCAACTTCTT	Negative
TCTTAGTGTCAGCTTA	Negative
TCTTAGTGTCGAAACG	Hashtag6
TCTTAGTTCCGACAGC	Negative
TCTTAGTTCGATTGGT	Negative
TCTTCCTAGCATGCAG	Hashtag8
TCTTCCTCATAACTCG	Hashtag6
TCTTCCTCATGTGGCC	Negative
TCTTCCTGTTCTCCAC	Negative
TCTTCCTTCAACACCA	Hashtag6
TCTTCCTTCTGGTCAA	Negative
TCTTGCGAGCATTGAA	Negative
TCTTGCGAGTTACTCG	Negative
TCTTGCGCATGTGCTA	Hashtag6
TCTTGCGCATTCTCTA	Hashtag6
TCTTGCGGTACGTGTT	Hashtag6
TCTTGCGGTGTAGGAC	Negative
TCTTGCGGTTCAGCTA	Negative
TCTTGCGTCTGGCCAG	Negative
TCTTGCGTCTTAGCCC	Negative
TCTTTGACAAATGCTC	Negative
TGAACGTAGATGAATC	Hashtag6
TGAACGTAGCACTAAA	Negative
TGAACGTAGGGCAGGA	Hashtag6
TGAACGTCATCGTCCT	Hashtag6
TGAACGTGTAATGCTC	Negative
TGAACGTGTAGGCTCC	Negative
TGAACGTGTGCATGAG	Hashtag6
TGAACGTTCTGGAGAG	Hashtag6
TGAATCGAGCACCTGC	Hashtag6_Hashtag8
TGAATCGAGTATTAGG	Negative
TGAATCGCAAAGCAAT	Hashtag6
TGAATCGGTAGTCCTA	Negative
TGAATCGTCTTGAACG	Negative
TGAATGCCAATAAGGT	Negative
TGAATGCCATCCGGTG	Negative
TGAATGCGTGGATCGA	Hashtag8
TGACAGTAGTTTGGCT	Hashtag6_Hashtag8
TGACAGTTCGACGCTG	Negative
TGACCCTCAGTCTCTC	Negative
TGACCCTCATGAATCC	Negative
TGACCCTGTACGACAG	Negative
TGACCCTGTAGTCTGT	Hashtag6
TGACCCTGTCGCATCG	Negative
TGACCCTTCGCAGAGA	Negative
TGACCCTTCGCAGTCG	Hashtag6
TGACGCGAGAGCAGTC	Negative
TGACGCGAGATTGACA	Negative
TGACGCGCAGGACAGT	Hashtag6
TGACGCGGTTCTAACG	Hashtag6
TGACTCCAGTAAACAC	Negative
TGACTCCAGTCCCAGC	Negative
TGACTCCTCCGTGGTG	Negative
TGACTCCTCGATCCAA	Hashtag6_Hashtag8
TGACTCCTCGCTGACG	Negative
TGAGACTCAGAAGCTG	Negative
TGAGACTCAGATTAAG	Hashtag6
TGAGACTCAGTCTCTC	Negative
TGAGACTCATAATGCC	Negative
TGAGACTCATATAGCC	Hashtag6
TGAGACTTCATGAGTC	Hashtag6
TGAGCATAGTTACGAA	Hashtag6_Hashtag8
TGAGCATGTAGCTCGC	Hashtag6
TGAGCATGTAGTTAGA	Negative
TGAGCATGTCTTCCGT	Negative
TGAGCATTCCGATAAC	Negative
TGAGCATTCGACGCTG	Negative
TGAGCGCAGCGCCGTT	Negative
TGAGCGCCAGCGTAGA	Hashtag6
TGAGCGCTCACGAACT	Negative
TGAGCGCTCTACCCAC	Hashtag6
TGAGCGCTCTCGGTAA	Hashtag6
TGAGGAGAGGAGACCT	Negative
TGAGGAGAGGCAGTCA	Negative
TGAGGAGGTAGGCAAC	Hashtag8
TGAGGAGTCGAGCCAC	Negative
TGAGGGACAAAGGATT	Negative
TGAGGGACAAGACAAT	Negative
TGAGGTTAGCGATCGA	Negative
TGAGGTTGTCCGAAAG	Negative
TGAGGTTTCCGGCAAC	Negative
TGAGTCAAGTAAAGCT	Hashtag6
TGAGTCAGTTTGTTCT	Hashtag6_Hashtag8
TGATCAGAGTACTGGG	Negative
TGATCTTAGGATTTCC	Negative
TGATCTTAGGGCAGTT	Negative
TGATCTTCAAACCGGA	Negative
TGATCTTCACCAATTG	Hashtag6_Hashtag8
TGATCTTGTCCACACG	Negative
TGATCTTGTTCGAACT	Negative
TGATCTTTCGTAACTG	Hashtag6
TGATGCAAGGTCGTCC	Negative
TGATGCACAGCATGCC	Hashtag6
TGATGCAGTCACATTG	Negative
TGATGCATCCGACGGT	Negative
TGATGGTCACGTATAC	Negative
TGATGGTGTGCAGGAT	Negative
TGATGGTGTGTGGACA	Hashtag6
TGATTCTAGCGTTACT	Hashtag6
TGATTCTCACAGTGTT	Negative
TGATTCTCACTCTCGT	Negative
TGATTCTGTAGGCTGA	Negative
TGATTTCAGGCGAACT	Negative
TGATTTCGTTACCTGA	Negative
TGATTTCTCGCGAAGA	Hashtag6
TGCACGGAGAGTGTTA	Negative
TGCACGGGTTGACGGA	Hashtag6
TGCACGGTCAGATGCT	Negative
TGCACGGTCTAGTGTG	Hashtag6
TGCAGATAGGTACTGG	Hashtag8
TGCAGATAGTGCCCGT	Hashtag6
TGCAGATGTAGGTGCA	Negative
TGCAGATTCCTTGAAG	Hashtag6
TGCAGATTCGGTCGAC	Negative
TGCAGATTCTTGGATG	Negative
TGCAGGCAGCTTACGT	Hashtag8
TGCAGGCAGGTCACCC	Hashtag6
TGCAGGCCAAATGCTC	Hashtag6
TGCAGGCCAGCTCTGG	Negative
TGCAGGCGTTAATGAG	Negative
TGCAGGCGTTGACTGT	Negative
TGCAGGCTCTTGGAAC	Negative
TGCAGTACAAAGCACG	Negative
TGCAGTACATATCTCT	Negative
TGCAGTAGTCCATAGT	Negative
TGCAGTAGTGCAAGAC	Hashtag6_Hashtag8
TGCAGTATCTGAGGCC	Negative
TGCATCCAGACAGTCG	Negative
TGCATCCAGGGAGGTG	Negative
TGCATCCCACGCCACA	Negative
TGCATCCGTAACAGGC	Negative
TGCATCCTCGACGTCG	Negative
TGCATGACAATGAACA	Negative
TGCATGAGTATCCTCC	Hashtag6
TGCATGAGTTGGATCT	Hashtag8
TGCATGATCCAGTGCG	Hashtag6_Hashtag8
TGCATGATCCCTTGGT	Negative
TGCCGAGCAGTTGGTT	Negative
TGCCGAGGTTAAGACA	Negative
TGCCGAGTCCGCCTAT	Hashtag6
TGCGACGAGCTCTGTA	Negative
TGCGACGAGGCGTCCT	Hashtag6
TGCGACGCAGTGAGCA	Negative
TGCGACGCATTCTCTA	Hashtag6
TGCGACGGTAGGGTAC	Negative
TGCGACGTCGGCTGTG	Hashtag6
TGCGATAAGACTGGGT	Negative
TGCGATAAGGCTATCT	Negative
TGCGATACAGTAACAA	Negative
TGCGATATCACCCATC	Negative
TGCGGCAAGGTACCTT	Negative
TGCGGCAAGTCCGCCA	Hashtag6
TGCGGGTAGATGAACT	Hashtag6_Hashtag8
TGCGGGTAGGAGGTTC	Hashtag6
TGCGGGTGTACAAGCG	Negative
TGCGGGTGTCCTTGTC	Negative
TGCGGGTGTGCCTGAC	Negative
TGCGGGTTCCTCTAGC	Negative
TGCTCCAAGAGAACCC	Negative
TGCTCCAAGAGGACTC	Hashtag6_Hashtag8
TGCTCCACAAGTCATC	Hashtag6
TGCTCCACACACAGCC	Hashtag6
TGCTCCAGTGGGACAT	Negative
TGCTCCATCAACACCA	Negative
TGCTCGTCACATAGCT	Negative
TGCTCGTTCGACCAAT	Negative
TGCTCGTTCTGTCCGT	Hashtag6
TGCTGAAAGCGCCTCA	Negative
TGCTGAAAGTGAGGTC	Hashtag6_Hashtag8
TGCTGAACAGAGGTTG	Negative
TGCTGAAGTCTAGTGT	Hashtag6
TGCTGAAGTGGAGGTT	Negative
TGCTGAATCCGAGATT	Negative
TGCTTCGAGTTGGAAT	Hashtag6
TGCTTCGGTAGACAGC	Negative
TGCTTCGTCGGCTGGT	Hashtag6_Hashtag8
TGCTTGCAGTAGAATC	Hashtag8
TGCTTGCCACGGATCC	Negative
TGCTTGCTCCGAAATC	Hashtag6
TGCTTGCTCGATACAC	Negative
TGGAACTCACTGTTCC	Hashtag6
TGGAACTGTTTGACAC	Negative
TGGAGAGAGCCAGAGT	Hashtag6
TGGAGAGCAGATCACT	Hashtag6_Hashtag8
TGGAGAGGTAGTCTGT	Hashtag6
TGGAGAGGTGTGTTTG	Hashtag6
TGGAGAGGTTGCTCCT	Hashtag6
TGGAGAGTCAGTCATG	Hashtag6
TGGAGAGTCCGTGCGA	Hashtag8
TGGAGAGTCGTAGCCG	Negative
TGGAGGACAAAGGGTC	Negative
TGGAGGAGTGACATCT	Hashtag6
TGGAGGATCAACGAGG	Negative
TGGAGGATCTACCTTA	Negative
TGGATCAGTGGTACAG	Negative
TGGATCAGTTGAAGTA	Negative
TGGATCATCAAGCCAT	Negative
TGGATCATCGTCAACA	Negative
TGGATGTCATGTTTGG	Negative
TGGATGTGTAGTCACT	Hashtag8
TGGATGTTCAGCCTTC	Negative
TGGATGTTCTCATGCC	Hashtag6
TGGCGTGCACAACGCC	Negative
TGGCGTGGTCGCATGC	Hashtag6
TGGCGTGTCCCTCTCC	Hashtag6
TGGCGTGTCTTACTGT	Negative
TGGGAAGAGCCTCTTC	Hashtag6
TGGGAAGAGCGTATAA	Negative
TGGGAAGAGCTTCGTA	Negative
TGGGAAGAGTACAGCG	Negative
TGGGAAGCACGCGCTA	Negative
TGGGAAGGTAATGATG	Hashtag6
TGGGAAGGTAGACGGT	Hashtag6
TGGGAAGGTCAGTCGC	Negative
TGGGAAGGTCCGGCAT	Negative
TGGGAAGGTCTTGCTC	Negative
TGGGAAGGTGGAAGTC	Negative
TGGGAAGTCGTTCCTG	Negative
TGGGAAGTCTTAGCAG	Negative
TGGGAGACAAAGGCAC	Hashtag6
TGGGAGATCGTGGTAT	Hashtag6
TGGGATTAGTAGTCAA	Hashtag6
TGGGATTAGTGACCTT	Negative
TGGGATTGTGATATAG	Negative
TGGGATTTCCACATAG	Negative
TGGGCGTAGCTTCATG	Hashtag6
TGGGCGTAGTTTCGAC	Hashtag6
TGGGCGTCAAACTAAG	Negative
TGGGCGTCACCGAATT	Negative
TGGGCGTCACCGTACG	Hashtag6
TGGGCGTGTCACCACG	Hashtag6
TGGGCGTGTCAGCTTA	Negative
TGGGCGTGTGAGTGAC	Hashtag6
TGGGCGTGTTACTCAG	Negative
TGGGCGTGTTTAGAGA	Negative
TGGGCGTTCGCCACTT	Hashtag6
TGGGCGTTCGTGGGAA	Hashtag8
TGGGCTGAGTCTAGAA	Hashtag6
TGGGCTGCAGCATGCC	Negative
TGGGCTGCAGTTACCA	Negative
TGGGCTGGTCGACTTA	Negative
TGGGTTAAGCTGTTCA	Negative
TGGGTTACACAAGGTG	Negative
TGGGTTACATGGGATG	Negative
TGGGTTAGTGCACATT	Negative
TGGGTTATCATGCGGC	Negative
TGGGTTATCCGCGGAT	Hashtag6
TGGTACAAGTGACCTT	Negative
TGGTACAAGTTGAAGT	Negative
TGGTACAGTCGCGTCA	Negative
TGGTACATCCCATAGA	Hashtag6
TGGTAGTCAAGCGCAA	Negative
TGGTAGTCACCATTCC	Negative
TGGTAGTCAGGTTCAT	Negative
TGGTAGTGTCTGTCAA	Hashtag8
TGGTAGTGTTCCTACC	Hashtag6
TGGTAGTTCAACTCTT	Hashtag6
TGGTGATAGAAGCTCG	Negative
TGGTGATCATCAGCTA	Negative
TGGTGATGTATCTTCT	Hashtag6
TGGTGATGTGGGATTG	Negative
TGGTGATTCCGTGGGT	Negative
TGGTTAGAGATACGAT	Negative
TGGTTAGAGCGATCGA	Negative
TGGTTAGCACCCTCTA	Negative
TGGTTAGGTACTCCGG	Negative
TGTAACGAGGTCCCTG	Negative
TGTAACGCAGCTCGGT	Negative
TGTAACGCATACCACA	Hashtag6
TGTAACGCATGTTCGA	Negative
TGTAACGGTTCCACGG	Negative
TGTAACGTCTCTCAAT	Hashtag6
TGTAAGCAGGACTAAT	Hashtag6
TGTAAGCAGTTACGAA	Negative
TGTAAGCGTGTAAACA	Hashtag6_Hashtag8
TGTACAGAGATGTTGA	Negative
TGTACAGAGGGAGGAC	Negative
TGTACAGGTATGAAGT	Negative
TGTACAGGTTTACCAG	Negative
TGTAGACAGGCAATGC	Negative
TGTAGACCAACAAGAT	Negative
TGTAGACCAGAATCGG	Negative
TGTAGACCAGATCCTA	Hashtag6
TGTAGACCAGGCTCTG	Hashtag6_Hashtag8
TGTAGACGTACTCCGG	Negative
TGTAGACGTTCCAGGC	Negative
TGTCAGAAGCATCGAG	Hashtag6
TGTCAGAGTGCGGTAA	Hashtag6
TGTCAGAGTTACGATC	Negative
TGTCAGAGTTTACTTC	Negative
TGTCAGAGTTTCGGCG	Negative
TGTCCACCATATGGCT	Negative
TGTCCACGTACCCGCA	Negative
TGTCCACGTACTGGGA	Negative
TGTCCACTCACAATGC	Negative
TGTCCCAGTCTTAGTG	Negative
TGTCCCATCCCAGTGG	Negative
TGTCCTGAGAATAGTC	Hashtag6
TGTCCTGAGACCGTTT	Hashtag6
TGTCCTGAGAGCATAT	Hashtag6
TGTCCTGAGTCACGAG	Negative
TGTCCTGAGTCATAGA	Negative
TGTCCTGCAGATCACT	Hashtag6
TGTCCTGTCGTAGTGT	Hashtag6
TGTCCTGTCGTGTGGC	Negative
TGTCCTGTCTGCTTTA	Hashtag6
TGTCCTGTCTTCCAGC	Negative
TGTGAGTAGGTGCCAA	Hashtag6
TGTGAGTCAAACCATC	Negative
TGTGAGTCAATAGGAT	Hashtag6
TGTGAGTTCGCTTTAT	Negative
TGTGAGTTCTACAGGT	Negative
TGTGAGTTCTGGAGAG	Hashtag6
TGTGATGCACTAGGCC	Negative
TGTGATGCAGAATCGG	Negative
TGTGATGGTGTACATC	Negative
TGTGATGTCGCTCTCA	Negative
TGTGCGGAGAAGTATC	Hashtag8
TGTGCGGCACGGGCTT	Negative
TGTGCGGGTCGCTTAA	Negative
TGTGCGGGTGTCATTG	Negative
TGTGCGGGTTTCCATT	Hashtag6
TGTGCGGTCATGAAAG	Negative
TGTGGCGAGCGAAACC	Negative
TGTGGCGAGGCCTGAA	Negative
TGTGGCGCACGCGCTA	Negative
TGTGGCGCATATCTGG	Negative
TGTGGCGCATCCGTGG	Hashtag6
TGTGGCGTCCTGGCTT	Hashtag6
TGTGGCGTCGGCACTG	Negative
TGTGGCGTCTGTACAG	Negative
TGTGTGACAAGTGGAC	Negative
TGTGTGAGTACGGTTT	Hashtag6
TGTGTGATCCTACACC	Hashtag6
TGTGTGATCCTTCTGG	Negative
TGTTACTAGCCGATAG	Hashtag6
TGTTACTAGGCCTTGC	Hashtag6
TGTTACTCAATCTCGA	Negative
TGTTACTCAGATCCAT	Hashtag6
TGTTACTGTATCACCA	Negative
TGTTCATCAAACTCTG	Negative
TGTTCATGTCGAATTC	Hashtag6
TGTTCATGTGGACAGT	Negative
TGTTCATGTTCACGAT	Hashtag6_Hashtag8
TGTTCCGAGGAATGTT	Hashtag6
TGTTCCGAGGTTCTAC	Negative
TGTTCCGAGTCACTCA	Negative
TGTTCCGCATCGGAAG	Negative
TGTTCCGTCGCCAGTG	Negative
TGTTCTAAGCATTGAA	Negative
TGTTCTAAGGAACTCG	Hashtag8
TGTTCTAAGTGATGGC	Hashtag6
TGTTCTACAACGATTC	Negative
TGTTCTAGTATACGGG	Negative
TGTTCTATCCTGATAG	Negative
TGTTCTATCTTACCAT	Hashtag6
TGTTGAGAGTAGAGTT	Negative
TGTTGAGCAAACACGG	Negative
TGTTGGAAGGATTCCT	Negative
TGTTGGAAGTTAACGA	Negative
TGTTGGAGTCAAATCC	Negative
TGTTGGAGTCCCAAAT	Negative
TGTTGGATCGGACAAG	Hashtag8
TGTTTGTAGAGTCACG	Hashtag6
TGTTTGTAGGGAACAA	Negative
TGTTTGTAGTAGGGTC	Negative
TGTTTGTCACTTGGGC	Hashtag8
TTAATCCAGCAGCACA	Hashtag6
TTAATCCAGTCATACC	Hashtag6_Hashtag8
TTAATCCCATTCCTAT	Negative
TTAATCCGTGATGAAT	Hashtag6
TTACAGGAGGGAGGGT	Hashtag6
TTACAGGGTGACTAAA	Negative
TTACAGGTCATTTCCA	Hashtag6
TTACCATAGGTGCTGA	Negative
TTACCATCAAGCTACT	Negative
TTACCATGTCACTACA	Negative
TTACCATTCGGCCCAA	Negative
TTACCGCAGCGCCTCA	Hashtag6
TTACCGCAGTGGTGAC	Negative
TTACCGCGTCATATGC	Hashtag6
TTACCGCGTCCCTAAA	Hashtag6
TTACCGCGTGATAGAT	Hashtag8
TTACGCCAGGCTTTCA	Negative
TTACGTTAGAATGTTG	Hashtag6
TTACGTTCAACTCCCT	Negative
TTACGTTCAAGTGTCT	Negative
TTACGTTCATACTGTG	Negative
TTACGTTGTTCCGGTG	Negative
TTACGTTGTTGTGGAG	Hashtag6
TTACGTTTCGCCAGTG	Negative
TTACTGTAGTTGGAAT	Hashtag6
TTACTGTCAGAACCGA	Hashtag6
TTACTGTCAGCTGTCG	Hashtag6
TTACTGTTCCTAGAGT	Negative
TTAGGCAAGAGATGCC	Negative
TTAGGCAAGGCGTTAG	Negative
TTAGGCAAGGGTAGCT	Hashtag6
TTAGGCAAGGTCGCCT	Hashtag6
TTAGGCACACCCATAA	Hashtag6
TTAGGCACAGCGTGCT	Negative
TTAGGCAGTCAGTCTA	Negative
TTAGGCAGTGTAGTGG	Hashtag6
TTAGGGTAGTCCCTAA	Hashtag6
TTAGGGTCATGCGTGC	Negative
TTAGGGTGTAGACAAT	Hashtag6
TTAGGGTTCTGGAGAG	Hashtag6
TTAGTCTAGACGAGCT	Negative
TTAGTCTCACCTCTGT	Negative
TTAGTCTGTGCTTCAA	Negative
TTATTGCAGAGGTTAT	Negative
TTATTGCAGGACAACC	Hashtag6
TTATTGCAGGAGCTGT	Negative
TTATTGCAGGGTGAAA	Negative
TTCAATCCAAAGAGTT	Hashtag6
TTCAATCCATCCGGCA	Negative
TTCAATCCATCGTGGC	Negative
TTCAATCGTTCTATCT	Hashtag6
TTCAATCTCAGGAGAC	Hashtag6
TTCAATCTCCGCGATG	Negative
TTCACCGAGACGGATC	Hashtag6_Hashtag8
TTCACCGAGCTGACCC	Negative
TTCACCGCATTGACCA	Hashtag6
TTCACCGGTACGACTT	Negative
TTCACCGTCGAAACAA	Hashtag6
TTCACGCAGTACTGGG	Negative
TTCACGCCATGTCGTA	Negative
TTCACGCGTCGACTTA	Hashtag6_Hashtag8
TTCACGCGTGTATTCG	Negative
TTCACGCGTTCGGTTA	Hashtag6
TTCAGGAAGCTAAACA	Negative
TTCAGGAAGGGCAGAG	Negative
TTCAGGACAATCGTCA	Hashtag6
TTCAGGACACCTCTGT	Negative
TTCAGGACATTGGCAT	Hashtag6
TTCAGGATCCACAAGT	Hashtag6
TTCAGGATCGTAGGAG	Negative
TTCATGTCAAGGGTCA	Hashtag6
TTCATGTCAGTCAACT	Negative
TTCATTGAGGTATTGA	Hashtag6
TTCATTGCAACCCTAA	Negative
TTCATTGCACATTGTG	Negative
TTCATTGGTGGCTCTG	Negative
TTCATTGTCAAACGAA	Negative
TTCATTGTCGGTCACG	Hashtag6
TTCCAATAGATGCCGA	Negative
TTCCAATAGGGCTAAC	Hashtag6
TTCCAATAGTCATCGT	Negative
TTCCAATCAGGTCCCA	Hashtag6
TTCCAATGTTAGAAGT	Hashtag6
TTCCACGAGATTACCC	Negative
TTCCACGGTACTGCCG	Negative
TTCCGGTCAGCGGATA	Hashtag6
TTCCGGTCATGCACTA	Hashtag6
TTCCGGTGTCCACATA	Negative
TTCCGTGAGAGTGGCT	Negative
TTCCGTGAGATAGTGT	Hashtag6
TTCCGTGAGCCAGACA	Negative
TTCCGTGAGGACTGGT	Negative
TTCCGTGTCAAGGAGC	Negative
TTCCGTGTCCGGCTTT	Negative
TTCCGTGTCTATACGG	Hashtag6
TTCCTAAAGGATGCGT	Negative
TTCCTAAAGTTCTCTT	Negative
TTCCTAACAAGGCAAC	Negative
TTCCTAACAATCAAGA	Negative
TTCCTAAGTCGTATGT	Negative
TTCCTCTTCCCAAGTA	Negative
TTCCTTCCAAGTGGTG	Hashtag6
TTCCTTCTCCAAGCAT	Negative
TTCCTTCTCCATAGAC	Negative
TTCCTTCTCTATCGCC	Hashtag6
TTCGATTGTCCAGAAG	Hashtag8
TTCGCTGAGTCGGCAA	Hashtag6
TTCGCTGGTTTCGCTC	Negative
TTCGCTGTCGGTAGAG	Negative
TTCGCTGTCTACGGTA	Negative
TTCGGTCAGGCACTCC	Negative
TTCGGTCAGTTGGAGC	Negative
TTCGGTCTCACGGTCG	Negative
TTCGGTCTCCATAGGT	Negative
TTCTAACAGCGACCCT	Negative
TTCTAACCAACAGATA	Negative
TTCTAACCACTGCACG	Negative
TTCTAACCACTTCAGA	Negative
TTCTAACGTAAGGTCG	Negative
TTCTAACGTACTCAAC	Negative
TTCTAACTCCGTGGCA	Negative
TTCTAGTCAATACCTG	Hashtag6
TTCTCTCAGAATGTTG	Negative
TTCTCTCAGGTACTGG	Negative
TTCTCTCCAAATCAAG	Negative
TTCTCTCCACATTACG	Negative
TTCTCTCGTACGGGAT	Negative
TTCTCTCGTCCTTGTC	Hashtag8
TTCTCTCGTTCAGGTT	Negative
TTCTCTCGTTCCATTT	Negative
TTCTCTCGTTCGATTG	Negative
TTCTCTCTCACCCTGT	Hashtag6
TTCTCTCTCATTTCGT	Negative
TTCTGTAAGCAAGGAA	Hashtag8
TTCTGTAAGCATGGGT	Hashtag6
TTCTGTACATGCCATA	Negative
TTCTGTAGTAGGGAGG	Negative
TTCTGTATCCCTTTGG	Negative
TTCTTCCAGATAGCAT	Negative
TTCTTCCAGCGTATGG	Hashtag6
TTCTTCCCAAGACAAT	Negative
TTCTTCCCAGACGGAT	Negative
TTCTTGAAGGCTATCT	Negative
TTGAACGCAACCGGAA	Negative
TTGAACGCACTTTAGG	Negative
TTGACCCAGCGACAGT	Negative
TTGACCCAGGGACTGT	Negative
TTGACCCCATTGGCAT	Negative
TTGACCCGTTTGGCTA	Negative
TTGAGTGGTACTAACC	Negative
TTGAGTGGTCTCGGAC	Negative
TTGAGTGGTTCTTAGG	Negative
TTGAGTGTCAGTGATC	Negative
TTGATGGCATGTGGCC	Negative
TTGATGGGTCCACAGC	Negative
TTGCATTAGATCCCGC	Negative
TTGCATTCAAGCTACT	Negative
TTGCATTCAGCGTTTA	Negative
TTGCATTCATGAGATA	Negative
TTGCATTGTGCCCTTT	Negative
TTGCCTGAGGTATTGA	Negative
TTGCCTGCACGACAGA	Negative
TTGCCTGCAGGTCCGT	Negative
TTGCCTGGTGTAGCAG	Negative
TTGCCTGTCCATTGTT	Negative
TTGCGTCTCGGAAACG	Hashtag6
TTGGATGAGTCTAACC	Negative
TTGGATGGTCTCAGAT	Hashtag6
TTGGATGGTTGCTGAT	Hashtag6
TTGGGATAGGGTTTCT	Negative
TTGGGATCAAGTATCC	Hashtag6
TTGGGCGAGCTTGTGT	Negative
TTGGGCGCAAGAGGCT	Negative
TTGGGCGCAAGCTGTT	Hashtag6
TTGGGCGCATCTAACG	Negative
TTGGGCGGTAGTACGG	Hashtag6
TTGGGCGGTGCAACAG	Hashtag6
TTGGGCGGTGCGGATA	Hashtag6
TTGGGCGTCGCCAGAC	Hashtag8
TTGGGCGTCTCCATAT	Negative
TTGGGTAAGGCCATAG	Hashtag6
TTGGGTATCGCCAATA	Hashtag6
TTGGGTATCTTCACGC	Hashtag6
TTGGTTTCAAGCTGCC	Negative
TTGGTTTCACATAACC	Negative
TTGGTTTCACCAGCCA	Hashtag6
TTGGTTTGTCAGACGA	Negative
TTGGTTTGTGAGAGGG	Hashtag6
TTGGTTTTCCCGATCT	Negative
TTGTGGACATTGAGGG	Hashtag6
TTGTGTTAGCATCAGG	Negative
TTGTGTTAGCGCCCAT	Negative
TTGTGTTAGGTGTGAC	Negative
TTGTGTTCAACAGCTT	Hashtag6
TTGTGTTCAGCTCATA	Hashtag6_Hashtag8
TTGTGTTGTTATAGCC	Negative
TTGTGTTTCTATCGGA	Negative
TTGTTCAAGCTACTGT	Hashtag6
TTGTTCACAGAGCCCT	Hashtag6
TTGTTCATCCGTATGA	Negative
TTGTTCATCTCGGCTT	Negative
TTGTTGTCACTTGTCC	Negative
TTGTTGTGTCAGACTT	Negative
TTGTTGTGTGACAGGT	Negative
TTGTTTGCACAGTCCG	Negative
TTGTTTGCATCGTGCG	Negative
TTGTTTGTCGGCTCTT	Hashtag6
TTTACCAAGTTTAGGA	Negative
TTTACCACATGATAGA	Negative
TTTACGTAGGTTTACC	Hashtag6
TTTACGTAGGTTTGAA	Negative
TTTACGTGTCAGCGTC	Negative
TTTACGTGTTCAAACC	Negative
TTTACGTTCAGGAAGC	Hashtag6
TTTACTGCATGGCTGC	Negative
TTTACTGGTGACTGTT	Negative
TTTACTGGTTAAGTCC	Negative
TTTACTGTCAACCCGG	Negative
TTTACTGTCGTGGTAT	Hashtag6
TTTAGTCAGGTTCCGC	Negative
TTTAGTCCAAAGACGC	Hashtag6
TTTAGTCGTTTACCTT	Hashtag6
TTTAGTCTCCACTAGA	Negative
TTTAGTCTCGAACCAT	Negative
TTTAGTCTCTTACGGA	Hashtag6
TTTATGCAGCCATCCG	Negative
TTTATGCAGTTGTCAC	Hashtag6
TTTATGCCAGCGAACA	Negative
TTTATGCCAGGACATG	Negative
TTTATGCCATCTGTTT	Hashtag6
TTTATGCGTCGGTGAA	Hashtag6
TTTATGCGTCTAATCG	Hashtag6
TTTATGCGTTGCTGAT	Hashtag6_Hashtag8
TTTATGCTCACTTGGA	Hashtag6
TTTCACACAGCTGGTC	Negative
TTTCACAGTAACATCC	Negative
TTTCACAGTGAATGTA	Hashtag6_Hashtag8
TTTCACAGTGGAGGTT	Negative
TTTCACAGTGTAGTGG	Negative
TTTCACATCCGCGATG	Negative
TTTCACATCCTGCCAT	Negative
TTTCACATCGCATTGA	Hashtag6
TTTCAGTCAACCAACT	Negative
TTTCAGTCAGCTTTGA	Negative
TTTCAGTCAGGCACTC	Negative
TTTCATGGTAGTCTTG	Negative
TTTCATGGTCATGCAT	Negative
TTTCATGGTTGCAACT	Negative
TTTCATGTCATGAGGG	Negative
TTTCATGTCATGGGAG	Negative
TTTCATGTCCAGTACA	Negative
TTTCCTCAGGTAGCCA	Negative
TTTCCTCAGGTCCGAA	Negative
TTTCCTCCATCACGGC	Negative
TTTCCTCTCCTCTCGA	Hashtag6
TTTCCTCTCGCCATAA	Negative
TTTCGATCACAGAAGC	Negative
TTTCGATCACCAGCCA	Hashtag6
TTTCGATGTCTACGAT	Negative
TTTCGATGTTCGAACT	Negative
TTTGACTCATACCATG	Negative
TTTGACTGTACCTTCC	Negative
TTTGACTTCCGTTTCG	Negative
TTTGACTTCGGAAGGT	Negative
TTTGATCTCCCAAGTA	Negative
TTTGATCTCCCAGCGA	Negative
TTTGGTTAGCACTAAA	Hashtag6_Hashtag8
TTTGGTTAGGTAACTA	Negative
TTTGGTTCAACCGCTG	Hashtag8
TTTGGTTCATCTAGAC	Hashtag8
TTTGGTTGTCCCACGA	Negative
TTTGTTGGTGGGTTGA	Negative
TTTGTTGTCCTACTGC	Negative
