cells	sample
AAACCCACAACCGACC	Hashtag5
AAACCCACAATAACGA	Hashtag5
AAACCCACATCGCTCT	Negative
AAACCCAGTACCTTCC	Negative
AAACCCAGTTTGTTGG	Hashtag5_Hashtag7
AAACCCATCCAAGGGA	Hashtag7
AAACCCATCGTCAAAC	Negative
AAACGAAAGACCCGCT	Hashtag5
AAACGAACATATTCGG	Hashtag7
AAACGAAGTCTCAGGC	Negative
AAACGAATCACCATAG	Hashtag5_Hashtag7
AAACGAATCCTGGGAC	Hashtag5_Hashtag7
AAACGCTAGCCAGAGT	Hashtag5
AAACGCTAGCGACTAG	Hashtag5
AAACGCTTCCATCTAT	Hashtag7
AAAGAACCAACTGAAA	Negative
AAAGAACCACAAAGCG	Hashtag7
AAAGAACGTAATGCGG	Hashtag5_Hashtag7
AAAGAACTCATTGGTG	Hashtag5_Hashtag7
AAAGGATAGACGCCCT	Hashtag5_Hashtag7
AAAGGATCAACCGGAA	Hashtag5_Hashtag7
AAAGGATTCGTGCTCT	Negative
AAAGGATTCTGTCTCG	Negative
AAAGGATTCTTTCCGG	Negative
AAAGGGCAGGTTGTTC	Hashtag5
AAAGGGCCAGGAGGAG	Hashtag5
AAAGGGCCAGTCAACT	Negative
AAAGGGCCATCGTTCC	Negative
AAAGGGCGTCCTCATC	Hashtag5_Hashtag7
AAAGGGCTCTTCTAAC	Hashtag7
AAAGGTAAGAAACCAT	Hashtag5
AAAGGTAAGCAGATAT	Hashtag7
AAAGGTACAATTGCCA	Negative
AAAGGTAGTGGTACAG	Negative
AAAGGTAGTTGCTTGA	Hashtag5_Hashtag7
AAAGGTATCCGATGTA	Hashtag5
AAAGGTATCGTTCCTG	Hashtag5
AAAGGTATCTTCGTAT	Hashtag5
AAAGTCCAGGTCGTGA	Hashtag7
AAAGTCCCACGGTAGA	Hashtag5_Hashtag7
AAAGTCCCATCCGCGA	Negative
AAAGTCCGTTAGAAAC	Hashtag5
AAAGTCCTCCGCAACG	Negative
AAAGTCCTCTCTCGCA	Hashtag5_Hashtag7
AAAGTGACACTTCATT	Hashtag7
AAAGTGAGTAGCACGA	Hashtag5_Hashtag7
AAAGTGAGTGATAGTA	Hashtag7
AAAGTGAGTTTGAAAG	Hashtag5_Hashtag7
AAAGTGATCGGACCAC	Hashtag5_Hashtag7
AAATGGAAGGTAAACT	Hashtag5_Hashtag7
AAATGGAAGGTGGGTT	Hashtag7
AAATGGACACATATCG	Hashtag5_Hashtag7
AAATGGACACTGGAAG	Hashtag5_Hashtag7
AAATGGACAGGGTCTC	Hashtag5_Hashtag7
AAATGGAGTCGAACAG	Hashtag5
AAATGGATCACGTAGT	Negative
AAATGGATCGCAGTCG	Hashtag5
AACAAAGAGAGTACCG	Negative
AACAAAGAGGTAGGCT	Hashtag5_Hashtag7
AACAAAGCATCCCACT	Hashtag5_Hashtag7
AACAAAGCATTCAGCA	Hashtag5
AACAAAGGTAGCGCTC	Hashtag5_Hashtag7
AACAAAGGTTCGGTCG	Hashtag7
AACAAAGGTTCTCCAC	Hashtag5_Hashtag7
AACAAAGTCATTATCC	Hashtag5
AACAAAGTCCCAATAG	Hashtag5_Hashtag7
AACAAAGTCGAAATCC	Negative
AACAAAGTCGATGGAG	Negative
AACAACCAGACCATGG	Negative
AACAACCAGATTAGAC	Hashtag7
AACAACCAGGGATGTC	Hashtag5_Hashtag7
AACAACCCACGAAAGC	Hashtag5
AACAACCGTAACATGA	Hashtag5_Hashtag7
AACAACCGTCTGTCCT	Negative
AACAACCGTGTTTCTT	Hashtag5
AACAACCTCGAGGCAA	Negative
AACAACCTCTGGGCGT	Negative
AACAAGAAGCCATTGT	Hashtag5_Hashtag7
AACAAGACACAAATGA	Negative
AACAAGACACCTGAAT	Hashtag5
AACAAGACATAGTCAC	Hashtag5_Hashtag7
AACAAGAGTGACAGCA	Negative
AACAAGAGTGGATTTC	Hashtag5_Hashtag7
AACAAGAGTGTGTGGA	Negative
AACACACAGTGTACCT	Hashtag5
AACACACCAATCGTCA	Negative
AACACACGTCAAAGAT	Hashtag5
AACACACGTCCGATCG	Hashtag7
AACACACTCAGTGTGT	Hashtag5_Hashtag7
AACACACTCCTTACCG	Hashtag5
AACAGGGCAACGAGGT	Hashtag5
AACAGGGGTATCAGCT	Negative
AACAGGGGTGCGGATA	Hashtag5
AACAGGGGTTCTATCT	Negative
AACAGGGTCCGAGTGC	Hashtag7
AACAGGGTCCTACAAG	Negative
AACCAACAGCTTGTTG	Hashtag5_Hashtag7
AACCAACCAACTCCCT	Hashtag5_Hashtag7
AACCAACCAACTGCTA	Hashtag5
AACCAACCAAGCAGGT	Hashtag5_Hashtag7
AACCAACCACTGAGTT	Negative
AACCAACGTACGCTAT	Hashtag5_Hashtag7
AACCAACGTTGAGAGC	Hashtag5_Hashtag7
AACCAACTCGTTCTCG	Hashtag5
AACCACAAGCCAAGGT	Hashtag5
AACCACACAGACTGCC	Hashtag5
AACCACACAGTTTGGT	Hashtag7
AACCACAGTCTTGCGG	Hashtag7
AACCACAGTTAACCTG	Negative
AACCACATCGAACGGA	Negative
AACCACATCTCCGAAA	Hashtag5_Hashtag7
AACCATGAGAAATTGC	Hashtag5_Hashtag7
AACCATGAGCTCCCTT	Hashtag7
AACCATGAGTGGGAAA	Hashtag7
AACCATGCACGACAGA	Hashtag5_Hashtag7
AACCATGTCCGAGCTG	Negative
AACCCAATCCAAAGGG	Negative
AACCCAATCGTCAAAC	Hashtag5_Hashtag7
AACCCAATCTGTCAGA	Hashtag5
AACCTGAAGCGCTTCG	Hashtag7
AACCTGACACGCACCA	Negative
AACCTGAGTAGGTAGC	Hashtag5
AACCTGAGTTATAGAG	Negative
AACCTTTAGAAGCCTG	Hashtag5_Hashtag7
AACCTTTAGAGCAGCT	Hashtag5
AACCTTTAGCGGTAGT	Hashtag7
AACCTTTGTACGATGG	Hashtag5
AACCTTTTCGTGCTCT	Hashtag5
AACGAAAAGACGCATG	Hashtag5
AACGAAACAAGGGTCA	Hashtag5_Hashtag7
AACGAAACACCTGCTT	Hashtag7
AACGAAATCAAACGTC	Negative
AACGAAATCTAACGCA	Hashtag5
AACGGGAAGGATGGCT	Negative
AACGGGAAGTGGCAGT	Negative
AACGGGACAGATACTC	Negative
AACGGGAGTAACGTTC	Negative
AACGGGATCATGTCAG	Hashtag5_Hashtag7
AACGTCAAGACCTGGA	Hashtag7
AACGTCAAGCCTCCAG	Hashtag7
AACGTCACACGCTTAA	Hashtag5_Hashtag7
AACGTCACACTCTAGA	Hashtag5
AACGTCAGTAGACAAT	Hashtag5
AACGTCATCGATAACC	Hashtag5_Hashtag7
AACGTCATCTTCCGTG	Hashtag5
AACTTCTAGGCCTTGC	Negative
AACTTCTCAGAACTAA	Hashtag5_Hashtag7
AACTTCTCAGCGGATA	Hashtag5
AACTTCTCAGCTGCCA	Negative
AACTTCTCAGGCACTC	Hashtag5_Hashtag7
AACTTCTCATGTGGTT	Hashtag7
AACTTCTGTGAATGTA	Hashtag5
AACTTCTGTTGTACGT	Hashtag7
AACTTCTTCGAGCCTG	Negative
AACTTCTTCTTGATTC	Hashtag5
AAGAACACAATTCTCT	Hashtag5
AAGAACACAGGCCTGT	Hashtag5
AAGAACAGTGGACTAG	Hashtag7
AAGAACATCGCCAGTG	Negative
AAGAACATCGCTCATC	Hashtag5
AAGACAAAGAAACCCG	Hashtag7
AAGACAAAGTCAAGCG	Hashtag5
AAGACAACAAGGCTTT	Hashtag5
AAGACAATCCTTTGAT	Negative
AAGACTCAGCTTAAGA	Hashtag7
AAGACTCAGGAAGAAC	Hashtag5_Hashtag7
AAGACTCCAATGGCCC	Negative
AAGACTCCACCCGTAG	Negative
AAGACTCGTACGATTC	Hashtag5
AAGACTCGTATACGGG	Hashtag7
AAGACTCGTTACGGAG	Hashtag7
AAGACTCTCCTAGCGG	Hashtag5
AAGATAGAGCCAGACA	Hashtag7
AAGATAGGTAAGTTGA	Hashtag5
AAGATAGGTAGCCCTG	Negative
AAGATAGTCCTACACC	Hashtag5
AAGATAGTCCTGGGTG	Negative
AAGCATCCAACAGTGG	Hashtag7
AAGCATCCACCAGCTG	Hashtag7
AAGCATCGTAACGCGA	Hashtag5_Hashtag7
AAGCATCGTAACTAAG	Hashtag5
AAGCATCGTGTCTTCC	Hashtag5
AAGCATCTCAGACCTA	Hashtag7
AAGCCATCAATCGTCA	Negative
AAGCCATTCCATCTGC	Hashtag5_Hashtag7
AAGCCATTCCCGAGTG	Hashtag5_Hashtag7
AAGCCATTCCGAACGC	Hashtag5_Hashtag7
AAGCCATTCCGAAGGA	Hashtag7
AAGCGAGCACGGTAGA	Negative
AAGCGAGGTACGGCAA	Negative
AAGCGAGGTTCAAACC	Hashtag7
AAGCGAGTCAGGAAAT	Negative
AAGCGAGTCGAAGTGG	Negative
AAGCGTTCACCCTTGT	Hashtag7
AAGCGTTTCAAAGCCT	Hashtag5
AAGGAATCAATCCAGT	Negative
AAGGAATCACTCCCTA	Negative
AAGGAATCAGGTGAGT	Hashtag5_Hashtag7
AAGGAATCATCCGAAT	Negative
AAGGAATGTAGCTTAC	Hashtag5_Hashtag7
AAGGAATGTTAAGTCC	Hashtag7
AAGGTAAAGACCACGA	Negative
AAGGTAAAGCATGGGT	Hashtag5
AAGGTAACAACCCGCA	Hashtag7
AAGGTAAGTCCATAGT	Hashtag7
AAGGTAAGTCCGATCG	Hashtag5
AAGGTAAGTTGGTACT	Hashtag5_Hashtag7
AAGGTAAGTTTACCAG	Hashtag7
AAGGTAATCTCTCCGA	Hashtag5
AAGTACCAGTAAATGC	Hashtag7
AAGTACCCAGCCGTTG	Hashtag5_Hashtag7
AAGTACCGTACCAATC	Hashtag5
AAGTCGTAGAAGGTAG	Hashtag5_Hashtag7
AAGTCGTCATCGATCA	Hashtag5
AAGTCGTTCGAGATAA	Negative
AAGTGAAAGGTGATCG	Hashtag5
AAGTGAACAAGCGAAC	Hashtag5
AAGTGAACACGCGTCA	Hashtag5
AAGTGAAGTCAAAGTA	Negative
AAGTGAAGTTAAACAG	Hashtag5_Hashtag7
AAGTGAATCAGCTCTC	Hashtag5
AAGTGAATCGGCATTA	Hashtag5_Hashtag7
AAGTTCGCACAGTCCG	Negative
AAGTTCGCATGAGAAT	Hashtag7
AAGTTCGGTCAAAGCG	Hashtag5_Hashtag7
AAGTTCGGTTATTCCT	Negative
AAGTTCGTCGTAGTCA	Hashtag5
AATAGAGAGCATGAAT	Hashtag7
AATAGAGCAAGGGCAT	Negative
AATAGAGCATCCTTCG	Hashtag7
AATCACGAGAAATGGG	Hashtag5
AATCACGAGTGCAAAT	Hashtag7
AATCACGCAGTAACCT	Hashtag5_Hashtag7
AATCACGCATGAGAAT	Hashtag7
AATCACGGTCAGACTT	Hashtag5_Hashtag7
AATCACGTCATCGACA	Hashtag5
AATCACGTCGTGAGAG	Negative
AATCGACCATGACTGT	Hashtag5_Hashtag7
AATCGACTCGAACGCC	Hashtag5
AATCGTGAGGATCATA	Negative
AATCGTGCAGAGGCTA	Negative
AATCGTGCATAGCACT	Hashtag5_Hashtag7
AATCGTGCATCAGTCA	Hashtag5_Hashtag7
AATCGTGGTCGCCACA	Hashtag5_Hashtag7
AATCGTGTCCTCGCAT	Hashtag5
AATGAAGAGCCAAGTG	Hashtag5
AATGAAGCAGTAACCT	Hashtag7
AATGAAGCATCGAACT	Hashtag7
AATGAAGGTAGGAAAG	Hashtag5
AATGAAGGTATCCTTT	Negative
AATGAAGGTTGGATCT	Hashtag7
AATGAAGTCTCCACTG	Hashtag7
AATGAAGTCTGGGATT	Hashtag7
AATGCCAAGCCATTTG	Hashtag7
AATGCCAAGGCCGCTT	Negative
AATGCCACACAGAGCA	Hashtag5_Hashtag7
AATGCCACAGTCTCTC	Hashtag5
AATGCCAGTCCCAAAT	Hashtag5_Hashtag7
AATGCCAGTGTGTGTT	Hashtag7
AATGGAACATATTCGG	Hashtag5_Hashtag7
AATGGAACATCAGTGT	Hashtag5
AATGGAACATGGAATA	Hashtag5_Hashtag7
AATGGAAGTACCACGC	Negative
AATGGAAGTATCGCGC	Hashtag5
AATGGAATCCGGTAGC	Hashtag7
AATGGAATCCTGTAAG	Hashtag5_Hashtag7
AATGGCTAGAGCCGTA	Hashtag5
AATGGCTAGCCTTGAT	Negative
AATGGCTAGCTACGTT	Hashtag5
AATGGCTCAGAGCCCT	Negative
AATGGCTGTACAAGCG	Hashtag7
AATGGCTTCCCTAGGG	Negative
AATTCCTAGCTTCGTA	Hashtag5
AATTCCTAGGCCTGAA	Hashtag5_Hashtag7
AATTCCTAGTTGAAGT	Negative
AATTCCTCAAACTCGT	Hashtag5
AATTCCTCAACAGATA	Hashtag7
AATTCCTCAACCGGAA	Hashtag5
AATTCCTCAACGATTC	Hashtag5_Hashtag7
AATTCCTCAACGGTAG	Hashtag5
AATTCCTCAGGTGTGA	Hashtag5
AATTCCTGTACCACGC	Hashtag5_Hashtag7
AATTCCTGTCAGTTTG	Hashtag5
AATTTCCAGGCGACAT	Hashtag7
AATTTCCTCGACATAC	Hashtag5_Hashtag7
AATTTCCTCGCTTGAA	Negative
ACAAAGACAAGCCCAC	Hashtag7
ACAAAGAGTCGAAGCA	Hashtag5_Hashtag7
ACAACCAAGCAGCCCT	Hashtag5_Hashtag7
ACAACCAAGGGAACAA	Hashtag7
ACAACCAAGTCTTCCC	Negative
ACAACCAAGTGATAGT	Hashtag7
ACAACCACAAGTACCT	Hashtag5
ACAACCACAGATCCTA	Hashtag5_Hashtag7
ACAACCACAGCGGTCT	Hashtag5_Hashtag7
ACAACCACAGGCATGA	Hashtag5
ACAACCACATGCCGCA	Hashtag5
ACAACCACATTCTCTA	Negative
ACAACCAGTCGGAACA	Negative
ACAACCATCTTCACAT	Hashtag5
ACAAGCTAGAATCTAG	Hashtag5
ACAAGCTAGCGATGCA	Negative
ACAAGCTAGCTGAGCA	Hashtag5_Hashtag7
ACAAGCTAGTCTAACC	Hashtag7
ACAAGCTCAATTCTTC	Negative
ACAAGCTCATCGGTTA	Negative
ACAAGCTCATTGAAAG	Hashtag7
ACAAGCTGTATGCAAA	Negative
ACAAGCTGTTGACTGT	Hashtag5
ACAAGCTTCACAATGC	Hashtag7
ACACAGTCAAGACAAT	Hashtag5_Hashtag7
ACACAGTCATCTGCGG	Negative
ACACAGTTCAAGTAAG	Hashtag5
ACACAGTTCAATCCGA	Hashtag5_Hashtag7
ACACAGTTCCGAGATT	Negative
ACACAGTTCTCTCAAT	Hashtag7
ACACAGTTCTGGGTCG	Hashtag5
ACACCAAAGCGATCGA	Hashtag5_Hashtag7
ACACCAAAGGACGCAT	Hashtag5
ACACCAACAACGGGTA	Hashtag5_Hashtag7
ACACCAACAACGTATC	Hashtag5_Hashtag7
ACACCAACACCAGCTG	Hashtag5_Hashtag7
ACACCAAGTATGGTTC	Negative
ACACCAAGTCAAATCC	Hashtag7
ACACCAAGTCCACTCT	Negative
ACACCAAGTGCACATT	Hashtag7
ACACCAAGTTGGGTAG	Hashtag5_Hashtag7
ACACCAATCTGTAACG	Hashtag7
ACACGCGAGGCATCTT	Hashtag7
ACACGCGCATGATGCT	Hashtag5
ACACGCGGTAACGCGA	Hashtag7
ACACGCGGTTCCAAAC	Hashtag5_Hashtag7
ACACGCGTCCACGTCT	Hashtag5_Hashtag7
ACACTGAAGGGTCAAC	Negative
ACACTGACAATCTCGA	Hashtag7
ACACTGACACCGTGCA	Hashtag7
ACACTGAGTGATGGCA	Hashtag7
ACACTGATCATTGGTG	Hashtag5_Hashtag7
ACACTGATCTCCTGTG	Hashtag7
ACAGAAAAGGCCTGCT	Hashtag5_Hashtag7
ACAGAAACATCCCGTT	Hashtag5
ACAGAAAGTAGCTGCC	Hashtag7
ACAGAAAGTTTAAGGA	Negative
ACAGAAAGTTTACTGG	Hashtag5_Hashtag7
ACAGAAATCTCTTAAC	Hashtag5_Hashtag7
ACAGCCGCAAATGGAT	Negative
ACAGCCGCACTTGGCG	Negative
ACAGCCGCAGAAGTGC	Hashtag7
ACAGCCGTCATAGCAC	Negative
ACAGCCGTCGTCAAAC	Hashtag5
ACAGGGAAGCACTCGC	Hashtag5
ACAGGGACAAATGGCG	Hashtag5
ACAGGGACAGAACGCA	Negative
ACAGGGACAGTGTATC	Hashtag5_Hashtag7
ACAGGGAGTCGAATTC	Hashtag5
ACAGGGAGTTGCGTAT	Hashtag5
ACAGGGATCGAAGGAC	Hashtag5_Hashtag7
ACATCCCAGTTGTAGA	Hashtag5_Hashtag7
ACATCCCGTGGATGAC	Hashtag5
ACATCCCGTTAGGACG	Hashtag5_Hashtag7
ACATCGAAGCGTGCTC	Hashtag5_Hashtag7
ACATCGAAGGGCTAAC	Hashtag7
ACATCGACACGTAGTT	Hashtag7
ACATCGACATACCAGT	Hashtag5
ACATCGAGTCATGCAT	Hashtag5_Hashtag7
ACATCGAGTTTGATCG	Hashtag5
ACATCGATCACCACAA	Negative
ACATCGATCGGTAGGA	Hashtag5
ACATGCAAGTAGGAAG	Hashtag7
ACATGCAGTTATGTCG	Hashtag5_Hashtag7
ACATGCATCCGCACTT	Hashtag5
ACATGCATCGTCAACA	Negative
ACATTTCAGAAGGTAG	Hashtag7
ACATTTCAGAGCATCG	Negative
ACATTTCAGTTCATGC	Hashtag7
ACATTTCCAAGACCGA	Hashtag5_Hashtag7
ACATTTCCATACTGAC	Hashtag5
ACATTTCTCCGATCTC	Hashtag7
ACCAAACAGAGCCTGA	Hashtag5
ACCAAACAGTCGCGAA	Hashtag7
ACCAAACCACCAGTAT	Hashtag5
ACCAAACCAGACCAGA	Hashtag5_Hashtag7
ACCAAACTCGTGCATA	Hashtag5_Hashtag7
ACCAACAAGTAGTGCG	Hashtag5
ACCAACAGTGAGTTTC	Negative
ACCACAACAACAAGTA	Hashtag5
ACCACAACAATCGAAA	Hashtag5
ACCACAATCGTAACAC	Hashtag5
ACCACAATCTGGGCAC	Hashtag5
ACCATTTAGCCATGCC	Negative
ACCATTTGTTGATGTC	Negative
ACCATTTTCATCACTT	Hashtag5
ACCATTTTCCACAGCG	Hashtag5
ACCCAAAAGAAGGATG	Hashtag7
ACCCAAAAGGCTTAAA	Negative
ACCCAAAAGTAGACAT	Hashtag5
ACCCAAACAATCTCTT	Hashtag5
ACCCAAAGTGATACTC	Negative
ACCCAAATCCTCTGCA	Hashtag5
ACCCAAATCGATAACC	Hashtag7
ACCCAAATCGCTACGG	Hashtag5
ACCCAAATCGGTCTGG	Hashtag5
ACCCAAATCTACTGAG	Hashtag5
ACCCAAATCTGAATCG	Hashtag7
ACCCTCAAGCTAGCCC	Hashtag7
ACCCTCACAAGACCGA	Hashtag5
ACCCTCACAAGCGATG	Hashtag5_Hashtag7
ACCCTCACACGGCGTT	Negative
ACCCTCACACTAACGT	Hashtag5
ACCCTCAGTACGATTC	Hashtag5_Hashtag7
ACCCTCAGTCCTCAGG	Hashtag5_Hashtag7
ACCCTCAGTGAGTTTC	Negative
ACCCTCAGTTGTGCCG	Negative
ACCCTCATCCCATAGA	Hashtag5
ACCCTTGCAACGAGGT	Negative
ACCCTTGCAACGTTAC	Hashtag5_Hashtag7
ACCCTTGCACGCAAAG	Hashtag5_Hashtag7
ACCCTTGGTCGTAATC	Negative
ACCCTTGGTTATAGAG	Hashtag5_Hashtag7
ACCGTTCAGGCATGCA	Negative
ACCGTTCAGGTCACAG	Hashtag5
ACCGTTCGTCCCGCAA	Hashtag5_Hashtag7
ACCGTTCGTCTCGGGT	Negative
ACCGTTCTCTGTGCAA	Hashtag5_Hashtag7
ACCTACCAGAGTTGTA	Negative
ACCTACCAGCATAGGC	Hashtag5
ACCTACCCACAACATC	Hashtag5
ACCTACCCATACCGTA	Negative
ACCTGAAAGAGTGTTA	Negative
ACCTGAACAATATCCG	Hashtag5_Hashtag7
ACCTGAACATGGGATG	Hashtag5
ACCTGAATCCGATCTC	Hashtag7
ACCTGTCAGAGGACTC	Hashtag5_Hashtag7
ACCTGTCCATACAGAA	Negative
ACCTGTCCATTGTAGC	Hashtag7
ACCTGTCGTACGATTC	Negative
ACCTGTCGTGACCTGC	Negative
ACGATCAAGCTGTCCG	Hashtag5
ACGATCAAGGGAGTTC	Negative
ACGATCAAGTCAGCCC	Hashtag5
ACGATCACAGAGTTGG	Hashtag7
ACGATCACATGGGCAA	Negative
ACGATCAGTACTGAGG	Negative
ACGATCATCTGCGGGT	Negative
ACGATGTAGTGGTTCT	Hashtag5_Hashtag7
ACGATGTCAACTGTGT	Hashtag7
ACGATGTGTACTGCCG	Hashtag5
ACGATGTGTAGCGTAG	Hashtag7
ACGATGTGTCCTGAAT	Hashtag5
ACGATGTGTGGGATTG	Negative
ACGCACGAGGGAGTTC	Hashtag5
ACGCACGCAACACACT	Hashtag7
ACGCACGGTAACGATA	Hashtag5
ACGCACGGTCTGATCA	Hashtag5_Hashtag7
ACGCACGGTTGTGCCG	Negative
ACGCACGTCATCGGGC	Hashtag7
ACGCACGTCCCATTCG	Hashtag5_Hashtag7
ACGCACGTCCTGTTGC	Hashtag7
ACGCACGTCTTCGATT	Hashtag5
ACGCACGTCTTCGGAA	Negative
ACGGAAGAGAAGCTCG	Negative
ACGGAAGAGGCTAACG	Hashtag5
ACGGAAGCATGGATCT	Negative
ACGGAAGGTCTTCGAA	Hashtag5
ACGGAAGGTGTCGATT	Hashtag5
ACGGAAGTCCAAGGGA	Hashtag5_Hashtag7
ACGGAAGTCCGGGACT	Hashtag7
ACGGAAGTCCTCAGGG	Hashtag5
ACGGGTCAGAAACTCA	Negative
ACGGGTCAGACGACGT	Hashtag7
ACGGGTCCAATAAGGT	Hashtag7
ACGGGTCCAGACCATT	Negative
ACGGGTCGTAGGGAGG	Hashtag7
ACGGTCGAGGTAGGCT	Hashtag5_Hashtag7
ACGGTCGCAAGGCTTT	Hashtag5
ACGGTCGCAATTGCCA	Hashtag5
ACGGTCGCATACTTTC	Hashtag5
ACGGTCGGTAGAAACT	Hashtag5_Hashtag7
ACGGTCGGTCAAGGCA	Hashtag5
ACGGTCGGTGTGGACA	Hashtag5
ACGGTCGTCACTTCTA	Hashtag7
ACGGTCGTCCATTGGA	Hashtag7
ACGGTCGTCGGCTTGG	Hashtag5_Hashtag7
ACGGTTAAGAACAAGG	Negative
ACGGTTACACCGGCTA	Hashtag5_Hashtag7
ACGGTTAGTCCACATA	Hashtag7
ACGGTTAGTCTCGGAC	Negative
ACGGTTATCACAAGGG	Hashtag5
ACGGTTATCCGCTTAC	Hashtag5
ACGTAACCAGAGGTTG	Hashtag5_Hashtag7
ACGTAACCATCTGGGC	Negative
ACGTAACGTCCGGATC	Negative
ACGTAACGTCGAGCAA	Hashtag5
ACGTAACGTCGGTAAG	Hashtag5
ACGTAACGTGGGCTCT	Hashtag5_Hashtag7
ACGTAACGTTCATCGA	Negative
ACGTAACTCCACTGAA	Hashtag5
ACGTAACTCGGATACT	Hashtag5
ACGTACAAGAAGAACG	Negative
ACGTACAAGGACAGCT	Negative
ACGTACACACAGAGCA	Hashtag5_Hashtag7
ACGTACACAGCCATTA	Hashtag5_Hashtag7
ACGTACAGTTTCCAAG	Hashtag7
ACGTAGTAGTCTACCA	Hashtag5
ACGTAGTCAACCGACC	Hashtag5
ACGTAGTCACCCTATC	Hashtag5
ACGTAGTGTAGTCACT	Negative
ACGTAGTGTGGCTACC	Hashtag5
ACGTCCTAGAAACTGT	Hashtag5
ACGTCCTAGGTATTGA	Hashtag5
ACGTCCTCAATGCTCA	Hashtag5
ACGTCCTCAGTCTCTC	Hashtag7
ACGTCCTCAGTTGAAA	Negative
ACGTCCTTCCACGTCT	Hashtag5
ACGTCCTTCGGCTTCT	Hashtag7
ACGTTCCAGGGATGTC	Hashtag7
ACGTTCCCAAGTTCGT	Negative
ACGTTCCGTATGAGCG	Negative
ACGTTCCGTGCCGTTG	Hashtag5
ACGTTCCTCCGAGCTG	Negative
ACGTTCCTCTTAGGAC	Hashtag7
ACTACGAAGACATAAC	Hashtag5_Hashtag7
ACTACGAAGCTCTATG	Hashtag5
ACTACGAAGTAGGATT	Hashtag5_Hashtag7
ACTACGAGTACGAGTG	Hashtag5
ACTACGAGTAGTGTGG	Hashtag7
ACTACGAGTGCAGTGA	Hashtag5
ACTACGATCATGAGTC	Negative
ACTATCTAGATGACAT	Hashtag5
ACTATCTAGGCCTGCT	Hashtag5
ACTATCTAGTGTTGTC	Hashtag5
ACTATCTGTCTCCTGT	Negative
ACTATCTGTCTTCATT	Hashtag5
ACTATCTGTGACGCCT	Hashtag5
ACTATCTTCAGGAGAC	Negative
ACTATGGAGAGCACTG	Hashtag5
ACTATGGCATACAGGG	Negative
ACTATGGCATCACGGC	Hashtag5
ACTATGGGTATCGTAC	Hashtag5
ACTATGGGTGGGCTTC	Hashtag5
ACTATGGTCTAACGGT	Negative
ACTATGGTCTAGCCAA	Hashtag5_Hashtag7
ACTATTCAGACCAAAT	Hashtag5_Hashtag7
ACTATTCAGTCATACC	Hashtag5_Hashtag7
ACTATTCCAGACAATA	Hashtag5
ACTATTCCATTGACTG	Hashtag7
ACTATTCGTAGCTAAA	Hashtag5
ACTCCCAAGCCTCTCT	Hashtag7
ACTCCCAAGGGACACT	Hashtag7
ACTCCCAAGGTTGCCC	Hashtag5
ACTCCCATCTGCGGGT	Negative
ACTCCCATCTGGCCAG	Hashtag5_Hashtag7
ACTCCCATCTTAGCCC	Negative
ACTCTCGAGTTGCTCA	Hashtag5_Hashtag7
ACTCTCGAGTTGGCTT	Negative
ACTCTCGCAAGAGTTA	Hashtag5
ACTCTCGGTACCGGCT	Hashtag5_Hashtag7
ACTCTCGGTTCCCAAA	Negative
ACTCTCGTCGAGGCAA	Negative
ACTCTCGTCTGAATGC	Hashtag5
ACTGATGTCATTTGGG	Hashtag5_Hashtag7
ACTGATGTCCGTTGAA	Negative
ACTGCAAAGCCACCGT	Negative
ACTGCAAGTTTCGTAG	Hashtag7
ACTGCAAGTTTGTTCT	Negative
ACTGCAATCGCACGAC	Negative
ACTGTCCAGTTGGCGA	Hashtag5
ACTGTCCAGTTGGCTT	Hashtag5
ACTGTCCCACGATAGG	Hashtag5_Hashtag7
ACTGTCCGTATCGTGT	Negative
ACTGTCCGTTAAACCC	Negative
ACTGTCCTCGAATGCT	Hashtag5
ACTGTGAAGATGACCG	Negative
ACTGTGAAGATTGAGT	Hashtag5
ACTGTGACAAACAGGC	Hashtag5
ACTGTGAGTCCGAAGA	Hashtag5
ACTGTGAGTGCCCAGT	Hashtag5
ACTGTGATCCGTAATG	Negative
ACTTAGGAGAAAGTCT	Hashtag5
ACTTAGGAGAAGAGCA	Negative
ACTTAGGCAAGCCTGC	Negative
ACTTAGGCATTGTGCA	Negative
ACTTAGGGTAATGCGG	Negative
ACTTAGGTCGACCATA	Negative
ACTTATCAGAAACACT	Hashtag5_Hashtag7
ACTTATCAGGCGAACT	Negative
ACTTATCCAACCAGAG	Negative
ACTTATCTCGTACCTC	Hashtag7
ACTTATCTCTAGCCTC	Hashtag7
ACTTCCGAGTACTCGT	Hashtag5
ACTTCCGGTACCACGC	Hashtag5
ACTTCCGGTCGTGTTA	Negative
ACTTCCGTCCGTATGA	Hashtag5
ACTTCGCAGCCTCTTC	Hashtag5_Hashtag7
ACTTCGCAGGTCCCGT	Negative
ACTTCGCCAAGTGGAC	Hashtag5
ACTTCGCCAGTTGTTG	Hashtag5_Hashtag7
ACTTCGCGTATGAAAC	Hashtag7
ACTTTCAAGTGGTGGT	Negative
ACTTTCACACATATGC	Negative
ACTTTCACAGATTAAG	Hashtag5
ACTTTCACATACTGTG	Negative
ACTTTCAGTACCCACG	Hashtag5_Hashtag7
ACTTTCAGTCGCTCGA	Negative
ACTTTCAGTTGGGTAG	Hashtag5
ACTTTCATCAATCCGA	Hashtag5_Hashtag7
ACTTTGTAGGAACTCG	Hashtag5_Hashtag7
ACTTTGTCAGAGAATT	Negative
ACTTTGTGTGGATGAC	Negative
ACTTTGTGTGTGTGTT	Hashtag5
ACTTTGTTCACATCAG	Negative
AGAAATGAGCACCCAC	Hashtag5_Hashtag7
AGAAATGCAAATGGAT	Negative
AGAAATGCAGAGATTA	Negative
AGAAATGCAGGAGACT	Hashtag7
AGAAATGCATGGTACT	Hashtag5
AGAAATGGTACCAATC	Hashtag5
AGAAATGGTGACACAG	Hashtag7
AGAAATGTCCGCCTAT	Negative
AGAAATGTCCGCGATG	Hashtag5
AGAACAAAGAGGCTGT	Hashtag5_Hashtag7
AGAACAATCTGAGTCA	Negative
AGAACCTAGACTCCGC	Hashtag5
AGAACCTAGCTTTCCC	Hashtag5_Hashtag7
AGAACCTAGGGTACAC	Hashtag5_Hashtag7
AGAACCTCACTATCCC	Hashtag7
AGAACCTCATTGAAGA	Hashtag5_Hashtag7
AGAACCTGTGTTCAGT	Hashtag5
AGAAGCGAGAATCTAG	Hashtag5
AGAAGCGCAGGCACTC	Negative
AGAAGCGCAGTCGAGA	Hashtag5_Hashtag7
AGAAGCGTCGGTGTTA	Hashtag5
AGAAGTAAGGTAGGCT	Hashtag7
AGAAGTACATTGAAAG	Hashtag7
AGACAAACAGACCTAT	Hashtag7
AGACAAACAGAGGTAC	Negative
AGACAAAGTCTCGGAC	Negative
AGACAAATCAAATAGG	Negative
AGACAAATCGCCAATA	Negative
AGACACTAGTCCTGTA	Hashtag5
AGACACTCAAAGAGTT	Hashtag5
AGACACTCACAGCTGC	Negative
AGACACTGTACGATCT	Hashtag5
AGACACTTCCAAGCCG	Hashtag5_Hashtag7
AGACACTTCGGCTGAC	Hashtag5
AGACAGGAGGGCTAAC	Hashtag7
AGACAGGTCCGTAATG	Hashtag5
AGACAGGTCGCGGACT	Hashtag5
AGACCATAGATAGTCA	Hashtag5
AGACCATCACAAGCCC	Hashtag5
AGACCATGTATTCCGA	Negative
AGACCATGTCAGTCTA	Negative
AGACCATGTCCTTTGC	Hashtag5_Hashtag7
AGACCATGTGCAAGAC	Hashtag5
AGACCCGAGACAACTA	Hashtag5
AGACCCGAGAGTGTTA	Hashtag7
AGACCCGTCGGCCAAC	Hashtag5_Hashtag7
AGACCCGTCTAGCATG	Hashtag5
AGACTCAAGAACAGGA	Negative
AGACTCAAGAGCCATG	Negative
AGACTCAAGAGGCGTT	Hashtag5
AGACTCAAGTAGTCAA	Hashtag5
AGACTCACAGCGTAGA	Hashtag7
AGACTCACATGGGTCC	Hashtag7
AGACTCAGTCAGGAGT	Negative
AGAGAATAGAAACTGT	Hashtag5
AGAGAATCATTCAGGT	Hashtag5_Hashtag7
AGAGAGCAGGCAGTCA	Hashtag7
AGAGAGCCATAACCCA	Hashtag7
AGAGAGCGTGTTTCTT	Hashtag5_Hashtag7
AGAGAGCTCAGAATAG	Hashtag5
AGAGAGCTCCATTTAC	Negative
AGAGAGCTCGCTTTAT	Hashtag5_Hashtag7
AGAGAGCTCTATCACT	Negative
AGAGCAGAGCACGTCC	Negative
AGAGCAGAGGTGCTAG	Hashtag7
AGAGCAGAGTCACTGT	Hashtag5
AGAGCAGCAAACGTGG	Hashtag5
AGAGCAGCAAAGGCAC	Hashtag5
AGAGCAGCAGCTACTA	Hashtag7
AGAGCAGGTAGTATAG	Hashtag7
AGAGCCCAGAGCTGCA	Hashtag7
AGAGCCCAGATAGCTA	Hashtag5
AGAGCCCAGCCTCAAT	Hashtag7
AGAGCCCAGGTGCTTT	Hashtag7
AGAGCCCAGTGGAAAG	Hashtag5_Hashtag7
AGAGCCCCACTCTGCT	Negative
AGAGCCCTCTTAAGGC	Hashtag5
AGAGCCCTCTTGTGCC	Hashtag5
AGATAGAAGTTCCGGC	Hashtag5
AGATAGACAACACACT	Hashtag7
AGATAGAGTCACGCTG	Hashtag5
AGATCCAAGACTGTTC	Negative
AGATCCAAGCTGACTT	Hashtag5
AGATCCAAGTACAGAT	Negative
AGATCCACAACTGCTA	Hashtag7
AGATCCACACCTAAAC	Hashtag5
AGATCCACAGCTACTA	Hashtag5
AGATCGTAGACGCCAA	Hashtag5_Hashtag7
AGATCGTAGTTCCTGA	Negative
AGATCGTCAAGAGGTC	Hashtag5_Hashtag7
AGATGAAAGATTCGCT	Hashtag7
AGATGAAAGCTTTCCC	Hashtag5_Hashtag7
AGATGAACAGCCGTTG	Hashtag5
AGATGAAGTGCTGCAC	Hashtag5
AGATGAAGTTTAAGGA	Negative
AGATGAATCAGTCTTT	Hashtag7
AGATGCTAGGCGCTCT	Negative
AGATGCTGTAGTCGTT	Hashtag7
AGATGCTGTGTCCCTT	Negative
AGATGCTGTTAAAGTG	Hashtag7
AGATGCTTCAGGTGTT	Negative
AGATGCTTCGAGGCAA	Negative
AGATGCTTCTCTGCCA	Negative
AGCATCACAATGGCAG	Negative
AGCATCACACGACGTC	Hashtag5_Hashtag7
AGCATCAGTCTCGACG	Hashtag5
AGCATCAGTGTCGATT	Hashtag7
AGCCAATAGCTCCATA	Hashtag7
AGCCAATAGGAACTAT	Negative
AGCCAATTCCTCACTG	Hashtag5
AGCCAATTCTACGGTA	Hashtag5
AGCCACGAGGTTTGAA	Hashtag5
AGCCACGCACCCATAA	Hashtag5
AGCCACGCATTCAGGT	Hashtag5_Hashtag7
AGCCACGGTCTAGTGT	Hashtag5
AGCCACGTCGGAATGG	Hashtag7
AGCCAGCAGAAACTAC	Negative
AGCCAGCCATCCGTGG	Hashtag7
AGCCAGCGTGCACATT	Negative
AGCCAGCTCATCTATC	Negative
AGCCAGCTCTCCATAT	Negative
AGCGATTAGCCGCACT	Negative
AGCGATTCATGCACTA	Negative
AGCGATTGTCTTACTT	Hashtag5
AGCGATTGTGACTGAG	Hashtag5
AGCGATTGTTTACCAG	Negative
AGCGATTTCTCCTGAC	Negative
AGCGCCAAGTGAGTTA	Hashtag5
AGCGCCATCCCGTTCA	Hashtag5
AGCGCTGAGTCGGCAA	Hashtag5
AGCGCTGCAAAGGATT	Hashtag5
AGCGCTGCAGCTTCGG	Hashtag7
AGCGCTGGTACTCGCG	Hashtag5
AGCGCTGTCGATGGAG	Hashtag5
AGCGCTGTCTCTCGAC	Negative
AGCGTATCAATCAGCT	Hashtag5
AGCGTATGTGCAAGAC	Hashtag5_Hashtag7
AGCGTCGGTCCACAGC	Negative
AGCGTCGGTGACTGAG	Negative
AGCTACAAGTACTCGT	Negative
AGCTACAGTCGATTCA	Hashtag7
AGCTACAGTGACTATC	Hashtag7
AGCTACAGTTAGGCCC	Negative
AGCTCAAAGGGTCACA	Hashtag7
AGCTCAAAGGTGCCTC	Negative
AGCTCAATCGATACGT	Negative
AGCTTCCAGATGCTTC	Hashtag5
AGCTTCCAGTGGTTCT	Negative
AGCTTCCCAACCGCCA	Hashtag5_Hashtag7
AGCTTCCCATTCCTCG	Hashtag5
AGCTTCCCATTCTCCG	Hashtag5
AGCTTCCTCAAGTCTG	Hashtag5_Hashtag7
AGCTTCCTCGCTACGG	Hashtag7
AGGAAATCAGTTGTTG	Hashtag7
AGGAAATGTTAGGAGC	Hashtag5_Hashtag7
AGGAAATTCGAGAGAC	Negative
AGGAAATTCTAGCCTC	Negative
AGGAATACACCAAAGG	Negative
AGGAATACATTCTCCG	Negative
AGGAATATCATAGACC	Hashtag5
AGGAATATCTTTCCGG	Hashtag7
AGGACGAAGAGACAAG	Hashtag5_Hashtag7
AGGACGAAGATGGGCT	Hashtag5_Hashtag7
AGGACGAAGCTTTGTG	Hashtag5
AGGACGACACTTACAG	Hashtag5
AGGACGACAGTGTATC	Hashtag7
AGGACGAGTAACTTCG	Hashtag5
AGGACGAGTCGCATTA	Negative
AGGACGATCAATCCAG	Hashtag5
AGGACTTAGAAAGTCT	Hashtag5
AGGACTTAGTAGACAT	Hashtag5_Hashtag7
AGGACTTCACGTAGAG	Negative
AGGACTTCACTGTGTA	Hashtag5_Hashtag7
AGGACTTCAGTGGTGA	Negative
AGGACTTTCCATGCAA	Negative
AGGACTTTCGGCGATC	Hashtag5
AGGAGGTCAAATGAGT	Hashtag5
AGGAGGTCACTTGAGT	Hashtag5_Hashtag7
AGGAGGTCATCATCTT	Negative
AGGAGGTGTACGATTC	Hashtag5_Hashtag7
AGGAGGTGTGTAGCAG	Hashtag5_Hashtag7
AGGAGGTGTTGGTACT	Hashtag7
AGGAGGTTCCTGGGAC	Negative
AGGATAACATTCATCT	Hashtag7
AGGATAAGTGTCCGTG	Hashtag5
AGGATAATCATTCCTA	Hashtag7
AGGATAATCTAAACGC	Hashtag5
AGGATAATCTAGGCAT	Hashtag7
AGGATCTAGGTATCTC	Negative
AGGATCTCACAAAGCG	Hashtag5
AGGATCTGTCGTGGTC	Negative
AGGCATTAGGAATCGC	Negative
AGGCATTGTACTTCCC	Hashtag5_Hashtag7
AGGCATTGTATAGGGC	Hashtag5
AGGCATTGTCGATTCA	Hashtag5
AGGCATTTCGAACCTA	Hashtag7
AGGCCACAGCACGATG	Negative
AGGCCACAGCCAGACA	Hashtag5_Hashtag7
AGGCCACCAAACGAGC	Negative
AGGCCACCAATACCTG	Hashtag7
AGGCCACCAGACCCGT	Hashtag5
AGGCCACCATTGCTTT	Hashtag5_Hashtag7
AGGCCACGTATCAAGA	Hashtag5_Hashtag7
AGGCCACGTCACCTTC	Hashtag7
AGGCCACGTCGAATGG	Negative
AGGCCACGTGTTCAGT	Hashtag5
AGGCCACGTTGCTTGA	Hashtag5_Hashtag7
AGGCTGCAGCACCGTC	Negative
AGGCTGCAGGTACATA	Hashtag5
AGGCTGCGTACCATAC	Negative
AGGCTGCGTCATGCAT	Negative
AGGCTGCGTCCGGACT	Hashtag7
AGGCTGCGTCGCATGC	Hashtag5
AGGGAGTAGCGCGTTC	Negative
AGGGAGTAGGCATCTT	Hashtag5_Hashtag7
AGGGAGTAGTGCACAG	Hashtag5
AGGGAGTCATGACGAG	Hashtag5
AGGGAGTGTACGAGTG	Hashtag5_Hashtag7
AGGGAGTTCATGCCGG	Hashtag5
AGGGAGTTCTCAGGCG	Hashtag5
AGGGCCTGTACGACAG	Hashtag5_Hashtag7
AGGGCCTGTAGCGAGT	Hashtag5_Hashtag7
AGGGCCTGTTACCGTA	Hashtag5
AGGGCTCCAGCGTTTA	Hashtag7
AGGGCTCCAGGCCCTA	Hashtag5
AGGGCTCGTCCTGGGT	Hashtag5
AGGGCTCGTGCAACAG	Hashtag7
AGGGCTCGTTGACTGT	Hashtag5_Hashtag7
AGGGCTCTCGGTGTAT	Negative
AGGGTCCCAGTAGTTC	Negative
AGGGTCCTCTTTGATC	Negative
AGGGTGAAGGAGTATT	Negative
AGGGTGACACGCCACA	Hashtag5
AGGGTGAGTAAGCAAT	Hashtag5_Hashtag7
AGGGTGAGTATGTCCA	Hashtag5
AGGGTGATCGCCAGTG	Hashtag5
AGGGTTTTCAAAGGTA	Hashtag5
AGGGTTTTCCACCCTA	Hashtag7
AGGGTTTTCCAGCACG	Negative
AGGTAGGAGTTTCTTC	Hashtag7
AGGTAGGCAAGCCCAC	Hashtag5_Hashtag7
AGGTAGGGTAGATCGG	Hashtag5_Hashtag7
AGGTAGGGTATCGGTT	Negative
AGGTCATAGATAGTCA	Hashtag7
AGGTCATAGGCACCAA	Hashtag7
AGGTCTAAGTTTGCTG	Negative
AGGTCTACAAATTAGG	Negative
AGGTCTACAAGACCTT	Hashtag5
AGGTCTACACTGGAAG	Hashtag7
AGGTCTACATTCACCC	Negative
AGGTCTAGTCCTCATC	Hashtag7
AGGTCTAGTCTCGGAC	Hashtag7
AGGTCTATCCCTCGAT	Hashtag5
AGGTGTTAGGTTTACC	Hashtag5
AGGTGTTGTTCCACAA	Negative
AGGTGTTTCCGACAGC	Negative
AGGTGTTTCGACGAGA	Negative
AGGTTACAGAAATTCG	Hashtag5
AGGTTACCATGTTACG	Hashtag7
AGGTTACGTGCGGTAA	Hashtag7
AGGTTACTCCCAGGAC	Hashtag5
AGGTTACTCGTGGCGT	Negative
AGGTTACTCGTTCAGA	Negative
AGGTTGTAGAAGGCTC	Hashtag5
AGGTTGTCAAGACGAC	Negative
AGGTTGTCAATTTCGG	Negative
AGGTTGTCACCATTCC	Negative
AGGTTGTGTACGACTT	Hashtag5
AGGTTGTGTGTACATC	Hashtag5_Hashtag7
AGGTTGTTCTCGGTAA	Negative
AGTAACCAGGTAAGAG	Hashtag7
AGTAACCCATGTTACG	Hashtag5_Hashtag7
AGTAACCGTACGAGCA	Hashtag7
AGTAACCGTAGTCGTT	Negative
AGTAACCGTTATCTGG	Negative
AGTAACCGTTGGGACA	Hashtag5_Hashtag7
AGTACCACATGTAACC	Hashtag5_Hashtag7
AGTACCAGTAGTCGTT	Hashtag7
AGTACCATCCAACCAA	Hashtag5_Hashtag7
AGTACCATCGACATAC	Negative
AGTACCATCGCTCTAC	Hashtag5_Hashtag7
AGTACTGAGATACCAA	Hashtag5_Hashtag7
AGTACTGAGTAGCTCT	Hashtag5_Hashtag7
AGTACTGAGTGGTTCT	Negative
AGTACTGCAAGACGAC	Hashtag5_Hashtag7
AGTACTGCAATCGCGC	Hashtag7
AGTAGCTAGAGCAGTC	Negative
AGTAGCTAGAGGTGCT	Negative
AGTAGCTAGGGTGGGA	Negative
AGTAGCTAGTAACCTC	Hashtag5_Hashtag7
AGTAGCTCAACTGATC	Hashtag5
AGTAGCTCAAGCTCTA	Hashtag5_Hashtag7
AGTAGCTCAATAACGA	Hashtag5
AGTAGCTCACAGAGAC	Hashtag5
AGTAGCTCAGGCTCTG	Hashtag5
AGTAGCTGTTATCTGG	Hashtag5
AGTAGCTGTTGTCTAG	Negative
AGTAGTCAGACTCCGC	Negative
AGTAGTCCATGAGATA	Hashtag7
AGTAGTCGTTGCAACT	Hashtag5_Hashtag7
AGTAGTCTCGCGGACT	Negative
AGTAGTCTCGTAACTG	Hashtag5
AGTCAACAGACATATG	Hashtag5_Hashtag7
AGTCAACAGCGACCCT	Hashtag7
AGTCAACAGCGACTAG	Negative
AGTCAACAGGCTCCCA	Negative
AGTCAACCACTGTTCC	Hashtag7
AGTCACAAGAGATCGC	Negative
AGTCACACAGTCGGAA	Negative
AGTCACATCAGGGATG	Hashtag5
AGTCATGAGGCAGGTT	Negative
AGTCATGCACGCTGTG	Hashtag5
AGTCATGGTGAGATAT	Hashtag7
AGTCATGTCTTCTTCC	Hashtag5_Hashtag7
AGTCTCCCAAAGAACT	Hashtag5_Hashtag7
AGTCTCCCAGAAGCGT	Hashtag5_Hashtag7
AGTCTCCGTACAGGTG	Negative
AGTCTCCGTATCCTCC	Negative
AGTCTCCGTGCACATT	Negative
AGTCTCCTCCCAGGCA	Negative
AGTCTCCTCTGCTTAT	Hashtag7
AGTGACTAGACGGAAA	Hashtag5
AGTGACTCACATACTG	Hashtag5
AGTGACTCACCGAATT	Hashtag5_Hashtag7
AGTGACTCACTTGGCG	Negative
AGTGACTCAGTGGGTA	Hashtag5
AGTGACTGTCCCTCAT	Hashtag5_Hashtag7
AGTGATCCATATACCG	Negative
AGTGATCTCCGAGGCT	Negative
AGTGCCGAGATGAATC	Hashtag5
AGTGCCGAGGATACGC	Hashtag5
AGTGCCGCAATCGCCG	Hashtag5
AGTGCCGCACTCTAGA	Negative
AGTGCCGCACTGGCGT	Hashtag7
AGTGCCGCAGTCGCAC	Hashtag5
AGTGCCGGTATTCCGA	Hashtag5
AGTGCCGGTCCTTTGC	Hashtag7
AGTGCCGGTCTTCTAT	Negative
AGTGCCGGTCTTGTCC	Hashtag5_Hashtag7
AGTGCCGTCCCTGTTG	Negative
AGTGTTGAGCTGAAGC	Hashtag5
AGTGTTGCATCTTCGC	Hashtag5
AGTGTTGGTGTCATTG	Negative
AGTGTTGGTTACGGAG	Hashtag5
AGTGTTGGTTCGGACC	Hashtag5
AGTTAGCAGCTTTCCC	Hashtag5_Hashtag7
AGTTAGCGTAGGTTTC	Hashtag5
AGTTAGCTCACGGGCT	Negative
AGTTAGCTCGGCCCAA	Negative
AGTTAGCTCGGTGTAT	Hashtag7
AGTTCCCAGACCGTTT	Negative
AGTTCCCAGATTAGCA	Hashtag5
AGTTCCCGTCCAGCCA	Negative
AGTTCCCGTGCAACGA	Hashtag7
AGTTCCCGTTCGTACA	Hashtag5
AGTTCCCTCCATCAGA	Hashtag5
AGTTCCCTCGATAACC	Negative
AGTTCCCTCTGACCCT	Hashtag5
AGTTCGAAGAGGTATT	Hashtag5_Hashtag7
AGTTCGAAGGATATAC	Hashtag5
AGTTCGAAGGCATGCA	Hashtag7
AGTTCGAAGGCCCAAA	Hashtag7
AGTTCGAGTACTCCGG	Negative
AGTTCGAGTATGCTTG	Negative
AGTTCGAGTTGCCATA	Hashtag5
AGTTCGATCACCACAA	Hashtag7
AGTTCGATCTACGCGG	Hashtag5
ATACCGAAGGCATTTC	Negative
ATACCGACAACAGATA	Hashtag5
ATACCGACAGTCTACA	Hashtag5
ATACCGAGTACGGTTT	Hashtag5_Hashtag7
ATACCGAGTAGTGCGA	Hashtag7
ATACCGAGTTGCTTGA	Hashtag5_Hashtag7
ATACCGATCCTATGGA	Hashtag7
ATACCGATCGCTACGG	Hashtag5
ATACCGATCTGTACAG	Negative
ATACCTTAGACACACG	Negative
ATACCTTCACCAGTAT	Hashtag7
ATACCTTGTACCTAAC	Negative
ATACCTTGTTTACCAG	Hashtag7
ATACTTCAGAGTCAGC	Hashtag7
ATACTTCAGGCGTCCT	Negative
ATACTTCCACGTGTGC	Hashtag5
ATACTTCTCACGACTA	Hashtag5
ATACTTCTCGTAGTGT	Hashtag5
ATAGACCCAAAGTATG	Hashtag7
ATAGACCGTACCGCGT	Hashtag5
ATAGACCGTCGGCACT	Negative
ATAGACCTCCTTCACG	Negative
ATAGACCTCGATGCTA	Hashtag5
ATAGACCTCTCTCTTC	Hashtag7
ATAGAGAAGCCTCAAT	Hashtag5
ATAGAGAAGGGATCTG	Hashtag7
ATAGAGAAGTTGTAGA	Hashtag7
ATAGAGACACGACGTC	Hashtag5
ATAGAGACATCCGATA	Hashtag5
ATAGAGAGTATGCTAC	Hashtag7
ATAGAGAGTCTTGAAC	Negative
ATAGAGATCGCGGACT	Negative
ATAGAGATCTACAGGT	Negative
ATAGGCTAGGCAGGGA	Negative
ATAGGCTAGTATGTAG	Hashtag5_Hashtag7
ATAGGCTAGTTCGGTT	Negative
ATAGGCTTCGGTTCAA	Hashtag5
ATAGGCTTCTAAGCGT	Negative
ATAGGCTTCTAGGCAT	Hashtag5
ATATCCTAGAGAATCT	Negative
ATATCCTAGCCGTAAG	Negative
ATATCCTCAAATCAGA	Hashtag7
ATATCCTGTGTTCCAA	Hashtag5
ATATCCTTCCAACTGA	Hashtag5_Hashtag7
ATATCCTTCGTTCTCG	Negative
ATCACAGGTAGCGTTT	Hashtag5
ATCACAGGTTTCGCTC	Hashtag5_Hashtag7
ATCACAGTCGAAGGAC	Hashtag5
ATCACAGTCTCTTCAA	Hashtag5_Hashtag7
ATCACGAAGAGTGTTA	Hashtag7
ATCACGAAGCCAAGGT	Negative
ATCACGACAGAACTAA	Hashtag5_Hashtag7
ATCACGACATCCTATT	Hashtag7
ATCACGATCCTTACCG	Hashtag7
ATCACGATCGCACGGT	Hashtag5
ATCACTTAGACTTGTC	Negative
ATCACTTAGCGTTAGG	Hashtag7
ATCACTTAGTATTCCG	Hashtag5_Hashtag7
ATCACTTCAGAAGTGC	Hashtag5
ATCACTTGTGGAAATT	Hashtag5_Hashtag7
ATCACTTGTGTTAGCT	Hashtag5_Hashtag7
ATCAGGTAGGAACGAA	Negative
ATCAGGTCACTGGCCA	Hashtag5_Hashtag7
ATCAGGTGTGGCCACT	Hashtag7
ATCAGGTTCTCGTGAA	Negative
ATCATTCAGTGCCCGT	Negative
ATCATTCCACTTCCTG	Hashtag5_Hashtag7
ATCATTCCATGACGAG	Hashtag7
ATCATTCGTAGGAGGG	Negative
ATCATTCGTCTGTGCG	Hashtag5_Hashtag7
ATCATTCGTGCTCCGA	Hashtag7
ATCATTCGTTGATCGT	Hashtag5
ATCATTCTCATACGAC	Negative
ATCATTCTCATGGCCG	Negative
ATCATTCTCTGGTGCG	Hashtag7
ATCCACCAGGAGATAG	Hashtag5_Hashtag7
ATCCACCGTGATATAG	Hashtag5_Hashtag7
ATCCACCGTTGATGTC	Hashtag7
ATCCACCTCAACGTGT	Negative
ATCCACCTCGCGTAGC	Hashtag5_Hashtag7
ATCCATTAGAGGATCC	Hashtag5_Hashtag7
ATCCATTAGTGATCGG	Hashtag5_Hashtag7
ATCCATTGTAGTGTGG	Hashtag5
ATCCATTTCGACGCTG	Hashtag7
ATCCCTGAGCGGGTTA	Negative
ATCCCTGTCGTTATCT	Negative
ATCCCTGTCTCTCGCA	Negative
ATCCGTCAGGTTCACT	Negative
ATCCGTCAGTTGCTGT	Negative
ATCCGTCCACTCACTC	Hashtag5
ATCCGTCTCAAACTGC	Hashtag7
ATCCGTCTCACTGATG	Hashtag5
ATCCTATGTTGAGTCT	Hashtag5
ATCCTATGTTGTATGC	Negative
ATCCTATTCCTCACTG	Hashtag7
ATCGATGAGCCTGTGC	Hashtag7
ATCGATGAGGACATCG	Negative
ATCGATGGTCTGCATA	Hashtag5
ATCGATGTCATCGTAG	Hashtag5_Hashtag7
ATCGATGTCATTTCCA	Hashtag7
ATCGATGTCGTCGGGT	Hashtag5_Hashtag7
ATCGCCTAGGATTCCT	Negative
ATCGCCTAGGGTATAT	Hashtag7
ATCGCCTAGTTCTACG	Negative
ATCGCCTGTCAACACT	Hashtag5
ATCGCCTGTCGACTGC	Hashtag5
ATCGCCTTCTTTGATC	Hashtag5_Hashtag7
ATCGGATAGCCTCTTC	Hashtag7
ATCGGATCAATACCTG	Hashtag7
ATCGGATTCACCCTTG	Hashtag5_Hashtag7
ATCGGATTCCTATGGA	Hashtag5_Hashtag7
ATCGGCGAGCCTTCTC	Hashtag5_Hashtag7
ATCGGCGAGTAACCTC	Hashtag5_Hashtag7
ATCGGCGGTAACAAGT	Hashtag5_Hashtag7
ATCGGCGTCACTTGGA	Hashtag5
ATCGGCGTCGACATCA	Hashtag5_Hashtag7
ATCGGCGTCTCCTGAC	Hashtag5_Hashtag7
ATCGTAGAGACTTAAG	Hashtag5
ATCGTAGCAATGCAGG	Hashtag5
ATCGTAGGTAGACTGG	Hashtag5
ATCGTAGGTAGGGTAC	Hashtag5_Hashtag7
ATCGTAGGTGATACCT	Negative
ATCGTCCAGCGCTGAA	Negative
ATCGTCCCACCCTAGG	Hashtag5
ATCGTCCCATCCTTGC	Hashtag5
ATCGTCCTCCAATCTT	Hashtag5
ATCGTGAAGGAGTATT	Hashtag7
ATCTCTAAGACATGCG	Hashtag7
ATCTCTAAGAGTCTTC	Hashtag5
ATCTCTAAGCTGTTCA	Hashtag7
ATCTCTAAGGAGACCT	Negative
ATCTCTAGTGCCGAAA	Hashtag5
ATCTCTAGTTTAGTCG	Hashtag7
ATCTCTATCAAGGAGC	Negative
ATCTCTATCGTTGTTT	Negative
ATCTTCAAGGGAGGGT	Negative
ATCTTCAAGTGGTGAC	Hashtag5
ATCTTCACAATTGAGA	Negative
ATCTTCACAGCAGGAT	Hashtag5_Hashtag7
ATCTTCAGTAACATAG	Hashtag5
ATCTTCAGTACTCCGG	Hashtag5
ATCTTCAGTCAAGCGA	Hashtag7
ATCTTCAGTCCGGACT	Hashtag5_Hashtag7
ATCTTCAGTCGCATGC	Negative
ATGAAAGAGAAGCGCT	Negative
ATGAAAGAGCCACAAG	Hashtag5_Hashtag7
ATGAAAGAGCCTTGAT	Hashtag5_Hashtag7
ATGAAAGCACCGTCTT	Hashtag5_Hashtag7
ATGAAAGCAGAGTGAC	Negative
ATGAAAGGTGTTACTG	Negative
ATGACCAAGACATGCG	Hashtag5_Hashtag7
ATGACCAAGGATGGCT	Negative
ATGACCACACAGTACT	Hashtag7
ATGACCACATCCGCGA	Hashtag7
ATGAGGGAGCACACAG	Negative
ATGAGGGAGGGTCACA	Hashtag5
ATGAGGGAGTATGAAC	Negative
ATGAGGGAGTCACTAC	Hashtag7
ATGAGGGCATGTGCCG	Hashtag5_Hashtag7
ATGAGGGGTTATCTGG	Negative
ATGAGGGTCGTCGATA	Negative
ATGAGGGTCGTTACCC	Hashtag5_Hashtag7
ATGAGTCCAGAGTCAG	Hashtag5
ATGAGTCCAGCGTTTA	Hashtag5
ATGAGTCTCTCAGTCC	Hashtag5
ATGAGTCTCTGAGCAT	Hashtag7
ATGATCGCAAGCTGCC	Hashtag5_Hashtag7
ATGATCGGTAGGGAGG	Hashtag5_Hashtag7
ATGATCGTCCGAAGGA	Hashtag5
ATGATCGTCCTGCCAT	Negative
ATGCATGCACCAGTTA	Hashtag5
ATGCATGCACGCTGAC	Hashtag5
ATGCATGCATTCCTCG	Hashtag7
ATGCATGTCGATACTG	Hashtag5
ATGCCTCAGACTCGAG	Hashtag5_Hashtag7
ATGCCTCAGAGAGCAA	Negative
ATGCCTCAGATTGACA	Hashtag7
ATGCCTCAGGAACGAA	Hashtag5_Hashtag7
ATGCCTCCAAGGTACG	Hashtag5_Hashtag7
ATGCCTCCAAGTATCC	Negative
ATGCCTCCACCCTAGG	Negative
ATGCCTCCACTCTGCT	Hashtag7
ATGCCTCCAGATTAAG	Hashtag5_Hashtag7
ATGCCTCGTACCTAAC	Hashtag7
ATGCCTCTCATGGGAG	Hashtag5
ATGCCTCTCTGTAAGC	Negative
ATGCGATAGTAGGTTA	Hashtag5_Hashtag7
ATGCGATCACGGTGAA	Negative
ATGCGATCATATGGCT	Hashtag7
ATGCGATGTAAGCAAT	Hashtag7
ATGCGATGTCTTGCGG	Negative
ATGCGATGTTGCACGC	Hashtag5_Hashtag7
ATGCGATGTTGGACTT	Hashtag7
ATGGAGGAGTTGTCGT	Hashtag5
ATGGAGGCAGCCTTCT	Hashtag7
ATGGAGGGTGCATCTA	Hashtag7
ATGGAGGGTGCTAGCC	Hashtag5
ATGGAGGTCTCAGGCG	Negative
ATGGATCAGACTCTTG	Hashtag7
ATGGATCAGCCTGGAA	Negative
ATGGATCCACAACCGC	Hashtag7
ATGGATCGTCTCACAA	Hashtag7
ATGGATCGTTGTATGC	Hashtag7
ATGGATCTCATTCGGA	Hashtag7
ATGGATCTCGAGTCTA	Hashtag5_Hashtag7
ATGGATCTCGCCTTTG	Hashtag7
ATGGGAGCAATACAGA	Hashtag5_Hashtag7
ATGGGAGCATGTGACT	Hashtag5
ATGGGAGTCGGTAAGG	Hashtag5_Hashtag7
ATGGGAGTCTAGCAAC	Hashtag5
ATGGGAGTCTTAGCCC	Hashtag7
ATGGGTTAGAAGAACG	Hashtag7
ATGGGTTAGGCACGAT	Hashtag5
ATGGGTTAGTGCAAAT	Negative
ATGGGTTCAAAGGCAC	Hashtag5
ATGGGTTCACGACGCT	Negative
ATGGGTTCACGTCTCT	Hashtag5_Hashtag7
ATGGGTTCAGACCATT	Hashtag5
ATGGGTTTCCAACCGG	Hashtag7
ATGGGTTTCGTTGCCT	Hashtag7
ATGGGTTTCTACAGGT	Hashtag5_Hashtag7
ATGGTTGAGATGCTAA	Negative
ATGGTTGGTTTGAACC	Hashtag5_Hashtag7
ATGGTTGTCAGTAGGG	Hashtag5
ATGGTTGTCATGAGGG	Negative
ATGGTTGTCATGCCCT	Hashtag5
ATGGTTGTCGACATTG	Hashtag5
ATGTCCCAGGCGATAC	Negative
ATGTCCCCATAGGTAA	Hashtag5
ATGTCCCGTATGAGCG	Hashtag7
ATGTCCCGTCAAAGAT	Negative
ATGTCCCGTCCAACGC	Negative
ATGTCCCGTCGGTGTC	Hashtag5
ATGTCCCGTCTGTGTA	Hashtag7
ATGTCCCGTGAAAGTT	Negative
ATGTCCCTCATTTACC	Hashtag7
ATGTCCCTCTACTATC	Negative
ATGTCTTAGCGGGTAT	Negative
ATGTCTTAGTCACTCA	Hashtag5
ATGTCTTCACCAGCCA	Hashtag5
ATGTCTTCACCCAACG	Hashtag5
ATGTCTTCAGGTCAAG	Hashtag5
ATGTCTTGTCTAGTGT	Hashtag5
ATGTCTTGTGGTCTAT	Hashtag7
ATGTCTTTCGCGTAGC	Hashtag5
ATTACCTAGCGTCAGA	Hashtag5_Hashtag7
ATTACCTAGTGGTGAC	Negative
ATTACCTGTGATATAG	Negative
ATTACCTGTGCAAGAC	Negative
ATTACCTTCAAGCGTT	Negative
ATTACCTTCGCTTACC	Hashtag7
ATTACTCAGACAACAT	Hashtag5
ATTACTCAGATGCCGA	Negative
ATTACTCCAAAGCGTG	Hashtag5_Hashtag7
ATTACTCCAGTCAACT	Hashtag5
ATTATCCAGTCAACAA	Hashtag7
ATTATCCGTGGAGAAA	Hashtag5_Hashtag7
ATTCACTAGAGTCAGC	Hashtag7
ATTCACTAGTTTCAGC	Hashtag5
ATTCACTCATCAGTCA	Hashtag5
ATTCACTGTAGGCTGA	Hashtag5
ATTCACTTCTCAGTCC	Hashtag7
ATTCACTTCTGCCTGT	Hashtag5
ATTCAGGCAAACTAGA	Negative
ATTCAGGCACACGGAA	Hashtag5_Hashtag7
ATTCAGGCAGCGTTGC	Hashtag5_Hashtag7
ATTCATCAGAAATGGG	Hashtag5_Hashtag7
ATTCATCAGGATACGC	Hashtag5
ATTCATCCAGAGATTA	Hashtag5_Hashtag7
ATTCATCCAGGTACGA	Negative
ATTCATCGTACACGCC	Hashtag7
ATTCATCGTCGCCACA	Negative
ATTCCATAGACCCGCT	Hashtag5_Hashtag7
ATTCCATAGGATGTTA	Negative
ATTCCATCAATTGTGC	Negative
ATTCCATGTCGCGTTG	Hashtag5
ATTCCATTCCTACAAG	Hashtag5
ATTCCCGAGAGGTTTA	Negative
ATTCCCGCAGTAGTTC	Negative
ATTCCCGGTATCTCTT	Hashtag5
ATTCCCGGTCGAAGCA	Hashtag5
ATTCCCGGTTGCTCCT	Hashtag5_Hashtag7
ATTCCCGGTTGGGATG	Negative
ATTCCCGTCCCATTCG	Hashtag5_Hashtag7
ATTCCTAAGCAATAGT	Hashtag7
ATTCCTAAGTAATCCC	Hashtag5
ATTCCTAAGTTTGCTG	Hashtag5
ATTCCTAGTGCTTCAA	Negative
ATTCCTAGTGGTATGG	Hashtag5_Hashtag7
ATTCCTATCGGTAGAG	Hashtag5
ATTCGTTCACAAATGA	Negative
ATTCGTTCAGTCTTCC	Hashtag7
ATTCGTTGTACAGTCT	Negative
ATTCTACAGGAGCAAA	Hashtag7
ATTCTACCAATGCAGG	Hashtag5_Hashtag7
ATTCTACCAGCGTATT	Hashtag7
ATTCTACCAGTCCCGA	Negative
ATTCTACGTCCGTTTC	Hashtag5
ATTCTACGTTGAGGAC	Hashtag5
ATTCTACTCAGGAGAC	Hashtag5
ATTCTACTCATCACAG	Hashtag5_Hashtag7
ATTCTACTCTTCCAGC	Hashtag5
ATTCTTGCAGTCGTTA	Hashtag5_Hashtag7
ATTCTTGTCATTCATC	Hashtag5_Hashtag7
ATTGGGTAGGATGGCT	Hashtag5
ATTGGGTGTAACAAGT	Hashtag5
ATTGGGTGTCCGGTCA	Negative
ATTGGGTGTGAATTAG	Hashtag5_Hashtag7
ATTGGGTTCTTTGCGC	Negative
ATTGTTCCACCGCTAG	Hashtag5
ATTGTTCCAGTTGAAA	Hashtag7
ATTGTTCCATCATGAC	Negative
ATTTACCAGAGGGCGA	Hashtag5
ATTTACCCACCAGCCA	Hashtag5
ATTTACCCAGTCTCTC	Negative
ATTTACCCATTGACTG	Negative
ATTTACCGTAATCAGA	Negative
ATTTACCGTCTGCCTT	Negative
ATTTACCGTCTTTCAT	Hashtag5
ATTTACCGTGGTAATA	Hashtag7
ATTTACCTCACGATAC	Hashtag5
ATTTACCTCGCAATTG	Hashtag7
ATTTCACAGGCACTAG	Negative
ATTTCACTCTAACGCA	Negative
ATTTCTGAGGACTATA	Hashtag5
ATTTCTGAGGGATCAC	Hashtag5
ATTTCTGAGGTGCTTT	Hashtag5
ATTTCTGAGTAGCTCT	Hashtag5_Hashtag7
ATTTCTGCAACTGATC	Hashtag5
ATTTCTGCAGCGCGTT	Hashtag7
ATTTCTGGTATAGCTC	Hashtag5
ATTTCTGGTCCTACGG	Negative
ATTTCTGTCACTGTCC	Hashtag7
ATTTCTGTCGCTGATA	Hashtag7
ATTTCTGTCTATGTGG	Hashtag5
ATTTCTGTCTGTGCAA	Hashtag5_Hashtag7
CAAAGAACAAACCACT	Hashtag5
CAAAGAAGTCTTCGAA	Hashtag5_Hashtag7
CAAAGAAGTGTAAACA	Hashtag5
CAACAACCAGAGGTAC	Hashtag7
CAACAACCAGGAATAT	Hashtag5_Hashtag7
CAACAACTCTCAACGA	Negative
CAACCAAGTAACCAGG	Hashtag5_Hashtag7
CAACCAAGTTGTAAAG	Hashtag5_Hashtag7
CAACCAAGTTTACGAC	Hashtag7
CAACCAATCATTCGTT	Hashtag5_Hashtag7
CAACCTCAGCGTACAG	Hashtag7
CAACGATCACAGCATT	Hashtag5
CAACGATCACCGTGCA	Hashtag5
CAACGATCATCGGTTA	Hashtag5
CAACGATGTGACCGAA	Hashtag5
CAACGATGTGCCGTTG	Hashtag5
CAACGATGTTACCCAA	Hashtag5
CAACGATTCGCAGATT	Hashtag5_Hashtag7
CAACGGCAGAGCATCG	Hashtag5
CAACGGCAGCTCAGAG	Hashtag7
CAACGGCAGGACTTCT	Hashtag5_Hashtag7
CAACGGCAGTCACGCC	Hashtag5
CAACGGCGTAAGTCAA	Hashtag5
CAACGGCGTCGCATGC	Hashtag5
CAACGGCGTTAGAAAC	Hashtag5_Hashtag7
CAACGGCGTTGCTAGT	Hashtag5_Hashtag7
CAACGGCTCAGCGCGT	Hashtag5
CAACGGCTCGGAATGG	Hashtag5_Hashtag7
CAAGACTAGCGACAGT	Hashtag5_Hashtag7
CAAGACTAGCTAGAGC	Hashtag5_Hashtag7
CAAGACTAGTATGGAT	Hashtag7
CAAGACTCACAATGTC	Hashtag7
CAAGACTCATCCGAGC	Negative
CAAGACTGTCGTGCCA	Hashtag7
CAAGACTTCCTCAGAA	Hashtag5_Hashtag7
CAAGAGGAGCCGGAAT	Hashtag5
CAAGAGGCACATAACC	Negative
CAAGAGGCAGCGACCT	Negative
CAAGAGGCATAGAATG	Hashtag5_Hashtag7
CAAGAGGGTCGCGTCA	Hashtag5
CAAGAGGTCAAGTGTC	Negative
CAAGAGGTCATTCACT	Hashtag7
CAAGAGGTCTGGGCGT	Negative
CAAGCTAAGCCAGACA	Hashtag7
CAAGCTAGTACAGTAA	Negative
CAAGCTAGTCTAACGT	Hashtag5_Hashtag7
CAAGGGAAGAGTTGCG	Hashtag7
CAAGGGAAGGGTCTTT	Hashtag7
CAAGGGAAGTGGCAGT	Hashtag5_Hashtag7
CAAGGGACAGCTCATA	Hashtag5_Hashtag7
CAAGGGACAGTTGCGC	Hashtag7
CAAGGGACATGGCTAT	Hashtag5
CAAGGGATCAACGTGT	Negative
CAATACGAGAGCCTGA	Hashtag5_Hashtag7
CAATACGCATCGAGCC	Hashtag7
CAATACGTCACCATCC	Hashtag7
CAATACGTCTCTGCCA	Hashtag7
CAATACGTCTGCGTCT	Negative
CAATCGAAGAACCCGA	Hashtag5
CAATCGAGTCTTTCTA	Negative
CAATGACCAAATCCCA	Negative
CAATGACCACAAGTTC	Hashtag5
CAATGACCATCTCCCA	Hashtag5
CAATGACGTAGTCTTG	Negative
CAATGACTCCTGTAAG	Hashtag7
CAATGACTCGCTCATC	Hashtag5
CAATGACTCTTGGGCG	Hashtag7
CAATTTCCAAACTGCT	Hashtag5
CAATTTCCAATAGTGA	Hashtag5_Hashtag7
CAATTTCGTGAGATCG	Hashtag5_Hashtag7
CACAACAAGAAGCTCG	Hashtag5
CACAACAAGCTAATGA	Negative
CACAACACAATCAAGA	Hashtag5
CACAACACACATTACG	Hashtag5_Hashtag7
CACAACACACTTCATT	Negative
CACAACACAGGGAATC	Hashtag5_Hashtag7
CACAACACAGGTCCGT	Hashtag5
CACAACACAGTGGGTA	Hashtag7
CACAACAGTCCGGTCA	Hashtag5_Hashtag7
CACAACATCATTCCTA	Hashtag7
CACAACATCCGTAATG	Negative
CACAACATCTTAGTTC	Hashtag5_Hashtag7
CACACAAAGATGGCGT	Hashtag7
CACACAAAGCGTCTGC	Hashtag5_Hashtag7
CACACAAAGGACTATA	Hashtag7
CACACAACATACAGAA	Hashtag5_Hashtag7
CACAGATAGGCAGGGA	Hashtag7
CACAGATAGGCTCTCG	Hashtag5
CACAGATTCCGAGAAG	Negative
CACAGGCGTTCGTTCC	Hashtag7
CACAGGCTCCACAAGT	Hashtag7
CACAGGCTCTCATTTG	Hashtag5_Hashtag7
CACAGGCTCTCGAACA	Hashtag7
CACATGAAGATAGGGA	Hashtag5_Hashtag7
CACATGAAGCTCCGAC	Negative
CACATGAAGTAAGAGG	Hashtag5
CACATGACAAGAAATC	Negative
CACATGAGTTAAGAAC	Hashtag5_Hashtag7
CACATGATCCATTCGC	Hashtag5_Hashtag7
CACATGATCCCATAAG	Hashtag5_Hashtag7
CACATGATCCGTTTCG	Negative
CACCAAAGTTACCCAA	Hashtag5_Hashtag7
CACCGTTCACGAAAGC	Hashtag5
CACCGTTCAGGTACGA	Negative
CACCGTTGTACTGGGA	Negative
CACCGTTGTCACTTAG	Hashtag5_Hashtag7
CACCGTTGTGATGGCA	Negative
CACCGTTTCATTGTGG	Negative
CACCGTTTCTCCCAAC	Negative
CACCGTTTCTGGTGGC	Negative
CACGAATAGCCTCACG	Hashtag5
CACGAATAGGAGAATG	Hashtag5_Hashtag7
CACGAATCAGATACTC	Negative
CACGAATGTACAGGTG	Hashtag5
CACGAATGTCGAGCAA	Hashtag5
CACGAATGTCTACGAT	Hashtag5
CACGAATTCCTACAAG	Negative
CACGGGTAGAGAGCCT	Negative
CACGGGTGTCACAGAG	Hashtag5
CACGGGTTCATTGCTT	Hashtag5
CACGGGTTCCCTCTCC	Negative
CACGGGTTCCGGTTCT	Hashtag5_Hashtag7
CACGGGTTCTTTGGAG	Hashtag7
CACGTGGCAGGTCCGT	Negative
CACGTGGTCCATGAGT	Negative
CACGTGGTCCCTGGTT	Negative
CACGTTCAGCGTTCAT	Negative
CACGTTCAGCTTAGTC	Hashtag5
CACGTTCAGGATACAT	Negative
CACGTTCAGTACTCGT	Hashtag5
CACGTTCCATTGCTTT	Hashtag7
CACGTTCGTAACCCGC	Negative
CACGTTCGTAGGACTG	Negative
CACGTTCTCACCCATC	Hashtag7
CACGTTCTCATTTCGT	Hashtag5
CACTAAGAGGGTCAAC	Hashtag7
CACTAAGTCCTTCTAA	Hashtag5_Hashtag7
CACTGAAAGAGCATTA	Hashtag5
CACTGAAAGGCGTTGA	Hashtag5_Hashtag7
CACTGAAAGTCTAGCT	Hashtag5
CACTGAACAAGAAACT	Hashtag5
CACTGAACAGCTACCG	Negative
CACTGAAGTACGTTCA	Hashtag5
CACTGAATCTTGAACG	Hashtag5_Hashtag7
CACTGGGAGCAGAAAG	Hashtag5
CACTGGGAGCAGGCTA	Hashtag5_Hashtag7
CACTGGGTCAGCGGAA	Hashtag7
CACTGGGTCTACACAG	Negative
CACTGTCAGTGTACCT	Hashtag5
CACTGTCCAACCTATG	Hashtag5
CACTGTCGTACACGTT	Hashtag7
CACTGTCGTACGATCT	Hashtag7
CACTGTCGTCCACAGC	Hashtag5
CACTGTCTCTTACCAT	Hashtag5
CACTGTCTCTTACTGT	Hashtag5
CACTTCGCAAACACCT	Hashtag5_Hashtag7
CACTTCGCAGCTCTGG	Negative
CACTTCGCAGTTAGGG	Hashtag7
CAGAGCCCACTGCGAC	Negative
CAGAGCCGTTGCGGAA	Hashtag5
CAGAGCCTCATGAAAG	Negative
CAGAGCCTCATTGGTG	Negative
CAGAGCCTCCACAGCG	Hashtag5_Hashtag7
CAGATACAGCGACTGA	Hashtag5_Hashtag7
CAGATACAGTTCGGTT	Negative
CAGATACGTTTAGAGA	Hashtag5
CAGATCAAGCTGGAGT	Hashtag5_Hashtag7
CAGATCACAATAGTAG	Hashtag5_Hashtag7
CAGATCAGTACAATAG	Hashtag5
CAGATCAGTGGGACAT	Negative
CAGATCATCATGACAC	Hashtag7
CAGATTGAGGGAGTTC	Hashtag5_Hashtag7
CAGATTGCAAGAAATC	Negative
CAGATTGCAGCCTATA	Negative
CAGATTGCAGTGTACT	Hashtag5_Hashtag7
CAGATTGCATAATGAG	Hashtag5_Hashtag7
CAGATTGGTATTCTCT	Hashtag5
CAGCAATAGCAAACAT	Hashtag5
CAGCAATCAAGTCCCG	Hashtag5_Hashtag7
CAGCAATCACGTCTCT	Hashtag5
CAGCAATCATTGACCA	Hashtag7
CAGCAATTCCACCTGT	Hashtag5
CAGCAATTCCTCTCGA	Hashtag5
CAGCACGCAAGTTGGG	Hashtag5
CAGCACGGTCTTCTAT	Hashtag5
CAGCACGTCAGGAAAT	Hashtag5_Hashtag7
CAGCACGTCTTCCCGA	Hashtag7
CAGCAGCAGCAAGCCA	Hashtag5
CAGCAGCAGCGTGAGT	Negative
CAGCAGCCAATCCTAG	Hashtag5
CAGCAGCCACGACGCT	Hashtag5_Hashtag7
CAGCAGCGTTATCCAG	Negative
CAGCAGCTCCAAATGC	Negative
CAGCCAGCAATGTTGC	Hashtag7
CAGCCAGCACAACCGC	Hashtag7
CAGCCAGCAGCTACCG	Hashtag5
CAGCCAGCAGGTTCAT	Hashtag5_Hashtag7
CAGCCAGGTGACCTGC	Hashtag7
CAGCCAGTCATGCATG	Hashtag5
CAGCCAGTCCCTCAAC	Negative
CAGCCAGTCTACTGCC	Hashtag5
CAGCCAGTCTTACACT	Hashtag7
CAGCGTGGTATCATGC	Negative
CAGCGTGGTTATCCAG	Hashtag5
CAGCGTGTCACTGTCC	Negative
CAGGCCAAGCACTCTA	Hashtag5_Hashtag7
CAGGCCAAGCGTCAAG	Hashtag5
CAGGCCAAGTCCGTCG	Negative
CAGGCCAGTAGTCACT	Hashtag5_Hashtag7
CAGGCCAGTGGAAATT	Hashtag5
CAGGCCATCACCCTTG	Hashtag5_Hashtag7
CAGGCCATCACTTGGA	Hashtag5_Hashtag7
CAGGCCATCCTAAGTG	Hashtag5
CAGGGCTAGGAGTACC	Negative
CAGGGCTAGGTCATCT	Hashtag5
CAGGGCTGTGCAACGA	Negative
CAGGGCTGTTGTAAAG	Hashtag5_Hashtag7
CAGGTATAGAAGTATC	Hashtag7
CAGGTATAGTATGACA	Hashtag5_Hashtag7
CAGGTATCACCCTTAC	Negative
CAGGTATCATACCATG	Negative
CAGGTATCATCCTATT	Negative
CAGGTATGTACTGACT	Negative
CAGGTATGTGACAACG	Hashtag5
CAGGTATGTGGTCCCA	Hashtag5
CAGGTATGTGTCTCCT	Hashtag7
CAGTGCGAGAATAACC	Negative
CAGTGCGAGACAGCGT	Hashtag7
CAGTGCGCACAAGCTT	Hashtag5
CAGTGCGCACTACCCT	Hashtag5_Hashtag7
CAGTGCGCATTCTTCA	Negative
CAGTGCGGTATTCCGA	Hashtag5
CAGTGCGGTGACTAAA	Hashtag5_Hashtag7
CAGTGCGGTTAACAGA	Hashtag5
CAGTTAGCAAACACGG	Hashtag5_Hashtag7
CAGTTAGCATCGCTGG	Hashtag5
CAGTTAGCATTCAGCA	Hashtag5_Hashtag7
CAGTTAGGTCGGTACC	Hashtag5
CAGTTAGGTGAGGATC	Hashtag5_Hashtag7
CAGTTAGGTGCAACAG	Negative
CAGTTAGGTTCGTACA	Negative
CAGTTAGTCCGAGATT	Hashtag7
CAGTTAGTCGTTCCCA	Hashtag5
CAGTTAGTCTCCGCAT	Negative
CAGTTCCAGAGGTCGT	Hashtag5_Hashtag7
CAGTTCCAGAGTTGTA	Negative
CAGTTCCAGCCGGATA	Hashtag5
CAGTTCCAGTCCTACA	Negative
CAGTTCCCAGTAGAAT	Negative
CAGTTCCGTATCGTTG	Negative
CAGTTCCGTTATCTGG	Negative
CAGTTCCTCCGAGCTG	Hashtag5
CAGTTCCTCGCACGGT	Negative
CATAAGCAGAAGTCCG	Hashtag5
CATAAGCAGTGCGTCC	Hashtag5_Hashtag7
CATAAGCCATGTCAGT	Hashtag5_Hashtag7
CATAAGCGTCGTATTG	Negative
CATAAGCGTGAGCGAT	Hashtag5_Hashtag7
CATAAGCTCATATGGC	Hashtag7
CATAAGCTCCAAGGGA	Negative
CATACAGAGCCGTAAG	Hashtag5_Hashtag7
CATACAGGTGACCTGC	Negative
CATACAGGTGCTCCGA	Hashtag5
CATACAGGTTGCCGCA	Hashtag7
CATACCCAGGTTGAGC	Negative
CATACCCCAATCAAGA	Hashtag7
CATACCCCAGTATACC	Negative
CATACCCGTACCAGAG	Hashtag5
CATACCCGTGGGATTG	Hashtag5_Hashtag7
CATACCCTCCGTAATG	Negative
CATACCCTCTACCAGA	Negative
CATACTTAGAAGTCCG	Hashtag5
CATACTTCACCTGTCT	Negative
CATACTTCAGCGACAA	Hashtag5
CATACTTTCATAGAGA	Negative
CATAGACAGTACGAGC	Hashtag5
CATAGACAGTGCAACG	Hashtag5
CATAGACCAGAATGTA	Hashtag5_Hashtag7
CATCAAGAGAAGCGCT	Negative
CATCAAGAGACCATTC	Hashtag7
CATCAAGAGACTGAGC	Hashtag5
CATCAAGAGGTCCTGC	Hashtag7
CATCAAGCAATACCCA	Hashtag5_Hashtag7
CATCAAGCACCACTGG	Negative
CATCAAGTCAAGCCGC	Negative
CATCAAGTCAATCGGT	Negative
CATCAAGTCTCTATGT	Hashtag5
CATCCACAGAGAACCC	Hashtag7
CATCCACAGTCTAGCT	Negative
CATCCACAGTTGCATC	Hashtag7
CATCCACCAATTGGTC	Hashtag5
CATCCACGTCGTTATG	Hashtag7
CATCCACGTGCAGGAT	Hashtag7
CATCCCAAGACATACA	Hashtag7
CATCCCACAGAAATCA	Hashtag5_Hashtag7
CATCCCACAGGCTCTG	Hashtag7
CATCCCATCATTTACC	Negative
CATCCCATCCAAACCA	Hashtag5
CATCCGTAGGCACTCC	Hashtag7
CATCCGTCAATCGTCA	Hashtag5
CATCCGTTCCACGGAC	Hashtag5_Hashtag7
CATCGCTAGAGTTGCG	Negative
CATCGCTCATCAGTGT	Hashtag7
CATCGCTCATCTATCT	Negative
CATCGCTCATCTGGGC	Hashtag7
CATCGCTGTCTTGCGG	Hashtag5
CATCGCTGTTCACCGG	Negative
CATCGCTTCAGCTTCC	Hashtag5_Hashtag7
CATCGCTTCGATACGT	Hashtag5
CATCGCTTCTGACAGT	Hashtag7
CATCGGGAGAGGCCAT	Negative
CATCGGGCAGAGGAAA	Hashtag5
CATCGGGGTATCGTTG	Hashtag5
CATCGGGTCACGATAC	Hashtag5_Hashtag7
CATCGTCCAATCGCCG	Negative
CATCGTCCACCTGATA	Hashtag5_Hashtag7
CATCGTCCATCCGTTC	Negative
CATCGTCTCCGCTGTT	Hashtag5
CATGAGTAGAAGAACG	Hashtag5_Hashtag7
CATGAGTAGAGCAACC	Hashtag5
CATGAGTCAATCCTTT	Hashtag7
CATGAGTGTCAAATCC	Negative
CATGAGTTCCGGCAAC	Negative
CATGAGTTCTCATTGT	Negative
CATGCAAAGGCAGGTT	Negative
CATGCAAAGGGCGAAG	Hashtag7
CATGCAAAGTCTGGTT	Hashtag5_Hashtag7
CATGCAAGTATTAAGG	Hashtag5
CATGCAAGTCCGATCG	Hashtag5_Hashtag7
CATGCCTAGAGCAGTC	Hashtag5_Hashtag7
CATGCCTAGCACCGTC	Hashtag5_Hashtag7
CATGCCTCAATAAGGT	Hashtag7
CATGCCTGTCGTAATC	Hashtag5_Hashtag7
CATGCGGAGCACTCAT	Hashtag5_Hashtag7
CATGCGGGTCATCGGC	Hashtag5
CATGCGGGTCCCGGTA	Hashtag5
CATGCTCAGAGGATCC	Hashtag5
CATGCTCAGATGACCG	Hashtag7
CATGCTCAGGAAAGGT	Negative
CATGCTCAGGTACTGG	Hashtag7
CATGCTCAGTGATAAC	Negative
CATGCTCCACTACGGC	Hashtag5_Hashtag7
CATGCTCCATAGGAGC	Hashtag5_Hashtag7
CATGCTCCATTGTACG	Negative
CATGCTCGTGAATTGA	Hashtag5_Hashtag7
CATGCTCGTTGCACGC	Negative
CATGCTCTCACCTCGT	Negative
CATGCTCTCGAGAATA	Hashtag5
CATGCTCTCGGTCGGT	Negative
CATGGATAGCGCATCC	Hashtag7
CATGGATAGCGTGCCT	Negative
CATGGATAGCTATCTG	Negative
CATGGATAGTAGACAT	Hashtag5
CATGGATCACAAGTGG	Hashtag5_Hashtag7
CATGGATCACCCTAGG	Hashtag7
CATGGATCAGTCCCGA	Hashtag5_Hashtag7
CATGGATGTTCATCTT	Hashtag7
CATGGATTCCGATGCG	Negative
CATGGTAAGCAGGCTA	Hashtag5_Hashtag7
CATGGTACAGGAGGAG	Hashtag5_Hashtag7
CATGGTAGTACTAAGA	Hashtag5
CATGGTAGTCATCCCT	Negative
CATGGTAGTTTCCAAG	Negative
CATGGTATCATGCCCT	Hashtag7
CATTCATAGTAATCCC	Hashtag5
CATTCATCATAGGTTC	Hashtag5_Hashtag7
CATTCATCATCGTCCT	Hashtag5
CATTCATGTAGGATAT	Hashtag7
CATTCATGTGACGCCT	Hashtag7
CATTCCGCACCCATAA	Hashtag5_Hashtag7
CATTCCGCACGCGTCA	Hashtag7
CATTCCGCATTCTCTA	Hashtag5
CATTCTAAGCAGCACA	Negative
CATTCTACAGTGTGCC	Hashtag5
CATTCTAGTCAGTCGC	Negative
CATTCTATCCGACATA	Hashtag5
CATTCTATCCGTAATG	Hashtag5_Hashtag7
CATTCTATCGCGTGAC	Hashtag5
CATTGAGAGGTCATCT	Hashtag5_Hashtag7
CATTGAGAGTAAATGC	Hashtag5
CATTGAGGTATCAGCT	Hashtag5_Hashtag7
CATTGAGGTATGCTTG	Hashtag7
CATTGAGGTGTAGTGG	Hashtag5
CATTGAGTCCCATTCG	Hashtag7
CATTGCCAGGGTTAAT	Hashtag5
CATTGCCTCCATTGCC	Hashtag5_Hashtag7
CATTGTTCACTTGACA	Negative
CATTGTTCAGCAGACA	Hashtag5
CATTGTTCATTCGATG	Negative
CATTGTTGTTAGCGGA	Hashtag5
CATTGTTGTTCAGTAC	Hashtag5
CATTGTTTCCATCACC	Hashtag5
CATTGTTTCTGGTTGA	Negative
CATTGTTTCTTCGCTG	Negative
CATTTCAAGGCTTTCA	Hashtag5
CATTTCACAGCTACTA	Hashtag7
CATTTCAGTAACGGTG	Hashtag5
CATTTCAGTTGCCAAT	Hashtag5
CATTTCATCGGCAGTC	Hashtag5_Hashtag7
CCAAGCGAGGTTACCT	Hashtag5
CCAAGCGCAGGAACCA	Hashtag7
CCAAGCGGTCTAACTG	Hashtag5
CCAAGCGGTGTCCAAT	Hashtag5_Hashtag7
CCAAGCGTCCAGCAAT	Negative
CCAATGAAGCGACAGT	Hashtag5_Hashtag7
CCAATGACACGAGGAT	Hashtag5
CCAATGACATCCGGTG	Hashtag5
CCAATGACATTCGGGC	Hashtag5
CCAATGATCATGTCTT	Hashtag5_Hashtag7
CCAATGATCCCTCGTA	Negative
CCAATGATCGATGCAT	Hashtag5
CCAATTTAGCAAATCA	Hashtag5
CCAATTTCACTCAGAT	Hashtag5_Hashtag7
CCAATTTGTTCTCACC	Hashtag5
CCAATTTTCAGCCTTC	Hashtag7
CCAATTTTCCCAACTC	Hashtag5_Hashtag7
CCAATTTTCGCAGTCG	Negative
CCACAAAAGATAGGGA	Hashtag5_Hashtag7
CCACAAAGTTGCTCGG	Hashtag7
CCACAAATCGCAGATT	Hashtag7
CCACAAATCTTTGCGC	Negative
CCACACTCACATTACG	Negative
CCACACTCATCCTTCG	Hashtag5_Hashtag7
CCACACTTCGACGTCG	Hashtag5
CCACACTTCGAGCCTG	Negative
CCACACTTCTAGATCG	Hashtag5_Hashtag7
CCACACTTCTCGGTAA	Hashtag5
CCACACTTCTGAACGT	Negative
CCACCATCAACTGCTA	Negative
CCACCATCAGAGGACT	Negative
CCACCATGTACTCCCT	Negative
CCACCATTCACCCATC	Negative
CCACGAGAGATGGCAC	Hashtag5_Hashtag7
CCACGAGAGGGTGAGG	Hashtag7
CCACGAGAGTTGCTCA	Hashtag5
CCACGAGAGTTGGACG	Hashtag7
CCACGAGCAATACAGA	Hashtag7
CCACGAGGTACAGCGA	Hashtag5_Hashtag7
CCACGAGGTCGAGCTC	Negative
CCACGAGGTCTTGCTC	Hashtag5_Hashtag7
CCACGAGGTGGTATGG	Hashtag5
CCACGAGTCATGCTAG	Negative
CCACGAGTCTATCCAT	Hashtag5_Hashtag7
CCACGAGTCTTCTCAA	Hashtag7
CCACGTTAGGCTCTAT	Hashtag5_Hashtag7
CCACGTTAGGTGCCAA	Hashtag5
CCACGTTGTTTGGGTT	Negative
CCACGTTTCAAATAGG	Hashtag5
CCACGTTTCACAACCA	Negative
CCACTTGAGGAGCAAA	Hashtag5_Hashtag7
CCACTTGCAGCGGTCT	Hashtag7
CCACTTGCAGCGTGCT	Hashtag5_Hashtag7
CCACTTGCATGGATCT	Hashtag5
CCACTTGGTCACATTG	Hashtag7
CCACTTGGTCTGTGTA	Hashtag5
CCACTTGTCTCGAGTA	Hashtag5
CCATAAGAGATGACCG	Hashtag5
CCATAAGAGCAGGGAG	Hashtag7
CCATAAGAGGAGATAG	Negative
CCATAAGAGTGCCTCG	Negative
CCATAAGCAAACTCGT	Negative
CCATAAGCAGTTGTTG	Negative
CCATAAGGTCGCTCGA	Negative
CCATAAGGTCTTTCTA	Hashtag5
CCATAAGGTTGGTGTT	Negative
CCATAAGTCTGCGGCA	Hashtag5
CCATCACAGGACAGCT	Negative
CCATCACGTCCACACG	Hashtag7
CCATCACGTTCGGTCG	Hashtag7
CCATCACGTTTACCAG	Hashtag5
CCATCACTCCCTCGAT	Hashtag5_Hashtag7
CCATCACTCGGCTCTT	Hashtag5
CCCAACTGTGAGCGAT	Hashtag5_Hashtag7
CCCATTGAGCCAAGTG	Negative
CCCATTGAGCGTGTTT	Hashtag7
CCCATTGAGTCCCGAC	Negative
CCCATTGCACAGCTGC	Negative
CCCATTGCAGTGGTGA	Negative
CCCATTGGTATTGGCT	Hashtag5
CCCATTGTCCAAACCA	Negative
CCCATTGTCCGTCAAA	Hashtag5
CCCGAAGAGGTCACCC	Hashtag7
CCCGAAGGTACGACAG	Hashtag5_Hashtag7
CCCGAAGGTAGATCGG	Hashtag5_Hashtag7
CCCGAAGGTCCAGCAC	Hashtag5_Hashtag7
CCCGAAGTCTGTTGGA	Hashtag5
CCCGGAAAGAAGCTCG	Hashtag5
CCCGGAAAGGATTCCT	Negative
CCCGGAACAGTGACCC	Hashtag5
CCCGGAACATAGTCAC	Hashtag5_Hashtag7
CCCGGAACATCGAAGG	Hashtag5
CCCGGAAGTCATAAAG	Hashtag5_Hashtag7
CCCGGAATCTCTAGGA	Negative
CCCTAACCATACCAGT	Hashtag5_Hashtag7
CCCTAACTCAAGCGTT	Hashtag5_Hashtag7
CCCTCAAAGCGTCAGA	Hashtag5_Hashtag7
CCCTCAACAGTTTCAG	Hashtag5_Hashtag7
CCCTCAAGTAAGTAGT	Negative
CCCTCAAGTACTAGCT	Negative
CCCTCAAGTACTCCCT	Negative
CCCTCAAGTCTGTGCG	Negative
CCCTCAATCTGGACCG	Negative
CCCTCTCAGTATGAAC	Hashtag7
CCCTCTCAGTCACTAC	Hashtag5_Hashtag7
CCCTCTCTCATCGCCT	Hashtag5_Hashtag7
CCCTGATAGGAGATAG	Negative
CCCTGATAGTACTCGT	Hashtag5
CCCTGATCAAATGCTC	Hashtag7
CCCTGATCAACTGAAA	Hashtag7
CCCTGATGTGACACAG	Hashtag5
CCCTGATGTTTGGGAG	Hashtag5
CCCTGATTCAAGTGGG	Hashtag7
CCCTGATTCACCCTGT	Hashtag5_Hashtag7
CCCTGATTCCTCACCA	Hashtag5_Hashtag7
CCCTTAGAGGAACATT	Hashtag5
CCCTTAGCAGAGAAAG	Hashtag5
CCCTTAGCAGGCATGA	Hashtag7
CCCTTAGCAGTTAGAA	Hashtag5
CCCTTAGGTCACTCAA	Negative
CCCTTAGTCACTCCGT	Hashtag5
CCGAACGAGAAGAACG	Hashtag5
CCGAACGCACTTCAGA	Hashtag5_Hashtag7
CCGAACGTCTAGCATG	Hashtag7
CCGAACGTCTTTCCAA	Hashtag7
CCGATCTCAACTAGAA	Negative
CCGATCTGTTGTATGC	Hashtag5_Hashtag7
CCGATCTTCATCGCCT	Hashtag7
CCGATCTTCGATACAC	Hashtag5
CCGATCTTCGGATTAC	Hashtag5_Hashtag7
CCGATGGAGAGAACCC	Hashtag5
CCGATGGAGCGAATGC	Hashtag5_Hashtag7
CCGATGGAGCTCTATG	Hashtag5
CCGATGGAGGGTCTTT	Hashtag7
CCGATGGCAGAGCTAG	Hashtag7
CCGATGGGTACCGTCG	Negative
CCGATGGGTATCATGC	Hashtag5
CCGATGGGTCGGTGAA	Hashtag7
CCGATGGTCCATCGTC	Hashtag5
CCGCAAGAGAGAGCAA	Hashtag5
CCGCAAGAGCTGCCAC	Hashtag5
CCGCAAGAGTCGCGAA	Negative
CCGCAAGAGTGGCAGT	Hashtag5
CCGCAAGCATTGAAGA	Negative
CCGCAAGGTAAGTCAA	Hashtag5
CCGCAAGGTAGCGAGT	Negative
CCGGACAAGCAAGGAA	Hashtag5_Hashtag7
CCGGACACAACTTCTT	Negative
CCGGACACAATAAGGT	Hashtag5
CCGGACACATGGATCT	Hashtag5_Hashtag7
CCGGACAGTAGACAAT	Negative
CCGGACAGTGCGAGTA	Hashtag5_Hashtag7
CCGGGTAAGCATCTTG	Hashtag5_Hashtag7
CCGGGTAAGCGACAGT	Hashtag5
CCGGGTAGTACAGAGC	Hashtag5_Hashtag7
CCGGGTAGTGAGAACC	Hashtag5_Hashtag7
CCGGGTAGTGAGATCG	Hashtag5
CCGGGTAGTGAGGCAT	Hashtag7
CCGGTAGGTCCGAAGA	Negative
CCGGTAGTCTCTGCTG	Hashtag5
CCGGTGAAGCAAACAT	Hashtag7
CCGGTGACAAAGCGTG	Hashtag5
CCGGTGACAACGACAG	Negative
CCGGTGACAGTAGTGG	Hashtag7
CCGGTGACATCTCAAG	Hashtag5
CCGGTGAGTTATAGCC	Hashtag5
CCGTAGGCATCCTCAC	Hashtag5_Hashtag7
CCGTAGGGTACAAGCG	Negative
CCGTAGGTCAAGCTGT	Hashtag5
CCGTAGGTCACAGAGG	Hashtag5_Hashtag7
CCGTAGGTCTATCGTT	Negative
CCGTGAGAGCTGCCTG	Hashtag5
CCGTGAGGTACGTACT	Negative
CCGTGAGGTCATAAAG	Hashtag5
CCGTGAGTCGGTTGTA	Hashtag5
CCGTTCAAGACTGTTC	Hashtag5_Hashtag7
CCGTTCACAAGCCTGC	Hashtag5
CCGTTCATCAGACCCG	Hashtag5
CCGTTCATCGCTACGG	Hashtag5
CCTAACCAGCGGTATG	Negative
CCTAACCGTAAGCAAT	Negative
CCTAACCTCAAGAGTA	Hashtag5
CCTAACCTCAGACATC	Hashtag5
CCTAAGAAGCCAGACA	Hashtag5
CCTAAGAAGCCTTTGA	Negative
CCTAAGACAAAGCGTG	Hashtag5_Hashtag7
CCTAAGACAATAGTGA	Negative
CCTAAGAGTACAATAG	Hashtag7
CCTAAGAGTGATACCT	Negative
CCTAAGAGTGCTCCGA	Negative
CCTAAGAGTGTACATC	Negative
CCTAAGATCACGATAC	Hashtag5_Hashtag7
CCTAAGATCATCGCAA	Hashtag7
CCTAAGATCGTTGTAG	Hashtag5
CCTACGTGTCACAGAG	Hashtag5
CCTACGTGTTTACTGG	Negative
CCTATCGAGGATCACG	Hashtag7
CCTATCGCATTGGCAT	Hashtag5_Hashtag7
CCTATCGGTATGTCCA	Hashtag5_Hashtag7
CCTATCGGTGCACATT	Hashtag5_Hashtag7
CCTATCGTCCGGCTTT	Negative
CCTCAACAGGCTGTAG	Hashtag5
CCTCAACAGTCACACT	Hashtag7
CCTCAACTCATGGCCG	Negative
CCTCAACTCCGGACTG	Hashtag7
CCTCACAAGGGTTAGC	Hashtag7
CCTCACACACCGTGAC	Hashtag5_Hashtag7
CCTCACACAGGGAGAG	Hashtag5
CCTCACAGTAGGCTGA	Hashtag7
CCTCACAGTCGGTGTC	Hashtag5_Hashtag7
CCTCACAGTGGGAGAG	Negative
CCTCACAGTTCAAACC	Hashtag5
CCTCAGTAGTATGAGT	Negative
CCTCAGTCACTGGCGT	Negative
CCTCAGTCATAATGAG	Negative
CCTCAGTGTCACTCGG	Hashtag5
CCTCAGTGTGAATATG	Hashtag5
CCTCAGTGTTCTAAGC	Negative
CCTCAGTTCCGATGCG	Negative
CCTCAGTTCTGCTTAT	Negative
CCTCATGAGGCATCGA	Hashtag5
CCTCATGCAAGAAATC	Hashtag5
CCTCATGCACTGCGAC	Negative
CCTCATGCAGAGCTAG	Hashtag7
CCTCATGCAGGCGAAT	Negative
CCTCATGGTACATACC	Hashtag5_Hashtag7
CCTCATGGTAGCTTTG	Hashtag5_Hashtag7
CCTCATGGTCCCGTGA	Negative
CCTCATGGTTGTACGT	Negative
CCTCATGTCACGGGAA	Negative
CCTCATGTCCAAATGC	Hashtag5_Hashtag7
CCTCATGTCGGTGTAT	Hashtag5_Hashtag7
CCTCATGTCGGTTCAA	Hashtag7
CCTCCAAAGTCTACCA	Hashtag5
CCTCCAACATACAGCT	Negative
CCTCCAAGTCGTTCAA	Hashtag5
CCTCCAATCCTAACAG	Hashtag7
CCTCCAATCGATTCCC	Hashtag7
CCTCCAATCTTAGGAC	Hashtag5
CCTCCTCAGCCGAATG	Hashtag5_Hashtag7
CCTCCTCCACACTTAG	Negative
CCTCCTCGTAGCTGTT	Hashtag5
CCTCCTCGTCATACCA	Negative
CCTCCTCGTCGTCATA	Hashtag5_Hashtag7
CCTCCTCGTGAGACCA	Hashtag5_Hashtag7
CCTCCTCGTTGACGGA	Negative
CCTCTAGAGCACTTTG	Hashtag5_Hashtag7
CCTCTAGAGGTCTGGA	Hashtag7
CCTCTAGAGTCGAAGC	Hashtag5
CCTCTAGCAATGAGCG	Negative
CCTCTAGGTTATAGAG	Hashtag7
CCTCTAGTCGCTTGAA	Negative
CCTCTCCAGTATGAGT	Negative
CCTCTCCAGTGTTCCA	Negative
CCTCTCCCATCCTTCG	Hashtag5_Hashtag7
CCTCTCCTCCATGATG	Negative
CCTCTCCTCGACCCAG	Negative
CCTGCATGTACGGTTT	Hashtag5
CCTGCATGTCCTGTCT	Negative
CCTGCATGTCTGTAGT	Hashtag5
CCTGCATTCGTCGCTT	Hashtag5_Hashtag7
CCTGCATTCGTTCTAT	Hashtag5
CCTGCATTCTGAGAGG	Hashtag7
CCTGTTGAGACGCAGT	Hashtag5_Hashtag7
CCTGTTGAGACTAGAT	Hashtag7
CCTGTTGAGAGCGACT	Hashtag7
CCTGTTGAGGACATCG	Hashtag5
CCTGTTGAGGCTAGCA	Hashtag7
CCTGTTGAGGCTGAAC	Hashtag7
CCTGTTGCAATGTGGG	Hashtag5
CCTGTTGCATACTGTG	Negative
CCTGTTGGTATTGAGA	Negative
CCTGTTGGTCTCTCTG	Hashtag5
CCTGTTGTCCGAACGC	Negative
CCTTCAGCAATAGAGT	Negative
CCTTCAGCACTTGAAC	Negative
CCTTCAGGTAACACCT	Hashtag5
CCTTCAGGTACAACGG	Negative
CCTTCAGGTATGAGGC	Negative
CCTTCAGTCCTTCACG	Hashtag5
CCTTGTGAGTAAACAC	Hashtag5
CCTTGTGCATCACCAA	Negative
CCTTGTGGTTCGGTCG	Hashtag7
CCTTTGGAGGGCAATC	Negative
CCTTTGGAGTCGAAGC	Hashtag5_Hashtag7
CCTTTGGCAAAGGCGT	Hashtag5
CCTTTGGCAACAAGTA	Hashtag5_Hashtag7
CCTTTGGGTCATATGC	Hashtag5
CCTTTGGGTCCACTCT	Hashtag5_Hashtag7
CCTTTGGTCGAGTCCG	Hashtag5
CCTTTGGTCGGAGTGA	Hashtag7
CCTTTGGTCTTAATCC	Hashtag5_Hashtag7
CGAAGGAAGCGACCCT	Hashtag5_Hashtag7
CGAAGGAGTCGAATTC	Hashtag7
CGAAGGATCAACCTTT	Hashtag5
CGAAGGATCTGGAAGG	Hashtag5
CGAAGTTAGGCGAAGG	Hashtag5
CGAAGTTAGTCTTCGA	Negative
CGAAGTTCACAATGCT	Hashtag7
CGAAGTTCAGCGGATA	Hashtag5
CGAAGTTCATACATCG	Negative
CGAAGTTGTCGTACAT	Hashtag5
CGAAGTTTCAGTCACA	Hashtag5_Hashtag7
CGAATTGAGATGTTGA	Hashtag5_Hashtag7
CGAATTGAGTGCTAGG	Negative
CGAATTGCAGCGAGTA	Hashtag5
CGAATTGGTCTTGAGT	Negative
CGAATTGTCCAATCTT	Hashtag5
CGAATTGTCCTCTTTC	Hashtag7
CGAATTGTCGCTACGG	Hashtag5
CGACAGCAGAGAACCC	Hashtag7
CGACAGCCATCAGCAT	Hashtag5
CGACAGCGTCGGCCTA	Hashtag7
CGACAGCGTTGTGCAT	Hashtag7
CGACAGCTCATAGGCT	Hashtag7
CGACAGCTCCACACCT	Negative
CGACAGCTCTGACGCG	Hashtag5_Hashtag7
CGACAGCTCTTCCCAG	Hashtag7
CGAGAAGAGGTCTGGA	Hashtag5
CGAGAAGCACGACAAG	Hashtag5
CGAGAAGCACTAACGT	Hashtag5
CGAGAAGGTGTTTGCA	Hashtag7
CGAGAAGTCTGCATAG	Hashtag5
CGAGAAGTCTTGCAGA	Hashtag5_Hashtag7
CGAGGAAAGACATCAA	Negative
CGAGGAAAGTGCAAAT	Hashtag5_Hashtag7
CGAGGAACATACGCAT	Hashtag5_Hashtag7
CGAGGAAGTAACAAGT	Negative
CGAGGAATCAATGCAC	Hashtag5_Hashtag7
CGAGGAATCCCAACTC	Hashtag5_Hashtag7
CGAGGAATCCCAATAG	Hashtag5_Hashtag7
CGAGGAATCCGATCGG	Hashtag5_Hashtag7
CGAGGAATCTACGCAA	Hashtag5
CGAGGAATCTTGGTCC	Negative
CGAGGCTAGATGCGAC	Hashtag5
CGAGGCTAGATGTTAG	Negative
CGAGGCTCAACCAACT	Hashtag7
CGAGGCTCAGAGAAAG	Hashtag5_Hashtag7
CGAGGCTGTGACCGAA	Hashtag5_Hashtag7
CGAGGCTGTTGCTTGA	Hashtag7
CGAGGCTTCCATGAGT	Hashtag5
CGAGTGCAGCACTAGG	Hashtag5
CGAGTGCAGCGAATGC	Hashtag5
CGAGTGCAGGTTAAAC	Hashtag5
CGAGTGCCACTGAGGA	Hashtag7
CGAGTGCCATCGTTCC	Negative
CGAGTTAAGCAGTCTT	Negative
CGAGTTAAGCGGTAAC	Hashtag5
CGAGTTACATTCACAG	Negative
CGAGTTAGTTACCTTT	Hashtag5
CGAGTTATCGTCGATA	Hashtag5
CGATCGGCAAGACAAT	Negative
CGATCGGCACATTGTG	Hashtag7
CGATCGGGTACTCCCT	Hashtag5
CGATCGGGTTCTCGCT	Hashtag5
CGATGCGAGAGAGAAC	Hashtag5_Hashtag7
CGATGCGCACATTGTG	Hashtag5
CGATGCGCAGAGGACT	Hashtag5
CGATGCGGTCGAGTTT	Hashtag7
CGATGCGGTGCCGTTG	Negative
CGATGCGGTGTAGTGG	Hashtag7
CGATGCGTCAGAGCGA	Hashtag7
CGATGCGTCGACGATT	Hashtag5
CGATGCGTCTGTAAGC	Hashtag5_Hashtag7
CGATGGCAGCCAAGGT	Hashtag5_Hashtag7
CGATGGCAGTAGCCAG	Hashtag5_Hashtag7
CGATGGCGTCTAGATC	Negative
CGCAGGTAGGCGAACT	Hashtag5_Hashtag7
CGCAGGTAGGCTAACG	Negative
CGCAGGTAGTAATCCC	Hashtag5
CGCAGGTCAAACGGCA	Hashtag5
CGCAGGTCAGACCAGA	Hashtag5
CGCAGGTCAGTTGCGC	Hashtag5_Hashtag7
CGCAGGTTCGGACAAG	Hashtag7
CGCAGGTTCTCCGAAA	Hashtag5
CGCAGGTTCTGTCTCG	Hashtag5
CGCATAAGTACCGGAA	Hashtag5
CGCATAAGTTGGGACA	Hashtag5
CGCATAATCGCGTGAC	Hashtag5
CGCATGGAGAAATGGG	Negative
CGCATGGGTATTGGCT	Negative
CGCATGGGTCAAAGCG	Hashtag7
CGCCAGAAGATCCCAT	Hashtag7
CGCCAGAAGCCTAGGA	Hashtag5_Hashtag7
CGCCAGAAGGGCAACT	Hashtag5_Hashtag7
CGCCAGATCCATTTAC	Hashtag7
CGCCATTTCACGACTA	Hashtag5
CGCCATTTCTCTCGAC	Hashtag5_Hashtag7
CGCGTGAAGGAACGAA	Hashtag5_Hashtag7
CGCGTGAAGTGAACAT	Negative
CGCGTGACACGACGCT	Hashtag5_Hashtag7
CGCGTGACATCTGGGC	Negative
CGCGTGACATTGCTGA	Hashtag5_Hashtag7
CGCGTGAGTACCATAC	Hashtag5_Hashtag7
CGCGTGAGTGAGGAAA	Hashtag5_Hashtag7
CGGAACCAGGTGCTGA	Hashtag7
CGGAACCGTACCTGTA	Hashtag7
CGGAACCGTCGAGCAA	Hashtag5_Hashtag7
CGGAACCGTTTACCAG	Hashtag5
CGGAACCGTTTGGGTT	Hashtag7
CGGAACCTCGAGAATA	Hashtag5
CGGAATTAGGACAGCT	Hashtag7
CGGAATTAGTGCTACT	Hashtag5
CGGAATTCAGAAATTG	Hashtag5_Hashtag7
CGGAATTGTGTTGACT	Negative
CGGAATTGTTGAATCC	Hashtag5_Hashtag7
CGGACACCAATGCAAA	Hashtag7
CGGACACCAGCCGTCA	Hashtag5_Hashtag7
CGGACACGTCAAATCC	Hashtag7
CGGACACTCCCGAAAT	Negative
CGGACACTCCCTTCCC	Hashtag5
CGGAGAAAGCCTCTCT	Hashtag5
CGGAGAAAGTTCACTG	Hashtag5_Hashtag7
CGGAGAACAACGAGGT	Hashtag5
CGGAGAACACCTGTCT	Hashtag5
CGGAGAAGTCACGTGC	Hashtag5_Hashtag7
CGGAGAATCGTACCTC	Hashtag5
CGGAGAATCGTGACTA	Hashtag7
CGGCAGTCATCTTTCA	Hashtag7
CGGCAGTGTAGCTCGC	Hashtag5_Hashtag7
CGGGACTAGGATCATA	Hashtag5_Hashtag7
CGGGACTGTCGTCTCT	Hashtag5
CGGGACTGTGGCATCC	Hashtag5_Hashtag7
CGGGACTTCACGACTA	Hashtag5_Hashtag7
CGGGACTTCAGGTAAA	Hashtag5
CGGGACTTCTCTCGCA	Hashtag5
CGGGCATAGATTCGAA	Negative
CGGGCATCAATCAGCT	Hashtag5_Hashtag7
CGGGCATCAGAGGTAC	Hashtag5
CGGGCATCATATGGCT	Hashtag5
CGGGCATGTCCGGATC	Hashtag7
CGGGCATGTTTACTGG	Hashtag5
CGGGTCAAGCGATGGT	Negative
CGGGTCACAACAGTGG	Hashtag5_Hashtag7
CGGGTCACACAAGTTC	Hashtag7
CGGGTCAGTAGTATAG	Negative
CGGGTCAGTTTCGACA	Hashtag5_Hashtag7
CGGGTGTGTACGATGG	Hashtag5
CGGTCAGAGAATTGCA	Hashtag5
CGGTCAGAGAGCAGCT	Negative
CGGTCAGAGGCACGAT	Hashtag5
CGGTCAGCAGCTCCTT	Hashtag5
CGGTCAGCATGACAAA	Hashtag5_Hashtag7
CGGTCAGGTGTACATC	Hashtag5
CGGTCAGTCACGGGCT	Hashtag5
CGGTCAGTCGAGAAGC	Hashtag5_Hashtag7
CGTAAGTAGTAACAGT	Hashtag5
CGTAAGTCAGACACCC	Hashtag5
CGTAAGTTCACATCAG	Negative
CGTAAGTTCAGCAATC	Hashtag5
CGTAAGTTCCCATAAG	Hashtag5
CGTAAGTTCCGGACTG	Hashtag5
CGTAATGAGCTAGTTC	Hashtag7
CGTAATGAGGCTCACC	Negative
CGTAATGAGGTTAAAC	Hashtag5_Hashtag7
CGTAATGAGTGAGTTA	Hashtag5
CGTAATGCACACGGAA	Hashtag5
CGTAATGGTCATGCAT	Hashtag5
CGTAATGGTGGCTGCT	Negative
CGTAATGTCAATCCAG	Hashtag7
CGTAATGTCATCGCTC	Hashtag5
CGTAATGTCATCTATC	Negative
CGTAATGTCCGCTAGG	Hashtag5_Hashtag7
CGTAATGTCGAGTCTA	Hashtag5
CGTAGTAGTACTCGTA	Hashtag5
CGTAGTAGTCTGTGTA	Hashtag5_Hashtag7
CGTAGTATCATTCGTT	Hashtag5
CGTAGTATCGAATGCT	Negative
CGTCAAACAGGGATAC	Hashtag5_Hashtag7
CGTCAAACATGGAACG	Hashtag7
CGTCAAAGTATAGCTC	Hashtag5_Hashtag7
CGTCCATCACTGTCCT	Hashtag5
CGTCCATCATGGCACC	Hashtag7
CGTCCATGTCGCAGTC	Hashtag7
CGTCCATTCACGAACT	Negative
CGTCCATTCCCTTCCC	Hashtag7
CGTCCATTCCGCAGTG	Negative
CGTCCATTCGGCCTTT	Hashtag7
CGTCCATTCTCTTCAA	Hashtag5
CGTGAATAGAGTCTGG	Hashtag5
CGTGAATCAAGCTACT	Hashtag5
CGTGAATCACGTATAC	Hashtag5
CGTGAATCATTAAGCC	Hashtag5
CGTGAATGTCCTGTCT	Hashtag5
CGTGAATGTCTCACAA	Hashtag5
CGTGAATTCCATACAG	Hashtag5_Hashtag7
CGTGATAAGGAGAATG	Hashtag5_Hashtag7
CGTGATACACCCTGAG	Hashtag5_Hashtag7
CGTGATACAGCGTTGC	Hashtag5
CGTGATATCATACGAC	Hashtag5
CGTGATATCGTTCCCA	Negative
CGTGCTTCACATTGTG	Negative
CGTGCTTGTATCTTCT	Negative
CGTGCTTTCTACCACC	Negative
CGTGCTTTCTGCGGAC	Negative
CGTGTCTAGGTATCTC	Hashtag5
CGTGTCTGTCCACTCT	Hashtag5
CGTGTCTTCAAGTGTC	Hashtag5
CGTGTCTTCTGTTCAT	Hashtag5
CGTTAGAAGAGGGTCT	Hashtag7
CGTTAGAAGAGTTCGG	Hashtag5_Hashtag7
CGTTAGATCCTAGCCT	Hashtag5_Hashtag7
CGTTAGATCTGTCCGT	Hashtag5
CGTTCTGAGGCAGGTT	Negative
CGTTCTGAGTCTGGAG	Hashtag7
CGTTCTGAGTGGAAAG	Negative
CGTTCTGCAGTATTCG	Hashtag5_Hashtag7
CGTTCTGCATAGAATG	Negative
CGTTCTGCATGGAGAC	Hashtag7
CGTTCTGGTGAGATAT	Negative
CTAACCCAGTAGCTCT	Negative
CTAACCCAGTGACACG	Hashtag5
CTAACCCCAGCTACTA	Hashtag5_Hashtag7
CTAACCCTCCGTGGGT	Hashtag5_Hashtag7
CTAACTTAGTATAGAC	Hashtag5_Hashtag7
CTAACTTCACTTCATT	Negative
CTAACTTCAGATAAAC	Hashtag7
CTAACTTGTATTCCTT	Hashtag5_Hashtag7
CTAACTTGTGACACAG	Hashtag7
CTAACTTTCGGCTATA	Negative
CTAAGTGAGATACGAT	Hashtag5
CTAAGTGAGCGTGAGT	Hashtag7
CTAAGTGAGCGTGTTT	Hashtag5
CTAAGTGAGCTTAGTC	Hashtag5
CTAAGTGAGGGCAGTT	Negative
CTAAGTGCAACTTCTT	Negative
CTAAGTGGTTGCGAAG	Hashtag5_Hashtag7
CTAAGTGTCAGGAAGC	Hashtag5_Hashtag7
CTACAGAAGAGTCCGA	Hashtag5
CTACAGACATAGAGGC	Hashtag5
CTACAGAGTTTACACG	Hashtag5
CTACAGATCTACGCGG	Negative
CTACAGATCTTCCCGA	Hashtag7
CTACATTAGAGATTCA	Hashtag7
CTACATTAGATGGTCG	Negative
CTACATTAGGATGAGA	Hashtag7
CTACATTAGGCGTTAG	Hashtag5_Hashtag7
CTACATTAGTCCCTAA	Negative
CTACATTCACAATGCT	Negative
CTACATTCAGACGATG	Negative
CTACATTGTCCCGTGA	Hashtag7
CTACATTTCGTCTAAG	Hashtag7
CTACCCAAGACCGTTT	Negative
CTACCCAAGATGGCAC	Hashtag5
CTACCCAAGCCAACCC	Hashtag5_Hashtag7
CTACCCAAGGGTTGCA	Hashtag7
CTACCCACAAGCTACT	Hashtag5_Hashtag7
CTACCCAGTGCCGAAA	Hashtag5
CTACCCAGTGTCGCTG	Hashtag5_Hashtag7
CTACCCAGTTCACCGG	Negative
CTACCTGCAGACTGCC	Negative
CTACCTGCATGACCCG	Hashtag5
CTACCTGGTAACATGA	Negative
CTACCTGTCGTGTCAA	Negative
CTACCTGTCTTTCCAA	Hashtag5_Hashtag7
CTACGGGAGCCGCTTG	Negative
CTACGGGAGCGCTGAA	Hashtag5_Hashtag7
CTACGGGAGTGAGTGC	Hashtag5_Hashtag7
CTACGGGCACAATTCG	Hashtag5_Hashtag7
CTACGGGGTGTTCAGT	Negative
CTACGGGGTTACCCTC	Hashtag5_Hashtag7
CTACGGGTCACCATCC	Hashtag5
CTACTATAGAACTGAT	Hashtag5
CTACTATAGTATAACG	Hashtag5
CTACTATCAACCGATT	Hashtag5
CTACTATCAACGGCTC	Negative
CTACTATTCGTGAGAG	Hashtag5_Hashtag7
CTACTATTCTTCACGC	Hashtag5
CTAGACAAGAGTATAC	Hashtag5
CTAGACAAGCATGAAT	Hashtag5_Hashtag7
CTAGACACATTGAAAG	Hashtag5_Hashtag7
CTAGACAGTAGAGGAA	Hashtag5
CTAGACAGTTTGTTCT	Hashtag7
CTAGACATCTCCTACG	Negative
CTAGGTACACGACCTG	Negative
CTAGGTACATCACGGC	Negative
CTAGGTACATCATCCC	Hashtag5
CTAGGTAGTAAGACCG	Hashtag5_Hashtag7
CTAGGTAGTACCGTGC	Negative
CTAGGTAGTGTCGATT	Negative
CTATAGGAGAAAGTCT	Hashtag5_Hashtag7
CTATAGGAGACCTCAT	Hashtag5_Hashtag7
CTATAGGAGATGACAT	Hashtag5_Hashtag7
CTATAGGAGTCGCCAC	Hashtag5_Hashtag7
CTATAGGCACTTGTGA	Hashtag7
CTATCCGAGACGACTG	Hashtag7
CTATCCGCACATTGTG	Hashtag5
CTATCCGCAGAGATTA	Negative
CTATCCGGTTGGCTAT	Hashtag5
CTATCCGGTTTACACG	Hashtag5_Hashtag7
CTATCCGTCACTCTTA	Negative
CTATCTAAGTCACTAC	Hashtag5
CTATCTACATCGATGT	Hashtag5_Hashtag7
CTATCTATCGAGATGG	Negative
CTCAACCAGTTGGAGC	Hashtag7
CTCAACCCAAGGCGTA	Hashtag5
CTCAACCCATAGGTTC	Hashtag5_Hashtag7
CTCAACCGTCGTTGGC	Hashtag5
CTCAACCTCAACCCGG	Hashtag5_Hashtag7
CTCAACCTCCCTAGGG	Hashtag5_Hashtag7
CTCAAGACAAATGATG	Hashtag5_Hashtag7
CTCAAGACAGCTGAAG	Hashtag5
CTCAAGAGTATGCTAC	Hashtag5
CTCAAGAGTCCTCATC	Hashtag5_Hashtag7
CTCAAGAGTTTCACAG	Hashtag5_Hashtag7
CTCAAGATCCAGTGTA	Hashtag7
CTCAAGATCTGAGCAT	Hashtag5
CTCAAGATCTGCATGA	Hashtag5
CTCAATTCAAAGGCTG	Negative
CTCAATTCAGGAATCG	Hashtag5_Hashtag7
CTCAATTGTGTCTCCT	Negative
CTCAATTGTTGACTAC	Hashtag5_Hashtag7
CTCAATTTCACTTGTT	Negative
CTCAATTTCTCACTCG	Hashtag5
CTCACTGAGAAGAGCA	Hashtag7
CTCACTGGTCTAGGCC	Negative
CTCACTGTCACATTGG	Hashtag5
CTCAGAAAGCCGTAAG	Hashtag5_Hashtag7
CTCAGAAAGCGAGGAG	Hashtag5_Hashtag7
CTCAGAACACCGGCTA	Negative
CTCAGAAGTGTAAACA	Negative
CTCAGAAGTTTAGACC	Negative
CTCAGGGGTGAATAAC	Negative
CTCAGGGGTTGGACTT	Hashtag5_Hashtag7
CTCAGGGTCCGAAATC	Hashtag5
CTCAGTCAGGCCTGAA	Hashtag5
CTCAGTCAGTGGATAT	Hashtag7
CTCAGTCGTACGCGTC	Negative
CTCAGTCGTAGTGATA	Hashtag5_Hashtag7
CTCAGTCGTGAGACCA	Hashtag5
CTCAGTCGTGCCCACA	Hashtag7
CTCAGTCGTGGAACCA	Hashtag5
CTCAGTCTCACACCCT	Negative
CTCAGTCTCAGCTAGT	Negative
CTCAGTCTCGTGGCTG	Hashtag5_Hashtag7
CTCATCGAGAATAGTC	Hashtag5_Hashtag7
CTCATCGGTACTCGCG	Hashtag7
CTCATCGGTAGTTCCA	Negative
CTCATCGGTCACCGAC	Hashtag5_Hashtag7
CTCATCGGTTAGAAAC	Negative
CTCATCGTCGCTCTAC	Negative
CTCATGCAGTTAGTGA	Hashtag5_Hashtag7
CTCATGCCAGTAGGAC	Negative
CTCATGCCATGGGTCC	Negative
CTCATGCGTCACTGAT	Hashtag5
CTCATGCGTGGGAGAG	Hashtag5
CTCATGCTCGGACAAG	Hashtag5
CTCATGCTCGGTCATA	Negative
CTCATTACACTGCATA	Hashtag5
CTCATTAGTAAGGTCG	Negative
CTCATTAGTACTCCGG	Negative
CTCATTAGTCGACGCT	Hashtag5
CTCATTATCCATGCAA	Hashtag7
CTCATTATCGCCTTTG	Hashtag7
CTCCAACCACACGTGC	Negative
CTCCAACCACATGAAA	Hashtag5_Hashtag7
CTCCAACGTGTAAATG	Hashtag5_Hashtag7
CTCCAACGTTTCCAAG	Hashtag5_Hashtag7
CTCCAACTCAAGCCTA	Hashtag7
CTCCACACAGGGAATC	Hashtag5
CTCCACAGTAACAGGC	Negative
CTCCACATCCCAGCGA	Hashtag5_Hashtag7
CTCCATGAGATACATG	Hashtag5
CTCCATGAGGTCTTTG	Hashtag5_Hashtag7
CTCCATGCACAAGCTT	Hashtag5
CTCCATGCAGCGTAGA	Negative
CTCCATGCATCTAGAC	Hashtag5_Hashtag7
CTCCATGTCTCTGACC	Hashtag5_Hashtag7
CTCCCAAAGACAGCTG	Hashtag5
CTCCCAAAGTCAGCCC	Negative
CTCCCAACAGGCTTGC	Hashtag5_Hashtag7
CTCCCAAGTATCACGT	Negative
CTCCCAAGTTAGGACG	Hashtag5
CTCCCAATCCCAATAG	Negative
CTCCCTCAGCACACCC	Hashtag5_Hashtag7
CTCCCTCAGCTAGAGC	Hashtag5
CTCCCTCCAGCGACCT	Hashtag5_Hashtag7
CTCCCTCCATAGTCAC	Hashtag7
CTCCCTCGTGACTGAG	Negative
CTCCCTCGTTGGCCTG	Hashtag5
CTCCCTCTCATTCGTT	Hashtag5_Hashtag7
CTCCCTCTCGGTTAGT	Hashtag5
CTCCGATAGACATAAC	Hashtag5
CTCCGATCAGGTATGG	Hashtag5_Hashtag7
CTCCGATTCACTCCGT	Hashtag7
CTCCGATTCCATACAG	Hashtag5_Hashtag7
CTCCTCCCAACACAAA	Negative
CTCCTCCGTATGGTAA	Hashtag5
CTCCTCCGTGATGAAT	Hashtag5_Hashtag7
CTCCTCCTCAGCTTGA	Hashtag5
CTCCTCCTCCAAAGGG	Hashtag5
CTCCTTTAGCACACCC	Hashtag5_Hashtag7
CTCCTTTAGCTAAATG	Negative
CTCCTTTAGGCATGCA	Negative
CTCCTTTAGTTTCGGT	Negative
CTCCTTTCAAGGTCAG	Negative
CTCCTTTCAAGTAGTA	Hashtag7
CTCCTTTCATATGCGT	Negative
CTCCTTTCATGCAGCC	Hashtag5
CTCCTTTGTAGTCACT	Hashtag7
CTCCTTTGTCCAAAGG	Hashtag7
CTCCTTTGTTCGGGTC	Negative
CTCCTTTTCTACTGAG	Hashtag5
CTCCTTTTCTCTGACC	Hashtag5
CTCCTTTTCTTCTGGC	Hashtag5_Hashtag7
CTCGAGGCAAGCAATA	Negative
CTCGAGGCACGACAGA	Hashtag5
CTCGAGGGTGACAACG	Negative
CTCTCAGAGTCGCGAA	Hashtag5
CTCTCAGAGTGTCATC	Hashtag5
CTCTCAGGTATCTTCT	Hashtag5
CTCTCAGGTGATACCT	Negative
CTCTCAGGTGATTAGA	Hashtag5_Hashtag7
CTCTCAGTCTACTATC	Hashtag7
CTCTCGACAAGACTGG	Hashtag7
CTCTCGACAGCGTGAA	Hashtag5
CTCTCGACATGGAGAC	Hashtag5_Hashtag7
CTCTCGAGTGACTATC	Hashtag7
CTCTCGAGTGTTAAAG	Hashtag5
CTCTCGAGTTCAACGT	Negative
CTCTCGAGTTCGGACC	Hashtag5
CTCTCGAGTTGGCTAT	Hashtag5
CTCTGGTAGGAACGCT	Hashtag5
CTCTGGTGTGTTCCAA	Hashtag5
CTCTGGTTCCCAACTC	Negative
CTGAATGAGACGGAAA	Hashtag5
CTGAATGAGGAGGTTC	Negative
CTGAATGAGGTAGCCA	Hashtag5_Hashtag7
CTGAATGAGGTAGGCT	Hashtag5
CTGAATGCAAAGCGTG	Hashtag5_Hashtag7
CTGAATGTCACTTCTA	Hashtag5
CTGAGCGAGTCATTGC	Hashtag5_Hashtag7
CTGAGCGCACCGAATT	Hashtag5_Hashtag7
CTGAGCGGTTAGGCTT	Negative
CTGAGGCAGATTGCGG	Negative
CTGAGGCAGTAAGACT	Hashtag5_Hashtag7
CTGAGGCCAATAGTCC	Negative
CTGAGGCTCTAGGAAA	Hashtag5
CTGATCCAGACCCGCT	Negative
CTGATCCAGACTCAAA	Negative
CTGATCCAGTCGCGAA	Hashtag5_Hashtag7
CTGATCCTCACTCACC	Hashtag7
CTGCAGGAGCCTGAGA	Hashtag5_Hashtag7
CTGCAGGCATACCAGT	Hashtag7
CTGCAGGCATCTAGAC	Hashtag5
CTGCAGGCATTATGCG	Hashtag5_Hashtag7
CTGCAGGGTGAGATTA	Negative
CTGCAGGGTGTACAGG	Negative
CTGCAGGTCCCTCTAG	Hashtag5
CTGCAGGTCGCACTCT	Hashtag5_Hashtag7
CTGCATCAGCCTCTGG	Negative
CTGCATCAGGACAGCT	Hashtag5_Hashtag7
CTGCATCCATGGAAGC	Hashtag5
CTGCATCGTGAGAGGG	Hashtag5
CTGCATCGTGCATGTT	Hashtag5
CTGCATCTCTCTAGGA	Hashtag7
CTGCCATAGAAGCCTG	Hashtag5_Hashtag7
CTGCCATAGTGAATAC	Hashtag5_Hashtag7
CTGCCATAGTTCTACG	Negative
CTGCCATCAATTTCTC	Hashtag7
CTGCCATGTCGTATTG	Hashtag7
CTGCCTAAGAGAGTGA	Hashtag5_Hashtag7
CTGCCTACACCTCTGT	Hashtag5_Hashtag7
CTGCCTACACTGAGTT	Hashtag5
CTGCCTATCGCTTGCT	Hashtag5_Hashtag7
CTGCCTATCGGCAGTC	Hashtag5_Hashtag7
CTGCGAGAGCCGTAAG	Hashtag5
CTGCGAGCACCTGCGA	Hashtag7
CTGCGAGCAGTTAGAA	Hashtag5_Hashtag7
CTGCGAGCATCGTCCT	Hashtag5_Hashtag7
CTGCGAGGTTCGTAAC	Hashtag7
CTGCGAGTCATCGCTC	Hashtag7
CTGCGAGTCCTGGCTT	Hashtag7
CTGCGAGTCGACCCAG	Hashtag5_Hashtag7
CTGCTCAAGACTACCT	Negative
CTGCTCACAACCAGAG	Negative
CTGCTCACAATGGCCC	Hashtag5
CTGCTCACAGACCGCT	Negative
CTGCTCACATCCGATA	Hashtag7
CTGCTCAGTCGTACTA	Hashtag5
CTGCTCAGTGTCCATA	Hashtag5
CTGCTCATCATTCGGA	Negative
CTGCTCATCCGATGCG	Negative
CTGGACGAGAAACCAT	Negative
CTGGACGAGACGACGT	Hashtag5_Hashtag7
CTGGACGAGATACAGT	Hashtag7
CTGGACGAGCTGGCCT	Hashtag5
CTGGACGAGGTGATAT	Hashtag5
CTGGACGCATAGATCC	Hashtag5_Hashtag7
CTGGACGGTCACCGCA	Hashtag7
CTGGACGGTGACCGTC	Hashtag5
CTGGACGTCGCACGGT	Negative
CTGGCAGCAGAGAAAG	Hashtag7
CTGGCAGCATGGGAAC	Hashtag5
CTGGCAGCATTGAGGG	Hashtag7
CTGGCAGGTCAACCTA	Negative
CTGGCAGGTGCATGAG	Hashtag5_Hashtag7
CTGGTCTAGTTGCCTA	Hashtag5
CTGGTCTGTTAGGGAC	Hashtag5
CTGGTCTGTTGGATCT	Hashtag5
CTGGTCTTCACTTCTA	Negative
CTGTACCAGAGGGTGG	Negative
CTGTACCGTAAGATTG	Negative
CTGTACCGTGGCCCAT	Hashtag7
CTGTACCGTTCGAAGG	Negative
CTGTAGAGTACGATGG	Hashtag5
CTGTAGAGTGTTATCG	Hashtag5
CTGTAGATCAGACAAA	Negative
CTGTAGATCCCAGTGG	Negative
CTGTAGATCGTCGACG	Negative
CTGTATTAGATACCAA	Hashtag5
CTGTATTAGCGAGTCA	Hashtag5_Hashtag7
CTGTATTCACAAGCTT	Hashtag5
CTGTATTGTCCACTCT	Hashtag7
CTGTATTGTTCTCTAT	Negative
CTGTATTTCTTCACGC	Hashtag5
CTGTCGTAGCTTGTGT	Hashtag7
CTGTCGTAGTATTGCC	Hashtag5
CTGTCGTGTTCTTGTT	Hashtag5
CTGTCGTTCGGCTGTG	Negative
CTGTGAAAGTTGTCGT	Hashtag7
CTGTGAACAAACTCGT	Negative
CTGTGAACATATGCGT	Negative
CTGTGAAGTGTACGCC	Negative
CTGTGAATCAGCTCTC	Negative
CTGTGAATCATATGGC	Negative
CTGTGGGAGTAATACG	Hashtag5
CTGTGGGCATTCGATG	Negative
CTGTGGGGTACCTATG	Negative
CTGTGGGGTGGTCCGT	Hashtag5_Hashtag7
CTTACCGAGCACTTTG	Hashtag5
CTTACCGAGCCTGTCG	Hashtag7
CTTACCGAGGTGTGAC	Hashtag5_Hashtag7
CTTACCGCACAAAGTA	Hashtag5
CTTACCGCAGCACGAA	Hashtag5_Hashtag7
CTTAGGAAGCCTGTCG	Hashtag5_Hashtag7
CTTAGGAAGGTTCCAT	Negative
CTTAGGACAACCAGAG	Hashtag5_Hashtag7
CTTAGGACACGCTGAC	Hashtag5
CTTAGGAGTTGTTGAC	Negative
CTTAGGATCGCTAAAC	Hashtag5
CTTCAATAGACAACAT	Hashtag5_Hashtag7
CTTCAATAGGGCATGT	Hashtag5
CTTCAATAGTCATGAA	Negative
CTTCAATAGTTACGTC	Negative
CTTCAATCATTCCTCG	Hashtag5
CTTCAATGTCAGACTT	Hashtag5_Hashtag7
CTTCAATTCGCTGTTC	Hashtag5_Hashtag7
CTTCAATTCTCAATCT	Hashtag7
CTTCAATTCTTACCGC	Hashtag5_Hashtag7
CTTCCGAAGATACGAT	Hashtag5_Hashtag7
CTTCCGAAGCCACTCG	Hashtag5
CTTCCGAAGGAACGCT	Negative
CTTCCGAAGTTTGAGA	Negative
CTTCCGACATGGGAAC	Hashtag5
CTTCCGATCTACACAG	Hashtag5
CTTCCTTGTGAAAGTT	Negative
CTTCCTTGTGGAGGTT	Hashtag7
CTTCCTTTCACTCGAA	Hashtag5
CTTCCTTTCTCCAAGA	Negative
CTTCGGTGTGGACCAA	Negative
CTTCGGTGTGGCTTGC	Hashtag5_Hashtag7
CTTCGGTTCAGTGGGA	Negative
CTTCGGTTCCACAGGC	Hashtag5
CTTCGGTTCCTGATAG	Hashtag5
CTTCGGTTCGAGCCAC	Hashtag7
CTTCGGTTCGTTGCCT	Negative
CTTCGGTTCTACAGGT	Hashtag5
CTTCGGTTCTAGAACC	Hashtag7
CTTCTAACAATACCTG	Negative
CTTCTAACAGATACCT	Negative
CTTCTAATCCTGCTAC	Hashtag5
CTTCTCTAGACAACAT	Hashtag7
CTTCTCTAGGACAACC	Negative
CTTCTCTAGGTTACAA	Negative
CTTCTCTGTTGCGGCT	Hashtag7
CTTCTCTTCATTCGTT	Hashtag5
CTTCTCTTCCCAGCGA	Hashtag5
CTTCTCTTCTGTTGGA	Hashtag5
CTTGAGAAGCTAAGTA	Negative
CTTGAGAAGGATACAT	Hashtag5
CTTGAGACACATACTG	Negative
CTTGAGACACCAGCCA	Hashtag5_Hashtag7
CTTGAGACAGGACTAG	Negative
CTTGAGAGTCCAGCGT	Negative
CTTGAGAGTTGGACCC	Hashtag7
CTTGAGATCCTTGGAA	Hashtag7
CTTGATTAGAAGGCTC	Hashtag5_Hashtag7
CTTGATTAGGCACTCC	Hashtag5
CTTGATTCACCATATG	Hashtag5_Hashtag7
CTTGATTCATCATCCC	Hashtag5
CTTGATTCATCTGCGG	Hashtag5
CTTGATTGTACATACC	Hashtag5
CTTGATTGTATTCCTT	Hashtag5
CTTTCAACACTTGGCG	Hashtag5
CTTTCAACAGCAGTTT	Hashtag5_Hashtag7
CTTTCAAGTAGACACG	Negative
CTTTCAAGTCCTGTTC	Hashtag5
CTTTCAATCTACCACC	Hashtag7
CTTTCGGAGAGACAAG	Hashtag7
CTTTCGGAGCCTCACG	Hashtag5
CTTTCGGAGGGCATGT	Hashtag5
CTTTCGGAGGTCATTC	Hashtag5
CTTTCGGGTATCAGGG	Hashtag7
CTTTCGGGTATCGTAC	Hashtag5
CTTTCGGGTCGCAACC	Negative
GAAACCTAGAACTGAT	Negative
GAAACCTAGACCAAAT	Hashtag5
GAAACCTAGGGTGAAA	Negative
GAAACCTGTAAGCTCT	Negative
GAAACCTGTAGCTTAC	Hashtag5
GAAACCTTCACCTGTC	Negative
GAAATGAAGCATACTC	Negative
GAAATGAAGCGTTACT	Hashtag5_Hashtag7
GAAATGACACCAGCGT	Hashtag5
GAAATGACACCCTAAA	Hashtag7
GAAATGACATATGAAG	Hashtag7
GAAATGAGTCTGTCAA	Hashtag5
GAAATGAGTGGCTAGA	Hashtag5
GAAATGAGTGGGTATG	Negative
GAAATGATCTCGCGTT	Hashtag7
GAAATGATCTCTGGTC	Negative
GAACACTCAATCCTAG	Hashtag5_Hashtag7
GAACACTCACCTCTGT	Hashtag5
GAACACTGTCTAATCG	Negative
GAACACTGTGGACCAA	Negative
GAACACTGTGTTCGAT	Hashtag5
GAACACTTCCGCAAAT	Hashtag5
GAACGTTCAATGTTGC	Negative
GAACGTTCATACATCG	Negative
GAACGTTCATTCACAG	Hashtag5
GAACGTTGTGCGGTAA	Hashtag5_Hashtag7
GAACGTTGTTCGGCGT	Negative
GAACGTTTCGCGCTGA	Negative
GAACTGTAGGTTTACC	Negative
GAACTGTCACCGTACG	Negative
GAACTGTCAGCGTAGA	Negative
GAACTGTCATCTATCT	Negative
GAACTGTGTCTGATAC	Negative
GAACTGTGTTCATCGA	Hashtag7
GAACTGTTCCGATGTA	Hashtag5_Hashtag7
GAACTGTTCTGCATGA	Hashtag5_Hashtag7
GAAGAATAGGTCATTC	Hashtag5
GAAGAATAGGTGGGTT	Hashtag5_Hashtag7
GAAGAATCAATAGGGC	Negative
GAAGAATCATACAGCT	Hashtag5
GAAGAATGTACGGATG	Hashtag5_Hashtag7
GAAGAATGTTTGAAAG	Hashtag5_Hashtag7
GAAGAATTCTACGGTA	Negative
GAAGCCCAGACGGATC	Hashtag5
GAAGCCCAGAGTCAGC	Hashtag5_Hashtag7
GAAGCCCAGCATGGGT	Hashtag7
GAAGCCCAGCGCTTCG	Negative
GAAGCCCCAGATCCTA	Hashtag5
GAAGCCCGTCATGACT	Hashtag5_Hashtag7
GAAGCCCGTTAGGGAC	Negative
GAAGCCCGTTCAGTAC	Negative
GAAGCCCTCCTGTACC	Negative
GAAGCCCTCGACGTCG	Hashtag5_Hashtag7
GAAGCGAAGACAGTCG	Hashtag5_Hashtag7
GAAGCGAAGCTCGCAC	Hashtag5_Hashtag7
GAAGCGAAGTCTAGAA	Hashtag5_Hashtag7
GAAGCGACACGCAGTC	Hashtag5
GAAGCGAGTCTGTGTA	Hashtag7
GAAGCGATCGAAGAAT	Hashtag5
GAAGGACAGGAAACGA	Hashtag5
GAAGGACCACGGTGAA	Hashtag5
GAAGGACGTACAAGCG	Hashtag5_Hashtag7
GAAGGACGTTACGCCG	Negative
GAAGGACTCCCTCGAT	Hashtag7
GAAGGACTCGAGATAA	Hashtag5
GAAGGACTCGGCAGTC	Hashtag5
GAAGGGTAGAGAGTGA	Hashtag7
GAAGGGTAGTCGGCAA	Hashtag5
GAAGGGTGTGGAAGTC	Hashtag5
GAAGGGTGTTCGGACC	Hashtag5
GAAGGGTTCTCTATGT	Hashtag5
GAAGTAACAGCACACC	Hashtag5_Hashtag7
GAAGTAACAGCCTTCT	Negative
GAAGTAACATGCCATA	Hashtag7
GAAGTAATCGGCATAT	Negative
GAATAGAAGACGATAT	Hashtag5
GAATAGACAGTCAGCC	Hashtag5
GAATAGAGTATACCTG	Negative
GAATAGAGTGCAATAA	Hashtag5
GAATAGATCCCTGGTT	Negative
GAATCACAGACCTTTG	Negative
GAATCACAGTCGGGAT	Hashtag5
GAATCACCACTTCCTG	Hashtag5_Hashtag7
GAATCACCAGAGTAAT	Hashtag7
GAATCACGTGTTTACG	Negative
GAATCACTCAGGAACG	Hashtag5
GAATCACTCAGGGATG	Negative
GAATCACTCGCAAGAG	Hashtag5
GAATCACTCTAGCCTC	Negative
GAATCGTCAGGGAATC	Hashtag5
GAATCGTGTACAGTAA	Negative
GAATCGTTCCAACCGG	Hashtag5
GAATCGTTCGACGATT	Negative
GACACGCAGACACACG	Hashtag7
GACACGCAGGGATCTG	Hashtag5
GACACGCCATCGATAC	Hashtag7
GACACGCTCCAACACA	Negative
GACACGCTCGTTCAGA	Negative
GACACGCTCTTGCAGA	Hashtag5
GACAGCCCACAAGTGG	Negative
GACAGCCGTACCTAAC	Hashtag5
GACAGCCGTTACCTTT	Hashtag5_Hashtag7
GACAGCCGTTTGGAGG	Hashtag5
GACAGCCTCCTAACAG	Hashtag5_Hashtag7
GACATCACAACTCATG	Hashtag7
GACATCACAGTCCGTG	Hashtag7
GACATCAGTAGGCTCC	Negative
GACATCAGTTCCAGGC	Negative
GACATCATCCAATCCC	Hashtag5_Hashtag7
GACATCATCGTAACTG	Negative
GACATCATCGTTAGTG	Negative
GACCAATCATCCGGCA	Negative
GACCAATGTAAGGAGA	Hashtag5_Hashtag7
GACCAATGTCAAAGTA	Negative
GACCAATGTCACTTAG	Hashtag5
GACCAATTCACTTTGT	Hashtag7
GACCAATTCGCTGCGA	Hashtag5
GACCCAGAGGAGGGTG	Negative
GACCCAGCAAGTATAG	Hashtag5
GACCCAGGTAAGGCCA	Negative
GACCCTTAGTCTTCCC	Hashtag7
GACCCTTCAACGGCCT	Negative
GACCCTTCAAGTGGCA	Negative
GACCCTTCAATAGTGA	Negative
GACCCTTCAGACCGCT	Negative
GACCCTTGTACAACGG	Negative
GACCCTTTCACTAGCA	Negative
GACCGTGCACAGACGA	Negative
GACCGTGGTCGAGATG	Hashtag5
GACCGTGGTTACCCTC	Negative
GACCGTGTCACTGGGC	Negative
GACCTTCAGCGTCTCG	Negative
GACCTTCAGGCCCAAA	Negative
GACCTTCAGTGCGCTC	Hashtag7
GACCTTCCACCTGTCT	Negative
GACCTTCCAGAGACTG	Hashtag7
GACCTTCGTTTGGCTA	Hashtag5
GACCTTCTCGTAGCTA	Negative
GACGCTGGTATCGCTA	Hashtag5
GACGCTGTCCGAGAAG	Hashtag5_Hashtag7
GACGCTGTCCTGGTCT	Negative
GACGTTACACTTCTCG	Hashtag5
GACGTTACAGACCATT	Negative
GACGTTAGTCCATCTC	Hashtag5
GACTATGCAATACGCT	Hashtag5_Hashtag7
GACTATGCACAAATCC	Hashtag7
GACTATGCATTGCCGG	Negative
GACTATGGTGTGTGGA	Hashtag5
GACTATGTCTCAGAAC	Hashtag5
GACTATGTCTGTTCAT	Negative
GACTCAAAGACAACTA	Hashtag7
GACTCAAAGCTGCCAC	Negative
GACTCAAAGCTTCGTA	Negative
GACTCAACAAATCGTC	Hashtag5
GACTCAACAACCCTCT	Hashtag5
GACTCAAGTATTGCCA	Negative
GACTCAAGTTTGCCGG	Hashtag5
GACTCAATCAAGCTGT	Hashtag7
GACTCAATCGGCTGTG	Negative
GACTCAATCGTGCTCT	Hashtag5_Hashtag7
GACTCTCAGATCACCT	Negative
GACTCTCCAATCGAAA	Hashtag5_Hashtag7
GACTCTCGTGACTAAA	Negative
GACTCTCGTGTCATTG	Negative
GACTCTCTCCTCATAT	Hashtag5
GACTCTCTCTCTCTAA	Negative
GACTGATAGGTGCTTT	Hashtag5
GACTGATAGGTTTACC	Hashtag5_Hashtag7
GACTGATAGTTAGTGA	Hashtag5
GACTGATCACTAGTAC	Negative
GACTGATCACTTCAAG	Hashtag5_Hashtag7
GACTGATGTGTGTTTG	Hashtag5
GACTGATGTTACCCAA	Hashtag5
GACTGATTCCCACAGG	Hashtag7
GACTGATTCGACCTAA	Hashtag5
GACTTCCAGATAGCAT	Negative
GACTTCCCAACAAGTA	Negative
GACTTCCTCAAGCGTT	Negative
GACTTCCTCCTGGGAC	Hashtag5
GAGAAATAGCATCAGG	Hashtag5
GAGAAATCAAGACAAT	Negative
GAGAAATCAAGTCCAT	Hashtag5
GAGAAATCAATTTCGG	Hashtag5
GAGAAATCAGTGCCTG	Negative
GAGAAATCATACCGTA	Hashtag5_Hashtag7
GAGAAATCATGGAACG	Negative
GAGAAATGTCGGATTT	Negative
GAGAAATGTGCCTAAT	Negative
GAGAAATGTGGTATGG	Hashtag5
GAGAAATGTGTCCAAT	Hashtag7
GAGACCCAGGACAACC	Negative
GAGACCCAGGGCCCTT	Negative
GAGACCCCACACCAGC	Hashtag5_Hashtag7
GAGACCCCAGAGTTCT	Negative
GAGACCCCAGGCGTTC	Hashtag5
GAGACCCTCGACGATT	Hashtag7
GAGACCCTCTATCGTT	Negative
GAGACTTAGAAGCTGC	Hashtag5
GAGACTTAGAATTGCA	Negative
GAGACTTAGACTCCGC	Hashtag5
GAGACTTTCCCATGGG	Negative
GAGACTTTCCTCTAAT	Hashtag5_Hashtag7
GAGACTTTCTCCTGCA	Negative
GAGAGGTCAACTGATC	Hashtag5
GAGAGGTCAATAACCC	Hashtag7
GAGAGGTCACCAGCCA	Hashtag5
GAGAGGTGTAGACAGC	Hashtag5
GAGAGGTGTCGTATTG	Negative
GAGAGGTTCCCTCAAC	Negative
GAGAGGTTCGACGTCG	Hashtag5_Hashtag7
GAGAGGTTCGCCGAGT	Negative
GAGAGGTTCGTGCACG	Negative
GAGATGGTCCGAGAAG	Negative
GAGCCTGAGAGTACCG	Hashtag7
GAGCCTGAGATTGCGG	Negative
GAGCCTGAGCCACTCG	Negative
GAGCCTGAGCCTTTCC	Negative
GAGCCTGCAGGCCCTA	Hashtag5
GAGCCTGCAGTCTTCC	Negative
GAGCCTGCATCGGATT	Hashtag5
GAGCCTGCATCGTGCG	Hashtag5_Hashtag7
GAGCCTGCATTCAGCA	Negative
GAGCCTGGTAAGACCG	Hashtag5_Hashtag7
GAGCCTGGTCGTTCAA	Negative
GAGCTGCAGAAGGCTC	Negative
GAGCTGCCAACACAAA	Negative
GAGCTGCCAAGCTGCC	Hashtag5
GAGCTGCGTGGCTGAA	Negative
GAGCTGCTCAAGATAG	Negative
GAGCTGCTCTGGAGAG	Negative
GAGGCAAAGATAACGT	Negative
GAGGCAAAGTGTACAA	Negative
GAGGCAAGTATACAGA	Hashtag5
GAGGCAAGTCGTATTG	Hashtag5
GAGGCAAGTCTCCCTA	Hashtag5
GAGGCAAGTTATCTTC	Hashtag7
GAGGCAATCCCAGGAC	Negative
GAGGCAATCTCATAGG	Negative
GAGGCCTCAAAGGAGA	Negative
GAGGCCTCACAAAGTA	Negative
GAGGCCTCACCCAACG	Negative
GAGGCCTCAGCAAGAC	Negative
GAGGCCTCAGTTAGAA	Hashtag7
GAGGCCTTCATGGGAG	Hashtag7
GAGGCCTTCTTTCTAG	Negative
GAGGGATAGCGTATAA	Hashtag7
GAGGGATCAACTGTGT	Negative
GAGGGATCAAGACTGG	Negative
GAGGGATCACTCTAGA	Hashtag5
GAGGGATCATCGGAGA	Negative
GAGGGATCATGCCATA	Negative
GAGGGATTCAAACGTC	Negative
GAGGGATTCAGAATAG	Negative
GAGGGTAAGACACACG	Negative
GAGGGTAAGACCCGCT	Hashtag5_Hashtag7
GAGGGTAAGGACAGTC	Negative
GAGGGTACAAGTGGGT	Negative
GAGGGTACAGTCAGAG	Hashtag5
GAGGGTAGTTCTCGTC	Negative
GAGTCATTCAACCTCC	Negative
GAGTCATTCACCTACC	Negative
GAGTCATTCCATCTGC	Hashtag5
GAGTCATTCCGTTGAA	Negative
GAGTCATTCGAGAGCA	Negative
GAGTCATTCGTTACCC	Negative
GAGTCTAAGATTCGAA	Negative
GAGTCTAAGCCACAAG	Negative
GAGTCTAAGTGGCGAT	Negative
GAGTCTATCAAGGACG	Negative
GAGTCTATCGCGGACT	Hashtag5
GAGTGAGAGGCCGCTT	Hashtag7
GAGTGTTAGAACCGCA	Negative
GAGTGTTAGTCACTAC	Negative
GAGTGTTCAAGAGTTA	Negative
GAGTGTTCATAACCCA	Negative
GAGTGTTGTATTGAGA	Hashtag7
GAGTGTTTCACATTGG	Negative
GAGTTACAGCTCATAC	Negative
GAGTTACAGTGTACCT	Negative
GAGTTACCAGAGGGTT	Hashtag5
GAGTTACCAGGCGTTC	Negative
GAGTTACGTAATTAGG	Negative
GAGTTGTAGACTTCAC	Negative
GAGTTGTCACGACGAA	Negative
GAGTTGTGTGTCCACG	Negative
GAGTTGTTCAAGGACG	Hashtag5
GAGTTTGAGAACTTCC	Hashtag7
GAGTTTGAGTGGTGAC	Negative
GAGTTTGGTCGCCACA	Negative
GAGTTTGGTCTGCAAT	Hashtag5
GATAGAAAGAGTACCG	Negative
GATAGAAAGTAGAGTT	Hashtag5
GATAGAAGTGTCTCCT	Negative
GATAGAATCCTCTTTC	Negative
GATAGAATCGACGTCG	Hashtag5
GATAGCTTCTTAGCAG	Hashtag7
GATCACAAGAGGTTTA	Hashtag5
GATCACAAGTAACGAT	Negative
GATCACACATGCACTA	Hashtag5_Hashtag7
GATCACATCCGATCGG	Hashtag5_Hashtag7
GATCACATCTCATGGA	Negative
GATCACATCTGCCCTA	Negative
GATCAGTAGACATATG	Hashtag5
GATCAGTCAGGAGGTT	Hashtag5
GATCAGTGTCTGCATA	Negative
GATCAGTTCAACCTCC	Negative
GATCAGTTCGGTTGTA	Hashtag7
GATCATGAGGGCAGAG	Hashtag5
GATCATGCATCTGGGC	Negative
GATCATGGTCCAGAAG	Hashtag5
GATCATGGTGAATGAT	Hashtag5_Hashtag7
GATCATGGTGTTCGAT	Hashtag5
GATCATGGTTTGAACC	Negative
GATCATGTCACCACAA	Negative
GATCATGTCCTAACAG	Negative
GATCCCTCAAACTAAG	Hashtag7
GATCCCTCAACCGGAA	Negative
GATCCCTGTCACTCTC	Negative
GATCCCTGTTAGAAAC	Negative
GATCCCTGTTGTGTTG	Negative
GATCCCTTCTCAGAAC	Negative
GATCGTACATACTGTG	Hashtag5
GATGACTCACAACATC	Hashtag5
GATGACTGTACTCGAT	Negative
GATGACTGTTACGATC	Hashtag5_Hashtag7
GATGACTTCCGGCAAC	Negative
GATGACTTCGTTATCT	Hashtag5
GATGACTTCTGGCTGG	Negative
GATGACTTCTGGTGGC	Hashtag5
GATGAGGCATGAGGGT	Hashtag7
GATGATCCAGATAAAC	Negative
GATGATCCAGCCCAGT	Negative
GATGATCGTATGTCTG	Hashtag7
GATGATCGTCATAACC	Negative
GATGATCTCAGAGCGA	Negative
GATGCTAAGAGTTGAT	Hashtag5
GATGCTAAGGTAGACC	Negative
GATGCTACAAGAGGTC	Hashtag5
GATGCTACACGAAGAC	Hashtag5_Hashtag7
GATGCTACAGGGTCTC	Negative
GATGCTAGTTATTCTC	Negative
GATGCTATCAGCAGAG	Hashtag7
GATGCTATCAGTGTGT	Negative
GATGCTATCATGAGGG	Hashtag5
GATGCTATCTGCGGGT	Negative
GATGGAGAGGGAGTGG	Hashtag5
GATGGAGAGGTAGTCG	Negative
GATGGAGCAGCACAGA	Hashtag7
GATGGAGTCGGTAACT	Hashtag5
GATGTTGCAACCGTGC	Negative
GATGTTGCATCTGTTT	Hashtag5
GATGTTGTCACTTGTT	Hashtag5
GATTCGACAATCGCCG	Negative
GATTCGACACGCGCAT	Hashtag5
GATTCGACAGGCCCTA	Hashtag5
GATTCGACATCGAAGG	Hashtag5
GATTCGAGTAGCTTTG	Hashtag5_Hashtag7
GATTCGAGTATACAGA	Hashtag5
GATTCGAGTGGATACG	Hashtag5
GATTCTTCACCGTCGA	Negative
GATTCTTCAGAGATTA	Negative
GATTCTTTCTCTCGCA	Hashtag5
GATTCTTTCTTCCACG	Hashtag5
GATTGGTAGCTACGTT	Negative
GATTGGTCAGACACAG	Hashtag5
GATTGGTCAGCTGAGA	Hashtag5
GATTGGTCATCCGTTC	Negative
GATTGGTTCATGAGGG	Negative
GATTTCTCACGACAGA	Negative
GATTTCTCATGTGCCG	Negative
GATTTCTGTTTCCAAG	Negative
GATTTCTTCCGTGGCA	Negative
GCAACATCACGTTCGG	Negative
GCAACATGTAGACGTG	Hashtag5
GCAACATTCCTTCTGG	Hashtag5_Hashtag7
GCAACCGAGCAAATGT	Negative
GCAACCGAGCATCGAG	Hashtag7
GCAACCGGTGCCGTAC	Hashtag5
GCACATAAGCAACCAG	Hashtag5
GCACATACAAATTGCC	Hashtag5
GCACATACACGGTGCT	Hashtag5
GCACATACACTGGACC	Negative
GCACATAGTCTCTCTG	Negative
GCACATAGTTGTGTAC	Negative
GCACGGTGTAGCGTTT	Hashtag5
GCACGGTGTCACCGCA	Hashtag5
GCACGGTTCAAGCCAT	Negative
GCACGGTTCATTATCC	Hashtag5
GCACGGTTCCTGATAG	Hashtag7
GCACGGTTCGTGAGAG	Hashtag5
GCACGTGAGGTCCCTG	Negative
GCACGTGCAACCTATG	Hashtag7
GCACGTGCAGAGTTGG	Hashtag5
GCACGTGGTCGCCTAG	Negative
GCACGTGGTGTTGAGG	Hashtag5
GCACGTGTCGAAGGAC	Hashtag5
GCACGTGTCTGTGCAA	Negative
GCACTAAAGTCTGGTT	Hashtag5
GCACTAACAAGGCTTT	Hashtag7
GCACTAAGTAGTGGCA	Negative
GCACTAATCATGCCAA	Hashtag5_Hashtag7
GCACTAATCGGCTCTT	Hashtag5
GCAGCCACAACAACAA	Negative
GCAGCCACAGAACTCT	Hashtag7
GCAGCCACAGACATCT	Hashtag7
GCAGCCAGTAGGCTGA	Hashtag7
GCAGCCAGTCTAGGCC	Hashtag5
GCAGCCAGTTCAGGTT	Negative
GCAGCTGAGGGCAACT	Negative
GCAGCTGCAGCACAGA	Hashtag5
GCAGCTGGTAGTAAGT	Negative
GCAGCTGGTCGTTATG	Negative
GCAGCTGGTGAGATTA	Negative
GCAGCTGGTGGCTAGA	Hashtag7
GCAGCTGTCCCTGTTG	Hashtag7
GCAGGCTAGACCTTTG	Hashtag5
GCAGGCTCAACCCGCA	Hashtag5
GCAGGCTCATCAGCTA	Hashtag7
GCAGGCTGTACAACGG	Hashtag7
GCAGGCTGTACATACC	Negative
GCAGGCTGTAGCTAAA	Negative
GCAGGCTGTCCAGCGT	Negative
GCAGTTAAGACTCAAA	Negative
GCAGTTAGTGTCCTAA	Hashtag5
GCAGTTAGTTCAAGGG	Negative
GCAGTTATCAGCGCGT	Negative
GCAGTTATCGTTAGAC	Negative
GCATCGGAGGCTTAAA	Hashtag5
GCATCGGCAGGGTTGA	Hashtag5
GCATCGGGTGGTTTAC	Hashtag5_Hashtag7
GCATCTCAGTCTACCA	Hashtag7
GCATCTCCACGACGTC	Hashtag5
GCATCTCGTATCGTGT	Negative
GCATCTCTCGGCGATC	Negative
GCATGATAGCGACTGA	Hashtag7
GCATGATCAGTTGAAA	Hashtag5
GCATGATCATAGCTGT	Negative
GCATGATGTAGGCTGA	Hashtag5
GCATGATGTCTTCATT	Hashtag7
GCATTAGCACGAGAAC	Hashtag5
GCATTAGCATAATCCG	Hashtag5
GCATTAGGTAGCTTTG	Hashtag5
GCATTAGGTCCGAAGA	Hashtag5
GCCAACGAGACGCCAA	Negative
GCCAACGCAAGTGCTT	Hashtag5
GCCAACGCATAAGCGG	Hashtag5
GCCAACGTCAACTTTC	Hashtag5
GCCAACGTCCAGCCTT	Hashtag5
GCCAACGTCCCATTCG	Hashtag7
GCCAACGTCTTCCCGA	Negative
GCCAGCAAGCTCGGCT	Hashtag7
GCCAGCAAGTAGTCCT	Hashtag5_Hashtag7
GCCAGCAGTCCGAAAG	Negative
GCCAGCATCCCATGGG	Hashtag7
GCCAGGTAGGATACAT	Hashtag5
GCCAGGTCACGGCCAT	Negative
GCCAGGTGTACAGCGA	Hashtag5
GCCAGGTGTACCACGC	Hashtag5_Hashtag7
GCCAGGTGTGATTCTG	Negative
GCCAGGTTCATTCGGA	Hashtag5
GCCAGTGAGCGTTAGG	Hashtag7
GCCAGTGAGGACGCAT	Negative
GCCAGTGCACAATGAA	Hashtag5
GCCAGTGCACGCGGTT	Hashtag5
GCCAGTGGTCATGGCC	Negative
GCCAGTGTCACCTACC	Hashtag7
GCCAGTGTCCATGATG	Negative
GCCATGGAGTTTAGGA	Hashtag5
GCCATGGGTAGAGCTG	Hashtag5
GCCATGGGTCCACTTC	Negative
GCCATGGTCATTGGTG	Hashtag5
GCCATTCGTTACGCCG	Hashtag5
GCCATTCTCACCTGTC	Negative
GCCCAGAAGAGGCGTT	Hashtag7
GCCCAGAAGCTTAAGA	Hashtag5
GCCCAGAAGGCAATGC	Hashtag5
GCCCAGAAGGCTATCT	Hashtag5
GCCCAGACAACCGTGC	Negative
GCCCAGACAAGATGGC	Negative
GCCCAGACAAGTAGTA	Negative
GCCCAGAGTTGGAGGT	Negative
GCCCAGATCGGTCTAA	Hashtag5_Hashtag7
GCCCAGATCGTTAGTG	Negative
GCCCGAAAGCCGCACT	Hashtag7
GCCCGAACACTAACCA	Negative
GCCCGAAGTAGCGTAG	Negative
GCCCGAAGTATCAGCT	Hashtag5
GCCCGAAGTCGTATTG	Negative
GCCGATGCAGCATTGT	Negative
GCCGATGGTAATGCGG	Negative
GCCGATGGTGTTTGCA	Negative
GCCGATGTCAAACTGC	Hashtag5_Hashtag7
GCCGATGTCGATCCAA	Hashtag5
GCCGATGTCTCTCAAT	Negative
GCCGTGAAGGAAGTGA	Negative
GCCGTGACAGCAGGAT	Negative
GCCGTGACAGCGAGTA	Negative
GCCGTGACATGTGGTT	Hashtag7
GCCGTGAGTGAAAGTT	Hashtag7
GCCGTGATCATCGACA	Negative
GCCGTGATCTTTGATC	Hashtag7
GCCTGTTAGCCTTGAT	Hashtag5
GCCTGTTCAGGGTCTC	Negative
GCCTGTTGTGCGGCTT	Hashtag5
GCGAGAAAGAGGCGGA	Hashtag5
GCGAGAAGTAATCAAG	Hashtag7
GCGAGAAGTGTTGAGG	Hashtag5
GCGAGAATCGATGGAG	Hashtag5_Hashtag7
GCGATCGAGCACCAGA	Negative
GCGATCGCAGAAGTTA	Hashtag5_Hashtag7
GCGATCGCAGAGCTAG	Hashtag7
GCGATCGCAGCAGGAT	Hashtag5_Hashtag7
GCGATCGGTTGATCGT	Negative
GCGATCGTCAACCTCC	Hashtag5
GCGATCGTCAAGTAAG	Hashtag5
GCGATCGTCACTTCTA	Negative
GCGATCGTCCGATAGT	Hashtag5
GCGATCGTCTGCGGGT	Hashtag5_Hashtag7
GCGGAAACAGAATTCC	Hashtag5
GCGGAAAGTACCAGAG	Negative
GCGGAAAGTATATGGA	Hashtag5
GCGGAAAGTGTAGGAC	Negative
GCGGAAATCCCGTTGT	Negative
GCGGAAATCTGGGCCA	Hashtag7
GCGGATCGTCTTCGAA	Negative
GCGGATCGTTGAAGTA	Negative
GCGGATCTCCCAGCGA	Negative
GCGTTTCAGTTTAGGA	Negative
GCGTTTCCAGAGGACT	Negative
GCGTTTCGTTGCCGCA	Negative
GCGTTTCTCATAGAGA	Hashtag5
GCGTTTCTCGGTGTAT	Negative
GCTACAAAGACGGAAA	Negative
GCTACAAAGGGATCTG	Negative
GCTACAAAGTGATTCC	Negative
GCTACAAAGTTGCGAG	Negative
GCTACAACAAGATCCT	Hashtag7
GCTACAATCCGATCGG	Hashtag7
GCTACAATCTCATGCC	Hashtag5_Hashtag7
GCTACCTCACGCGTCA	Negative
GCTACCTCATTGCCGG	Hashtag5
GCTACCTGTGTATCCA	Negative
GCTACCTGTGTGTGTT	Hashtag5
GCTACCTTCCACGGAC	Negative
GCTCAAACAGAGAAAG	Negative
GCTCAAACATAGGTTC	Negative
GCTCAAAGTAAGATCA	Hashtag7
GCTCAAAGTGACAGGT	Hashtag5
GCTCAAATCATTTCGT	Hashtag5
GCTCAAATCCTGGGTG	Negative
GCTCAAATCTGTTGGA	Hashtag5
GCTGAATAGTGTTCAC	Hashtag5_Hashtag7
GCTGAATCACAGCTTA	Hashtag7
GCTGAATCAGCAGGAT	Hashtag7
GCTGAATGTGATTCAC	Negative
GCTGAATGTGGAACCA	Negative
GCTGAATTCCTACGGG	Hashtag5
GCTGAATTCGACGATT	Hashtag5
GCTGCAGAGGTGAGAA	Negative
GCTGCAGAGTCATCGT	Negative
GCTGCAGGTCGTGATT	Hashtag5
GCTGCAGGTGCTATTG	Negative
GCTGCAGTCAGACTGT	Hashtag5
GCTGGGTAGGGAACAA	Negative
GCTGGGTCACTACTTT	Negative
GCTGGGTGTACACGTT	Hashtag5
GCTGGGTTCGTTCATT	Negative
GCTTCACCAACTAGAA	Hashtag5
GCTTCACCACCGCTGA	Hashtag5
GCTTCACCAGTTCACA	Hashtag5_Hashtag7
GCTTCACGTACGGTTT	Negative
GCTTCACGTTTGGCTA	Negative
GCTTCACTCCGCGATG	Hashtag7
GCTTGGGAGATAGTGT	Negative
GCTTGGGAGGCAGGGA	Negative
GCTTGGGCATGCCATA	Negative
GCTTGGGGTATCACGT	Negative
GCTTGGGGTTTACCAG	Negative
GCTTGGGGTTTCGGCG	Negative
GCTTGGGTCCAAGGGA	Negative
GCTTTCGAGACCAAAT	Hashtag7
GCTTTCGAGGTGATAT	Negative
GCTTTCGGTAGCCCTG	Negative
GCTTTCGGTAGCTGCC	Negative
GCTTTCGGTTAGGGTG	Negative
GCTTTCGTCGGACAAG	Negative
GCTTTCGTCTGTTGGA	Hashtag5
GGAACCCCATGCCGAC	Hashtag7
GGAACCCGTATTTCTC	Negative
GGAAGTGAGATAGTCA	Hashtag5_Hashtag7
GGAAGTGGTTATGTCG	Negative
GGAAGTGGTTCTCCTG	Hashtag7
GGAAGTGTCATCCTGC	Negative
GGAATCTAGTCTACCA	Hashtag5
GGAATCTAGTTCATCG	Hashtag7
GGAATCTTCGAGATGG	Negative
GGAATCTTCGAGCCTG	Hashtag7
GGAATGGAGAGTGAAG	Hashtag5
GGAATGGCAAGTATCC	Hashtag7
GGAATGGCACGTAGTT	Negative
GGAATGGGTCGACTTA	Hashtag5_Hashtag7
GGACGTCGTATGAGGC	Negative
GGACGTCGTTGTTGAC	Negative
GGACGTCTCAAGAAAC	Hashtag5
GGAGAACAGGCATCAG	Negative
GGAGAACGTATACGGG	Hashtag5_Hashtag7
GGAGAACGTGCTCGTG	Negative
GGAGAACGTTCCACGG	Hashtag5
GGAGAACGTTGGTAGG	Negative
GGAGAACTCATCGGGC	Hashtag5_Hashtag7
GGAGAACTCGGACAAG	Hashtag5
GGAGATGAGGCTATCT	Negative
GGAGATGCAACAAAGT	Negative
GGAGATGCAGTGAGCA	Negative
GGAGATGGTCACAGAG	Negative
GGAGATGTCAGTCATG	Hashtag5
GGAGCAAAGAAGATCT	Negative
GGAGCAAAGCGAGAAA	Hashtag5
GGAGCAACAAGATGTA	Hashtag7
GGAGCAACAGAACTAA	Negative
GGAGCAACATATGAAG	Hashtag7
GGAGCAAGTACCTTCC	Hashtag5
GGAGCAAGTATCGAGG	Hashtag5
GGAGCAAGTCAGACGA	Hashtag7
GGAGCAAGTGATTCTG	Hashtag5
GGAGCAATCAGTGCGC	Hashtag5
GGAGCAATCCATAGAC	Negative
GGAGCAATCCTGCTAC	Hashtag5_Hashtag7
GGAGGATCACGGAAGT	Hashtag5_Hashtag7
GGAGGATTCGAAGCAG	Hashtag7
GGAGGTAAGCAGTCTT	Hashtag7
GGAGGTACACAAGTTC	Hashtag5_Hashtag7
GGAGGTACATCCCGTT	Negative
GGAGGTAGTCTAATCG	Hashtag5
GGAGGTATCTGTTCAT	Negative
GGATCTAAGCGGTATG	Hashtag7
GGATCTAAGTACCCTA	Negative
GGATCTACAACTCCCT	Negative
GGATCTACATCAGTGT	Negative
GGATCTAGTCATAACC	Negative
GGATCTAGTCCTCCAT	Hashtag5
GGATCTAGTTATCTTC	Hashtag5
GGATCTATCACTACGA	Negative
GGATGTTAGCCTATTG	Hashtag5
GGATGTTAGGCTAAAT	Hashtag5_Hashtag7
GGATGTTCAGTCGTTA	Negative
GGATGTTCATCAGCAT	Negative
GGATGTTGTAAGGTCG	Negative
GGATGTTGTCCCTAAA	Hashtag5
GGATGTTTCCATAGAC	Negative
GGATGTTTCGAGTGAG	Hashtag5
GGCACGTCACTCCCTA	Negative
GGCACGTCAGGTCTCG	Negative
GGCACGTGTAATGATG	Negative
GGCACGTTCTACCCAC	Hashtag5
GGCAGTCCAAGGGCAT	Negative
GGCAGTCCACAGTATC	Hashtag5
GGCAGTCCAGCCGTTG	Hashtag5_Hashtag7
GGCAGTCGTACAAACA	Negative
GGCAGTCGTACTTGTG	Hashtag5
GGCAGTCGTTCGAAGG	Hashtag5_Hashtag7
GGCAGTCTCATGAAAG	Negative
GGCAGTCTCTACGGGC	Negative
GGCGTCAAGCTAGAAT	Hashtag7
GGCGTCAAGGACCCAA	Negative
GGCGTCACAACTTGGT	Negative
GGCGTCACAAGTGCTT	Hashtag5
GGCGTCACATATAGCC	Hashtag5_Hashtag7
GGCGTCAGTAGCTTTG	Hashtag5
GGCGTCATCGTCAAAC	Negative
GGCGTCATCTGCGGGT	Negative
GGCTGTGCAAGCAATA	Negative
GGCTGTGCAATGGCAG	Negative
GGCTGTGCATAGAGGC	Hashtag5_Hashtag7
GGCTGTGTCAATCCGA	Negative
GGCTGTGTCTGTACAG	Hashtag7
GGCTTGGAGATGACCG	Negative
GGCTTGGAGGATAATC	Hashtag7
GGCTTGGCATCCGGCA	Negative
GGCTTGGGTCAGCTTA	Negative
GGCTTGGGTCCGGCAT	Negative
GGCTTGGGTTTGTGGT	Hashtag7
GGCTTTCAGGAACATT	Hashtag5
GGCTTTCAGTTTCTTC	Negative
GGCTTTCCACGATTCA	Hashtag5_Hashtag7
GGCTTTCCACGCCACA	Hashtag7
GGCTTTCCAGAGTCAG	Hashtag7
GGCTTTCGTGCATGTT	Negative
GGCTTTCGTGGTTTGT	Negative
GGCTTTCGTTGTAGCT	Negative
GGCTTTCTCATCTATC	Negative
GGCTTTCTCATGCCAA	Negative
GGGAAGTTCCGTAGGC	Hashtag5
GGGAAGTTCGCTCTCA	Hashtag5
GGGACAAAGATCACCT	Negative
GGGACAAAGGAATTAC	Negative
GGGACAACACTGGCCA	Hashtag5
GGGACAAGTGTGTCGC	Negative
GGGACAATCAAGCTGT	Negative
GGGACAATCCAAGCTA	Hashtag7
GGGACCTAGACTTCAC	Negative
GGGACCTAGGTAAAGG	Negative
GGGACCTAGTATTAGG	Negative
GGGACCTCAAAGGCAC	Negative
GGGACCTCAACCTAAC	Hashtag5
GGGACCTCATCGTCCT	Hashtag5_Hashtag7
GGGACCTCATGGCTGC	Negative
GGGACCTGTCACTGAT	Hashtag5
GGGACCTGTTTAAGGA	Negative
GGGACCTTCAGACTGT	Hashtag5
GGGACCTTCAGTCCGG	Hashtag5
GGGACCTTCTAACGCA	Negative
GGGACCTTCTTCGCTG	Negative
GGGACTCGTCGTGTTA	Negative
GGGAGATAGGTCGAGT	Negative
GGGAGATAGTAACAGT	Hashtag5
GGGAGATCAACTTCTT	Hashtag5
GGGAGATCATTCAGGT	Hashtag5
GGGAGATGTCATTGCA	Hashtag5
GGGAGATTCAGCTAGT	Hashtag5
GGGAGATTCCAAGCCG	Hashtag7
GGGAGATTCGTGAGAG	Negative
GGGAGTAAGCTGGAGT	Negative
GGGAGTAGTGCCTGAC	Hashtag5_Hashtag7
GGGAGTATCGATAACC	Hashtag7
GGGATCCAGCAAATGT	Negative
GGGATCCAGCTACAAA	Negative
GGGATCCAGGGTAGCT	Negative
GGGATCCCAACGACAG	Negative
GGGATCCCAGGGTTGA	Hashtag5_Hashtag7
GGGATCCTCTGTTGGA	Hashtag5
GGGATCCTCTTCGTAT	Hashtag7
GGGATGAAGCATATGA	Hashtag5
GGGATGAAGGAGACCT	Hashtag5_Hashtag7
GGGATGACAGAGCCCT	Hashtag5
GGGATGAGTCATCGGC	Negative
GGGCCATGTCAACCTA	Negative
GGGCCATGTCATCTAG	Negative
GGGCCATGTGGTCTGC	Negative
GGGCCATTCTTGGAAC	Negative
GGGCGTTAGTGCCAGA	Hashtag5
GGGCGTTCACCGAATT	Negative
GGGCGTTCACCTGCGA	Negative
GGGCGTTGTAGTGATA	Hashtag5
GGGCGTTTCAATCTTC	Negative
GGGCGTTTCATGCGGC	Hashtag7
GGGCGTTTCGAAGAAT	Hashtag5
GGGCGTTTCTGCGGGT	Hashtag5
GGGCGTTTCTGGGAGA	Hashtag5_Hashtag7
GGGCTACCATTGACCA	Hashtag5_Hashtag7
GGGCTACGTTGGCCGT	Hashtag5
GGGCTACTCCTCGCAT	Negative
GGGCTACTCTGAACGT	Hashtag5
GGGCTCATCCTTGGAA	Negative
GGGTAGAAGCGTCAGA	Hashtag5
GGGTAGACAACGTATC	Hashtag5
GGGTAGACAAGACAAT	Hashtag5
GGGTAGATCAAAGACA	Negative
GGGTAGATCCTGGGAC	Negative
GGGTATTCAACGACTT	Negative
GGGTATTCATAACAGA	Hashtag7
GGGTATTGTTCAGCTA	Hashtag5
GGGTATTGTTCCGCGA	Negative
GGGTATTTCTCGAACA	Hashtag5
GGGTCACAGTAGTCAA	Hashtag5
GGGTCACAGTGAATAC	Negative
GGGTCACCACGCAGTC	Negative
GGGTCACGTCGAAGCA	Negative
GGGTCACGTTGGGACA	Negative
GGGTCACTCAACTCTT	Negative
GGGTCACTCAGTCCGG	Negative
GGGTCACTCATAAGGA	Negative
GGGTCACTCCCATAAG	Negative
GGGTCACTCCGTGGGT	Negative
GGGTCACTCGCTGTTC	Negative
GGGTCACTCGGAACTT	Hashtag5
GGGTCTGAGCCACTCG	Hashtag5
GGGTCTGAGCTGTACT	Negative
GGGTCTGCAAATAGCA	Negative
GGGTCTGCAAGTGTCT	Hashtag5
GGGTCTGGTGCACAAG	Negative
GGGTCTGTCAGAGCAG	Negative
GGGTCTGTCCTCTAAT	Negative
GGGTGAACATCGGCCA	Negative
GGGTGAATCGTGGACC	Negative
GGGTGTCAGGCCTTCG	Hashtag5
GGGTGTCCATCACGGC	Hashtag5
GGGTGTCCATCCGGTG	Hashtag5
GGGTGTCCATTAGGAA	Negative
GGGTGTCGTATCCTCC	Hashtag5
GGGTGTCGTCGTGTTA	Negative
GGGTGTCGTGCCTACG	Hashtag5
GGGTTATCAAAGCTAA	Negative
GGGTTATCAGGCGTTC	Hashtag5
GGGTTATGTACAGAAT	Hashtag5
GGGTTATTCGATGGAG	Hashtag5
GGGTTTACAAGTGGTG	Hashtag5
GGGTTTACACATTGTG	Hashtag7
GGGTTTAGTAGAGCTG	Hashtag5
GGGTTTAGTAGTCCTA	Hashtag5
GGTAACTAGACCAGAC	Hashtag7
GGTAACTAGCACTTTG	Negative
GGTAACTAGGCTTAAA	Hashtag5
GGTAACTGTTATTCTC	Hashtag7
GGTAACTTCGAACTCA	Negative
GGTAACTTCGTCTCAC	Negative
GGTAATCAGAGGACTC	Hashtag7
GGTAATCAGATGCCGA	Negative
GGTAATCCACTCCCTA	Negative
GGTAATCGTGAGATAT	Negative
GGTAATCTCGCTGATA	Negative
GGTAGAGCAGGCATTT	Hashtag5_Hashtag7
GGTAGAGCATAGAATG	Hashtag5_Hashtag7
GGTAGAGTCGGTCTGG	Hashtag7
GGTAGAGTCGTGACTA	Hashtag5
GGTAGAGTCTGCGGAC	Negative
GGTCACGAGCGTTAGG	Hashtag5
GGTCTGGAGCCATTCA	Hashtag7
GGTCTGGAGCCTCTTC	Hashtag5
GGTCTGGAGCTCACTA	Negative
GGTCTGGCAGGAATCG	Negative
GGTCTGGCATCGTTCC	Negative
GGTCTGGGTGGCGCTT	Negative
GGTCTGGGTTGCATGT	Negative
GGTGAAGGTATGTCAC	Hashtag5_Hashtag7
GGTGAAGGTCAGGCAA	Negative
GGTGAAGGTTCCAGGC	Negative
GGTGAAGGTTTACGTG	Negative
GGTGAAGGTTTGAAAG	Hashtag5
GGTGAAGTCGAAGCCC	Negative
GGTGAAGTCTCGACGG	Negative
GGTGATTAGGCCTGCT	Hashtag5
GGTGATTAGTCAGCGA	Hashtag5
GGTGATTCAAGTGCTT	Negative
GGTGATTCACGAGGTA	Hashtag5
GGTGATTGTGTCACAT	Hashtag5
GGTGATTGTGTCATTG	Hashtag5
GGTGATTGTTTACCTT	Hashtag5
GGTGATTGTTTGAAAG	Negative
GGTGGCTAGAGGCTGT	Negative
GGTGGCTAGCCGATTT	Negative
GGTGGCTGTCCGTTTC	Negative
GGTGGCTTCAAGTCTG	Hashtag5
GGTGTCGCAACGCCCA	Hashtag5
GGTGTCGCATTGGCAT	Negative
GGTGTCGTCCGACATA	Negative
GGTGTTAAGGGTTAGC	Negative
GGTGTTAGTACGTGTT	Hashtag5
GGTGTTAGTGAGATAT	Hashtag7
GGTGTTAGTGGATGAC	Negative
GGTGTTATCTAAGCCA	Hashtag5
GGTTAACAGGATACCG	Hashtag5
GGTTAACAGTACAACA	Hashtag5
GGTTAACAGTACTGTC	Negative
GGTTAACCACCCTGTT	Negative
GGTTAACCAGACTGCC	Hashtag7
GGTTAACGTCAAAGAT	Negative
GGTTAACGTGCAACAG	Negative
GGTTAACTCTACGGTA	Hashtag5_Hashtag7
GGTTCTCAGACTTCAC	Negative
GGTTCTCAGCAGGGAG	Hashtag7
GGTTCTCAGCGTATGG	Negative
GGTTCTCAGGGAGGGT	Negative
GGTTCTCCAACCGACC	Negative
GGTTCTCCATGTGCCG	Negative
GGTTCTCTCCTGTTAT	Hashtag5
GGTTGTAAGTGTGTTC	Negative
GGTTGTACAATCTCGA	Hashtag5_Hashtag7
GGTTGTACAATGAAAC	Negative
GGTTGTACAGGACATG	Negative
GGTTGTAGTCAAGTTC	Negative
GGTTGTAGTGTGAGCA	Negative
GGTTGTATCCACGTAA	Hashtag5
GGTTGTATCCTGTTAT	Negative
GTAACACAGAATAACC	Negative
GTAACACAGTGGACGT	Negative
GTAACACCAGAGCCCT	Hashtag5_Hashtag7
GTAACACCAGGTTCGC	Hashtag5
GTAACACGTGGCAGAT	Negative
GTAACACGTTGCTAGT	Negative
GTAACACTCCATATGG	Negative
GTAACACTCCCTCGAT	Hashtag7
GTAACCAGTCTAGATC	Negative
GTAACCATCCCTTGGT	Negative
GTAAGTCGTGTAAATG	Negative
GTAAGTCGTGTCTTAG	Hashtag5
GTAATCGAGATCCCGC	Hashtag5
GTAATCGAGTGACCTT	Negative
GTAATCGCAAACTCGT	Negative
GTAATCGCAGACCCGT	Negative
GTAATCGCAGGGACTA	Hashtag5
GTAATCGCATGACTGT	Negative
GTAATCGCATTGACCA	Hashtag5
GTAATCGGTTCATCGA	Hashtag5
GTAATCGTCAGTCTTT	Negative
GTAATCGTCCGGCAGT	Hashtag5
GTAATGCAGGTCCGAA	Hashtag5
GTAATGCCACACACGC	Hashtag5_Hashtag7
GTAATGCGTGACCGAA	Hashtag5
GTAATGCGTGACTCTA	Negative
GTAATGCGTTCCGCGA	Hashtag5
GTAATGCTCGCACGGT	Hashtag5
GTACAACAGCTAGTTC	Hashtag5
GTACAACGTATCCCTC	Hashtag5_Hashtag7
GTACAACGTCGGATTT	Negative
GTACAACGTTACCCTC	Hashtag5
GTACAACTCATCGCAA	Negative
GTACAACTCCTTCAGC	Negative
GTACAGTAGATAGTGT	Negative
GTACAGTAGCCATTTG	Hashtag5_Hashtag7
GTACAGTAGTATAACG	Hashtag5
GTACAGTCACAACGTT	Negative
GTACAGTCATAGACTC	Hashtag5
GTACAGTGTCACCCTT	Negative
GTACAGTGTCAGATTC	Hashtag5
GTACAGTGTGCGGCTT	Negative
GTACAGTGTTATTCCT	Hashtag5
GTAGAAAAGATCACCT	Hashtag5
GTAGAAACAAATACAG	Hashtag5
GTAGAAACAATTGCCA	Hashtag5_Hashtag7
GTAGAAACAGATTCGT	Hashtag5
GTAGAAAGTATACCTG	Hashtag7
GTAGAAAGTTCCGCTT	Hashtag5
GTAGAAATCATCCCGT	Negative
GTAGAAATCTAGTCAG	Negative
GTAGAGGAGAGGATCC	Hashtag5
GTAGAGGGTACGTGAG	Hashtag5_Hashtag7
GTAGATCAGCTCGCAC	Hashtag5
GTAGATCAGTGAACAT	Hashtag7
GTAGATCGTACAAGCG	Hashtag5
GTAGATCGTGTAAACA	Hashtag5
GTAGATCGTTCATCGA	Negative
GTAGATCGTTGCAACT	Hashtag5
GTAGATCGTTTAGTCG	Hashtag5
GTAGATCTCTGTACAG	Hashtag5
GTAGCTAAGAGATCGC	Negative
GTAGCTACAGATCACT	Negative
GTAGCTAGTTTACACG	Negative
GTAGCTATCTCTCAAT	Negative
GTAGGAGAGTAGGAAG	Negative
GTAGGAGCAGCTTCGG	Hashtag7
GTAGGAGCAGGTCCCA	Hashtag5
GTAGGAGTCCGCAACG	Hashtag7
GTAGGAGTCGTTGTTT	Negative
GTAGGTTCATCCTGTC	Hashtag5
GTAGGTTGTGGTATGG	Negative
GTAGGTTTCGTTCGCT	Negative
GTAGTACAGCTCCATA	Hashtag5
GTAGTACAGGCCTGCT	Hashtag5
GTAGTACAGTGTCATC	Negative
GTAGTACGTAAGTCAA	Hashtag5
GTAGTACGTAGTGTGG	Negative
GTAGTACGTCTTGGTA	Negative
GTAGTACTCAAACCCA	Hashtag5
GTAGTACTCCTTGACC	Negative
GTAGTACTCGCCTCTA	Negative
GTATTGGGTGATAGAT	Hashtag5
GTATTGGTCCAACACA	Negative
GTATTTCAGCCTCGTG	Negative
GTATTTCAGTTCCATG	Negative
GTATTTCCAGTGTACT	Hashtag7
GTATTTCCATCGAAGG	Hashtag5
GTATTTCGTACGTAGG	Hashtag5
GTATTTCGTCGACTGC	Hashtag5
GTATTTCTCACTGTCC	Hashtag7
GTCAAACAGGCTGAAC	Negative
GTCAAACCAGGACAGT	Negative
GTCAAACCATAAGATG	Hashtag5
GTCAAACTCCGCTGTT	Negative
GTCAAGTAGCTCTATG	Negative
GTCAAGTCAAAGACTA	Hashtag5
GTCAAGTGTAGCTCGC	Negative
GTCAAGTGTCTCTCTG	Negative
GTCAAGTTCCGTTGAA	Negative
GTCACGGAGCGATTCT	Negative
GTCACGGCAAGTTCCA	Negative
GTCACGGCAGGATGAC	Negative
GTCACGGTCGAGATGG	Hashtag5
GTCACTCGTCGACTGC	Hashtag5
GTCACTCGTGGGCTCT	Negative
GTCACTCTCACAACCA	Negative
GTCACTCTCGACGCGT	Negative
GTCACTCTCGTAGCCG	Hashtag5
GTCAGCGAGGTCTGGA	Negative
GTCAGCGAGGTTACAA	Negative
GTCAGCGAGGTTGTTC	Negative
GTCAGCGCAATACGAA	Negative
GTCAGCGCACTGTCCT	Hashtag5
GTCAGCGTCAAAGGAT	Negative
GTCAGCGTCGCCCAGA	Negative
GTCAGCGTCTGGACTA	Negative
GTCATCCCAACGCATT	Negative
GTCATCCGTACAAAGT	Hashtag5
GTCATCCGTACCGTCG	Negative
GTCATCCGTACTGCGC	Hashtag5
GTCATCCGTTCTCCAC	Negative
GTCATCCGTTGCCTAA	Negative
GTCATCCTCACCCTGT	Hashtag5
GTCATCCTCAGGTGTT	Hashtag5
GTCATGAAGCGAGAAA	Negative
GTCATGAAGGATTCAA	Negative
GTCATGAAGTGTACAA	Negative
GTCATGACAAGTGGAC	Negative
GTCATGACACCTGCAG	Hashtag5
GTCATTTAGAATAGTC	Hashtag5
GTCATTTAGTGGTGAC	Hashtag7
GTCATTTTCTGGCCAG	Hashtag5
GTCCACTAGAACTCCT	Negative
GTCCACTAGAGAGCCT	Negative
GTCCACTGTGGACTGA	Negative
GTCCACTGTTCCAAAC	Hashtag5_Hashtag7
GTCCACTTCACTCGAA	Hashtag5
GTCCACTTCTGGAGAG	Hashtag5
GTCCCATAGCATGATA	Hashtag5
GTCCCATAGGTGATAT	Hashtag5
GTCCCATCACATGAAA	Hashtag7
GTCCCATCATCTGCGG	Hashtag5
GTCCCATGTAGTGATA	Negative
GTCCCATTCCGAGAAG	Hashtag5
GTCCCATTCCGCATAA	Hashtag5
GTCCCATTCGCTAGCG	Hashtag7
GTCCTCAAGGCTGTAG	Hashtag5
GTCCTCACAAATGCGG	Negative
GTCCTCACACAATCTG	Negative
GTCCTCACATGGCCAC	Hashtag5_Hashtag7
GTCCTCAGTAGCTAAA	Negative
GTCCTCAGTCCGGCAT	Hashtag5
GTCCTCAGTGTCCCTT	Negative
GTCGAATAGCTACTGT	Negative
GTCGAATAGCTCTATG	Negative
GTCGAATAGTATAGGT	Negative
GTCGAATAGTGTACCT	Negative
GTCGAATGTGAGTTTC	Negative
GTCGAATTCAGAGTTC	Negative
GTCGAATTCGCCAACG	Hashtag5
GTCGCGAAGTAGTCTC	Hashtag5
GTCGCGAGTCTTTCAT	Hashtag5
GTCGTAAAGTTGCGCC	Negative
GTCGTAACAGTCGGAA	Hashtag5
GTCGTAAGTCGAGCTC	Negative
GTCGTAATCACGAGGA	Hashtag5
GTCGTTCAGCAGGGAG	Negative
GTCGTTCAGCTGGCTC	Negative
GTCGTTCGTCCTGTTC	Negative
GTCTACCAGAAGTGTT	Hashtag5
GTCTACCAGCATACTC	Negative
GTCTACCAGTGAGTTA	Hashtag5
GTCTACCGTGAGCAGT	Hashtag5
GTCTACCGTTCATCTT	Negative
GTCTACCTCCAGCTCT	Hashtag7
GTCTACCTCGGACAAG	Hashtag5
GTCTAGAAGCGAGTCA	Negative
GTCTAGAGTACTCGAT	Negative
GTCTAGATCTTGTTAC	Negative
GTCTCACCACATACGT	Hashtag5
GTCTCACGTCGCATGC	Negative
GTCTCACTCTCGGTAA	Hashtag5
GTCTGTCCAAGGCCTC	Hashtag5
GTCTGTCCAGAAATCA	Hashtag5
GTCTGTCCAGCATTGT	Hashtag5
GTCTGTCGTATGGAAT	Hashtag5
GTCTGTCTCCGGTTCT	Hashtag7
GTCTGTCTCGTAGCTA	Negative
GTCTGTCTCGTCGCTT	Negative
GTCTGTCTCTAGGCCG	Negative
GTCTTTAAGATTTGCC	Negative
GTCTTTAAGTTTGTCG	Hashtag5
GTCTTTAGTGAATATG	Hashtag5
GTCTTTAGTGGACAGT	Hashtag5
GTCTTTAGTTGGTGTT	Hashtag5
GTCTTTATCATTCACT	Hashtag5
GTGACGCAGCTCGAAG	Hashtag5
GTGACGCCACGTACAT	Negative
GTGACGCCACTACCCT	Hashtag5
GTGACGCGTAAGCTCT	Negative
GTGACGCGTATACCTG	Hashtag5
GTGACGCGTTGGAGGT	Hashtag5
GTGACGCTCAATCTCT	Negative
GTGAGCCAGCAATAAC	Hashtag7
GTGAGCCCAATGAAAC	Negative
GTGAGCCCAGTAGAGC	Negative
GTGAGCCTCTTCGACC	Negative
GTGAGGAAGGGTTTCT	Negative
GTGAGGAAGTTTGTCG	Negative
GTGAGGACAGCAAGAC	Hashtag5
GTGAGGAGTAGGAAAG	Hashtag5
GTGAGGAGTATCGCGC	Negative
GTGAGGATCTCCTGTG	Hashtag5
GTGAGGATCTTCGACC	Hashtag7
GTGAGTTAGTACCCTA	Hashtag7
GTGAGTTCAGAACCGA	Negative
GTGAGTTCATACAGAA	Negative
GTGAGTTTCAAACTGC	Negative
GTGAGTTTCGCGAAGA	Hashtag5
GTGATGTAGATACGAT	Hashtag5
GTGATGTAGCCATCCG	Hashtag5
GTGATGTAGCCTAACT	Negative
GTGATGTAGGATCACG	Negative
GTGATGTGTCGACTTA	Hashtag5
GTGATGTGTCGTACTA	Negative
GTGATGTTCCCGTTGT	Hashtag5
GTGCACGAGGTCCAGA	Hashtag5_Hashtag7
GTGCACGCAATTGAAG	Negative
GTGCACGGTCCGAAGA	Negative
GTGCACGGTCGTCGGT	Hashtag7
GTGCACGTCACTAGCA	Hashtag5
GTGCACGTCGGCCCAA	Negative
GTGCAGCCACCCTTAC	Negative
GTGCAGCCATAACCCA	Negative
GTGCAGCGTGACCTGC	Negative
GTGCAGCGTGGTCTGC	Negative
GTGCAGCTCACTACTT	Hashtag7
GTGCAGCTCAGCGCGT	Hashtag5
GTGCAGCTCCATGATG	Negative
GTGCAGCTCGCAATGT	Hashtag5
GTGCGTGAGCTGGCTC	Negative
GTGCGTGAGGAACGCT	Hashtag5
GTGCGTGGTAGCTGAG	Negative
GTGCGTGGTTGCCGAC	Negative
GTGCGTGTCTCGCCTA	Negative
GTGCTGGAGCCTGGAA	Negative
GTGCTGGAGCGTACAG	Hashtag7
GTGCTGGCACGGAAGT	Negative
GTGCTGGCATATCTGG	Negative
GTGCTGGGTCTAGATC	Negative
GTGCTGGTCGTTCATT	Negative
GTGCTTCAGAGAGAAC	Negative
GTGCTTCAGAGCAACC	Negative
GTGCTTCAGGAATTAC	Hashtag5
GTGCTTCAGTCCCTAA	Negative
GTGCTTCCACGCTGTG	Negative
GTGCTTCCATACAGCT	Negative
GTGCTTCGTGCTGTCG	Hashtag5
GTGCTTCTCCGATAGT	Negative
GTGGAAGAGGACAACC	Hashtag5
GTGGAAGAGGGTACGT	Hashtag7
GTGGAAGAGTGATAAC	Hashtag7
GTGGAAGCACTCAGAT	Negative
GTGGAAGGTATCCCTC	Negative
GTGGAAGGTGGCTGAA	Hashtag5
GTGGAAGTCATTTACC	Hashtag7
GTGGAAGTCGCGCTGA	Negative
GTGGAGAAGAAGTGTT	Hashtag7
GTGGAGAAGCTAAATG	Hashtag5
GTGGAGAAGGGACTGT	Hashtag5
GTGGAGAAGTAAGGGA	Negative
GTGGAGACACCCTATC	Negative
GTGGAGACACTGGAAG	Negative
GTGGAGAGTTCGGTCG	Negative
GTGGAGATCCTTGAAG	Negative
GTGGCGTAGCCACCGT	Hashtag7
GTGGCGTGTGTTACAC	Hashtag7
GTGGCGTTCAACACGT	Negative
GTGGGAAAGGCATCTT	Negative
GTGGGAAAGGTCACCC	Negative
GTGGGAACAACCCGCA	Hashtag5
GTGGGAACAAGCCTGC	Negative
GTGGGAAGTATGATCC	Hashtag5
GTGGTTAAGACCAGCA	Negative
GTGGTTAAGGGCATGT	Hashtag5_Hashtag7
GTGGTTACAGAAGTGC	Hashtag5
GTGGTTACAGATTCGT	Negative
GTGGTTACATCGCTCT	Negative
GTGGTTAGTGGACAGT	Negative
GTGGTTAGTGGCGCTT	Negative
GTGGTTATCCGCAGTG	Hashtag5
GTGTAACAGAAATTGC	Negative
GTGTAACAGATTGGGC	Hashtag7
GTGTAACAGCACCTGC	Hashtag5
GTGTAACGTCACTAGT	Negative
GTGTAACGTGCATGAG	Negative
GTGTAACTCATGCTAG	Negative
GTGTCCTAGCGCGTTC	Negative
GTGTCCTCATCGGCCA	Hashtag5
GTGTGATAGACTACGG	Hashtag5
GTGTGATCACTTTAGG	Hashtag5
GTGTGATCAGCGTAGA	Negative
GTGTGATGTATGAGAT	Negative
GTGTGATGTGAACTAA	Negative
GTGTGATGTTCAAGTC	Negative
GTGTGATTCATTTCCA	Negative
GTGTGGCAGGAAGTCC	Hashtag5
GTGTGGCCACGCTATA	Negative
GTGTTAGAGACCATTC	Hashtag5
GTGTTAGTCTGGGAGA	Negative
GTGTTCCAGAGGGTGG	Negative
GTGTTCCAGGCGCTCT	Hashtag5
GTGTTCCAGTCACAGG	Hashtag5
GTGTTCCAGTTGCATC	Hashtag5
GTGTTCCCACTCAGAT	Hashtag7
GTGTTCCGTGAGATAT	Hashtag5
GTGTTCCGTGTCATTG	Negative
GTGTTCCGTTCAAGGG	Negative
GTGTTCCTCTGTCTCG	Negative
GTGTTCCTCTTCCCGA	Negative
GTTACAGAGCGCTGCT	Negative
GTTACAGAGTAAGGGA	Hashtag7
GTTACAGCACAAATAG	Negative
GTTACAGGTCACTCGG	Negative
GTTACAGGTCATCGGC	Negative
GTTACAGGTCGGCCTA	Hashtag7
GTTACAGTCGCGATCG	Negative
GTTACAGTCGGTTCAA	Hashtag5
GTTACAGTCGTTGTGA	Hashtag5
GTTACCCAGAGCTGAC	Negative
GTTACCCAGCTAGATA	Negative
GTTACCCAGTACCATC	Negative
GTTACCCAGTTTAGGA	Negative
GTTACCCCAAACACCT	Hashtag7
GTTACCCTCTTAGCTT	Hashtag5
GTTACGAAGTGCCTCG	Hashtag5
GTTACGAAGTGTAGTA	Negative
GTTACGACACGACCTG	Negative
GTTACGAGTACTAACC	Hashtag5
GTTACGAGTGCGGTAA	Negative
GTTACGATCCAGCACG	Hashtag5
GTTAGACAGACCAGAC	Hashtag5_Hashtag7
GTTAGACAGTATTAGG	Hashtag5
GTTAGACAGTCCCTAA	Hashtag5
GTTAGACGTACCTATG	Negative
GTTAGACTCGACATTG	Hashtag5
GTTAGTGAGCTCCCTT	Negative
GTTAGTGAGTCCGTCG	Hashtag5
GTTAGTGAGTCGGGAT	Negative
GTTAGTGAGTGGCGAT	Negative
GTTAGTGCATAGACTC	Hashtag5
GTTAGTGGTGTTGACT	Negative
GTTAGTGTCGAGTCCG	Hashtag5
GTTAGTGTCGGCATAT	Hashtag5_Hashtag7
GTTAGTGTCTGCGGGT	Negative
GTTATGGAGCCTCAGC	Negative
GTTATGGCACGGCCAT	Hashtag5
GTTATGGCAGCTTTGA	Negative
GTTATGGCATTGAAGA	Negative
GTTATGGGTCATAAAG	Negative
GTTATGGGTGATTGGG	Negative
GTTATGGGTGCTATTG	Negative
GTTATGGTCAAACGTC	Hashtag5
GTTCATTAGAGAGGGC	Negative
GTTCATTAGGTAGTAT	Negative
GTTCATTAGTGCAGCA	Negative
GTTCATTCAATAGTAG	Negative
GTTCATTCACACCTGG	Negative
GTTCATTCACTATGTG	Negative
GTTCATTCATTACGGT	Negative
GTTCATTGTACAGAGC	Negative
GTTCATTGTATGCAAA	Negative
GTTCATTGTCCGAAAG	Negative
GTTCATTGTTGGGAAC	Negative
GTTCATTTCACAGTGT	Negative
GTTCATTTCCATACAG	Negative
GTTCCGTAGATAGGGA	Hashtag7
GTTCCGTCACATATGC	Hashtag5
GTTCCGTGTTATGTCG	Negative
GTTCGCTGTAAGATCA	Negative
GTTCGCTGTCATACCA	Hashtag7
GTTCGCTGTCATGACT	Hashtag5
GTTCGCTTCACACCCT	Negative
GTTCGCTTCGAGTGGA	Negative
GTTCGCTTCGGTGAAG	Negative
GTTCGCTTCTGATGGT	Negative
GTTCTATAGGATTTAG	Negative
GTTCTATCAATAAGGT	Hashtag5
GTTCTATGTAACACCT	Negative
GTTCTATTCACGAGGA	Hashtag5
GTTCTATTCTATCGGA	Negative
GTTGAACCAATTGGTC	Negative
GTTGAACCACTACGGC	Negative
GTTGAACCAGCTGGTC	Negative
GTTGAACGTCAACCAT	Negative
GTTGAACGTCTTCCGT	Negative
GTTGAACTCCCATAGA	Negative
GTTGCGGAGAGCAGAA	Hashtag7
GTTGCGGCAACTCCAA	Negative
GTTGCGGCACCTGTCT	Negative
GTTGCGGCATTACGGT	Negative
GTTGCGGCATTCACAG	Negative
GTTGCGGTCAAAGGAT	Negative
GTTGCGGTCAATGTCG	Negative
GTTGCGGTCGCAATTG	Negative
GTTGCGGTCGCTGATA	Negative
GTTGCGGTCTTCGTGC	Hashtag5
GTTGCTCAGGGTACAC	Negative
GTTGCTCCAACTCATG	Negative
GTTGCTCGTAGTGATA	Negative
GTTGCTCGTTGTATGC	Negative
GTTGCTCTCGTTGTAG	Negative
GTTGCTCTCTGAGGCC	Negative
GTTGTAGCATCGGTTA	Negative
GTTGTAGCATGCACTA	Negative
GTTGTAGGTCTACGTA	Negative
GTTGTAGGTTCGAGCC	Negative
GTTGTAGGTTGGCCTG	Negative
GTTGTAGTCAGCGCAC	Negative
GTTGTAGTCAGCTTCC	Negative
GTTGTCCAGGATTTAG	Negative
GTTGTCCAGTACTGGG	Negative
GTTGTCCCAGAGAAAG	Negative
GTTGTCCGTGGACTGA	Negative
GTTGTCCTCGTAACAC	Negative
GTTGTCCTCTGCCCTA	Negative
GTTGTGACATAAGATG	Negative
GTTGTGATCCGTGGCA	Negative
GTTGTGATCGACATAC	Negative
GTTTACTCAAGAGGCT	Negative
GTTTACTCACAGTGAG	Negative
GTTTGGAGTGGACCTC	Hashtag5_Hashtag7
TAACACGAGGGTGAAA	Hashtag5
TAACACGGTACTAACC	Hashtag7
TAACACGGTTTCGTTT	Hashtag5_Hashtag7
TAACACGTCCCAGGAC	Hashtag5_Hashtag7
TAACCAGAGCACACAG	Hashtag7
TAACCAGAGCCAGAGT	Hashtag5_Hashtag7
TAACCAGCAAATAGCA	Hashtag5
TAACCAGCAGAAGTTA	Hashtag5_Hashtag7
TAACCAGCATCTTCGC	Hashtag5_Hashtag7
TAACGACAGAGGATGA	Hashtag7
TAACGACAGCGATCGA	Negative
TAACGACAGGGAGGTG	Negative
TAACGACAGTTTCGGT	Hashtag5_Hashtag7
TAACGACCACAAGTTC	Negative
TAACGACGTACGGTTT	Hashtag7
TAACGACGTGACTATC	Negative
TAACGACTCCAACTAG	Hashtag5_Hashtag7
TAACGACTCCACACCT	Negative
TAACGACTCGTCGGGT	Negative
TAACTTCAGACCCGCT	Negative
TAACTTCAGCCGCTTG	Hashtag5_Hashtag7
TAACTTCAGTAGATCA	Hashtag7
TAACTTCCAAACGGCA	Hashtag5
TAACTTCCACAAAGTA	Hashtag7
TAACTTCCATTGGGAG	Negative
TAACTTCGTCCTTAAG	Negative
TAACTTCGTGCGAGTA	Hashtag5
TAACTTCTCGTCTACC	Negative
TAAGCACAGAAGCGGG	Hashtag5_Hashtag7
TAAGCACAGGGACACT	Hashtag7
TAAGCACGTCGCATTA	Hashtag5
TAAGCACTCAGATTGC	Hashtag7
TAAGCACTCAGGAAGC	Hashtag7
TAAGCACTCGGATACT	Hashtag5_Hashtag7
TAAGCCAAGATACGAT	Negative
TAAGCCAAGTCGCCAC	Hashtag5
TAAGCCAAGTGCGTCC	Hashtag5_Hashtag7
TAAGCCACAGAGAATT	Hashtag5_Hashtag7
TAAGCCACAGTCGAGA	Negative
TAAGCCAGTGGCTTGC	Hashtag5
TAAGCCATCAAGGCTT	Negative
TAAGCCATCGTTCTGC	Negative
TAAGCCATCTACCACC	Hashtag5
TAAGCGTCAGCGTAGA	Hashtag5_Hashtag7
TAAGCGTGTACTGCGC	Hashtag5
TAAGTCGAGCTGGCCT	Negative
TAAGTCGCAGGATCTT	Hashtag5_Hashtag7
TAAGTCGGTAGTGGCA	Negative
TAAGTCGGTTGGGACA	Hashtag7
TAAGTCGTCACTGTCC	Hashtag5_Hashtag7
TAATCTCAGGACGCTA	Hashtag5
TAATCTCCACCTGATA	Hashtag5
TAATCTCGTGGCTTAT	Hashtag5
TAATCTCTCTAGTGAC	Hashtag7
TAATTCCAGACCTCCG	Negative
TAATTCCGTGTTAACC	Hashtag7
TAATTCCTCCCGAATA	Hashtag5_Hashtag7
TACAACGAGAAATTGC	Hashtag7
TACAACGAGGTGCAGT	Hashtag5_Hashtag7
TACAACGCATTGTACG	Hashtag7
TACAACGGTTCGAGCC	Hashtag5
TACACCCAGATGGTAT	Negative
TACACCCAGGACAAGA	Hashtag7
TACACCCAGGTCATCT	Negative
TACACCCAGGTGCTTT	Negative
TACACCCCAAGTTCGT	Hashtag5
TACACCCCACAGAGAC	Hashtag5
TACACCCCAGATACTC	Hashtag5_Hashtag7
TACACCCCATGGATCT	Negative
TACACCCGTATCGCAT	Hashtag5
TACACCCGTTACCTGA	Negative
TACACCCGTTCGCGTG	Hashtag5_Hashtag7
TACACCCTCGTGCATA	Hashtag5_Hashtag7
TACAGGTAGCAGCACA	Hashtag5
TACAGGTCACAAGTGG	Negative
TACAGGTTCGCCGTGA	Negative
TACATTCAGTGAATAC	Negative
TACATTCCAGCTGCCA	Hashtag5
TACATTCTCACTTGTT	Hashtag7
TACATTCTCATTGCTT	Negative
TACCCACAGCCTCATA	Hashtag5_Hashtag7
TACCCACCAGCATGCC	Negative
TACCCACGTAGGCAGT	Hashtag5
TACCCACGTCAGATTC	Negative
TACCCACGTGGCTTGC	Negative
TACCCACGTTCGAGCC	Negative
TACCCACTCAACCGAT	Hashtag5
TACCCACTCACAACCA	Hashtag7
TACCCACTCATGTCAG	Hashtag5_Hashtag7
TACCCACTCGGTCACG	Hashtag5
TACCCGTCAAACCATC	Hashtag5
TACCCGTCAAATGGAT	Negative
TACCCGTCAGTAGAAT	Negative
TACCCGTCATGGCTGC	Hashtag5
TACCCGTCATTCCTCG	Hashtag5_Hashtag7
TACCCGTGTGGATTTC	Hashtag5_Hashtag7
TACCCGTGTTACCTTT	Hashtag5
TACCCGTGTTCAAAGA	Negative
TACCCGTTCTATACGG	Hashtag5_Hashtag7
TACCCGTTCTATTGTC	Negative
TACCGAAAGCGTGCCT	Negative
TACCGAAGTCGTCATA	Hashtag7
TACCGAAGTGGCTTGC	Hashtag5
TACCGAAGTGTTACTG	Negative
TACCGAATCACAAGGG	Hashtag5_Hashtag7
TACCGAATCCGAAGGA	Negative
TACCGGGAGGTAGCCA	Negative
TACCGGGCAATGTGGG	Negative
TACCGGGGTGTTCCTC	Hashtag5
TACCGGGTCATTCGTT	Negative
TACCGGGTCGGTCGGT	Hashtag7
TACCGGGTCGTCAAAC	Hashtag7
TACCGGGTCTGGGAGA	Hashtag5
TACCTCGAGAGTCAAT	Negative
TACCTCGGTAGTCACT	Hashtag7
TACCTCGGTTCGATTG	Hashtag5
TACCTCGGTTCTCCCA	Negative
TACCTGCAGCACCGTC	Hashtag5_Hashtag7
TACCTGCAGTCAATCC	Hashtag7
TACCTGCAGTTAGTAG	Hashtag5
TACCTGCCATTCAGGT	Hashtag7
TACCTGCGTCTTACAG	Hashtag7
TACCTGCGTTCAAACC	Negative
TACGCTCCACACTGGC	Hashtag5_Hashtag7
TACGGGCAGACTCCGC	Hashtag5_Hashtag7
TACGGGCAGTCATGAA	Hashtag7
TACGGGCCAGTCGCTG	Negative
TACGGGCGTGACCGTC	Negative
TACGGGCTCCTGCTAC	Negative
TACGGTAAGCATGATA	Hashtag5
TACGGTAAGCCTCTCT	Negative
TACGGTACATGTTCAG	Hashtag7
TACGGTAGTATCGGTT	Hashtag5
TACGGTAGTATTAAGG	Hashtag5_Hashtag7
TACGGTAGTTAGCTAC	Hashtag5
TACGGTATCGGCATTA	Hashtag5
TACGTCCAGACTCGAG	Negative
TACGTCCAGCTGGCTC	Negative
TACGTCCAGGACAGCT	Negative
TACGTCCCACCAATTG	Negative
TACGTCCGTTCTAAGC	Hashtag5
TACGTCCGTTGGAGGT	Negative
TACGTCCTCTAGTACG	Hashtag7
TACTGCCAGCCTCTCT	Negative
TACTGCCAGTAGTCAA	Hashtag7
TACTGCCGTCCTACGG	Hashtag5_Hashtag7
TACTGCCGTCTAGATC	Hashtag5_Hashtag7
TACTGCCGTTAAACAG	Negative
TACTGCCTCTCGAACA	Hashtag7
TACTTACAGGCCATAG	Hashtag5
TACTTACCAGAGCTAG	Negative
TACTTACTCAAACCTG	Hashtag7
TACTTACTCCTTTGAT	Hashtag7
TACTTCAAGCAAGTCG	Hashtag5
TACTTCAAGCCAGAGT	Hashtag5
TACTTCAAGTACCATC	Hashtag5_Hashtag7
TACTTCACACCCTTGT	Hashtag7
TACTTCACAGAGGTTG	Hashtag5_Hashtag7
TACTTCACAGTCGCTG	Hashtag7
TACTTGTAGGATATGT	Hashtag5
TACTTGTCACCGCTAG	Hashtag5
TACTTGTCACGGTGAA	Negative
TACTTGTCAGTTCCAA	Hashtag7
TACTTGTTCGCCAACG	Hashtag5
TACTTGTTCGGAAGGT	Hashtag7
TACTTGTTCGTGCACG	Hashtag5
TAGACCAAGTATTGCC	Hashtag5_Hashtag7
TAGACCAAGTCATCGT	Negative
TAGACCAGTCCCTGAG	Hashtag5
TAGACCATCACCTCAC	Hashtag7
TAGACCATCCATACTT	Hashtag5
TAGACTGAGGTCACTT	Negative
TAGACTGCACCAGCTG	Hashtag7
TAGACTGCAGTCGAGA	Negative
TAGACTGGTGGCTTGC	Negative
TAGACTGTCAACGCTA	Negative
TAGAGTCCACTCCGGA	Hashtag5
TAGAGTCCACTCTGCT	Hashtag7
TAGAGTCGTATCGCGC	Negative
TAGAGTCTCCAACTAG	Hashtag5
TAGATCGAGAGTATAC	Hashtag5_Hashtag7
TAGATCGGTTGTTTGG	Hashtag5_Hashtag7
TAGATCGTCGGTAACT	Hashtag7
TAGCACAAGCCGTTGC	Hashtag5
TAGCACAAGGACGCAT	Hashtag5
TAGCACACACGTTCGG	Negative
TAGCACAGTAGATGTA	Hashtag5
TAGCACATCGCTGTCT	Hashtag5_Hashtag7
TAGGAGGAGCGTATGG	Hashtag7
TAGGAGGCACAGACGA	Hashtag5
TAGGAGGCACAGGATG	Hashtag5
TAGGAGGCATCGCTCT	Negative
TAGGAGGTCCGTAATG	Hashtag5
TAGGGTTAGAGAGGTA	Hashtag7
TAGGGTTAGTCTAACC	Hashtag5
TAGGGTTCAGACCTAT	Hashtag5_Hashtag7
TAGGGTTCAGAGTGTG	Negative
TAGGGTTGTATTCTCT	Hashtag5
TAGGGTTGTCACCGAC	Negative
TAGGGTTTCCCAAGTA	Hashtag5_Hashtag7
TAGGGTTTCGCCTTGT	Negative
TAGGTACAGAAGCTGC	Hashtag5_Hashtag7
TAGGTACAGCCTGAAG	Hashtag7
TAGGTACAGTCTGCAT	Negative
TAGGTACCAAACCGGA	Hashtag5_Hashtag7
TAGGTACCAAGCTGTT	Negative
TAGGTACGTACACTCA	Hashtag7
TAGGTACGTCTGGTTA	Hashtag5
TAGGTACGTGTGGACA	Hashtag5
TAGGTACTCGTCGACG	Negative
TAGGTACTCTGCGATA	Hashtag7
TAGGTTGAGTCTGCGC	Hashtag5
TAGGTTGCAGACACAG	Hashtag5
TAGGTTGTCGACATAC	Negative
TAGGTTGTCGCTTTAT	Hashtag5
TAGTGCAAGAGCAACC	Hashtag5
TAGTGCAGTCAAGTTC	Hashtag5
TAGTGCAGTGGACTGA	Hashtag5
TAGTGCAGTTAGGCTT	Hashtag5
TAGTGCATCATTTCCA	Negative
TAGTGCATCTCGGCTT	Hashtag5
TAGTGCATCTTCCAGC	Negative
TATACCTAGCCGAATG	Hashtag5_Hashtag7
TATACCTAGGCCTAAG	Negative
TATACCTCATCGGCCA	Hashtag5
TATACCTCATCTTCGC	Hashtag5
TATACCTGTAATGCTC	Negative
TATACCTGTACTCCCT	Hashtag5_Hashtag7
TATACCTGTGTTAGCT	Hashtag5
TATATCCCACAGTCGC	Hashtag5
TATATCCCACATACTG	Hashtag5_Hashtag7
TATATCCGTTGTACGT	Hashtag5_Hashtag7
TATATCCTCACCTCGT	Negative
TATATCCTCTTACACT	Hashtag7
TATCAGGAGCATAGGC	Hashtag5
TATCAGGGTCCGACGT	Hashtag5_Hashtag7
TATCAGGGTTGCGAAG	Hashtag5
TATCCTAAGAAGGATG	Hashtag5_Hashtag7
TATCCTAAGGTAGCAC	Hashtag5_Hashtag7
TATCCTACAAGGCTTT	Hashtag5
TATCCTACATTGCTTT	Hashtag5
TATCCTAGTCGTTATG	Hashtag7
TATCCTAGTTGGAGAC	Hashtag7
TATCCTATCCACTGAA	Hashtag5
TATCCTATCCCATGGG	Hashtag5
TATCCTATCTCGGTCT	Hashtag5
TATCGCCAGATTAGTG	Negative
TATCGCCCAATGAACA	Hashtag7
TATCGCCCAATGAGCG	Hashtag5_Hashtag7
TATCGCCGTATGATCC	Hashtag5_Hashtag7
TATCGCCGTCTTCGAA	Hashtag5
TATCGCCGTGACAGCA	Negative
TATCTGTCAAACACGG	Hashtag5
TATCTGTCAAACCGGA	Negative
TATCTGTCAAGAGTAT	Negative
TATCTGTCACCATAAC	Hashtag5_Hashtag7
TATCTGTCAGAGCTAG	Hashtag5_Hashtag7
TATCTGTGTCGTGATT	Negative
TATCTGTGTCTACATG	Hashtag5
TATCTTGAGGTACAGC	Hashtag7
TATCTTGTCGAACGCC	Hashtag5
TATCTTGTCTCCTACG	Hashtag5_Hashtag7
TATGTTCCAGTCTTCC	Hashtag5
TATGTTCGTTGCTGAT	Negative
TATTCCACAACCTAAC	Hashtag5
TATTCCACAAGGGTCA	Hashtag7
TATTCCACACATGTTG	Hashtag7
TATTCCAGTCGAGTTT	Hashtag5
TATTCCATCAAGTGTC	Hashtag7
TATTCCATCGGAACTT	Hashtag5
TATTGCTAGGCCTAGA	Hashtag5
TATTGCTGTAGTCTTG	Hashtag7
TATTGCTGTGAGACGT	Negative
TATTGCTTCCATAGAC	Negative
TATTGCTTCCCAGTGG	Hashtag5
TATTGGGAGTGCCCGT	Negative
TATTGGGCATCGTTCC	Negative
TATTTCGAGGTTTACC	Hashtag7
TATTTCGCAAACGTGG	Hashtag7
TATTTCGCACGAGGAT	Hashtag5
TATTTCGGTGCGTTTA	Hashtag5
TATTTCGTCTATACGG	Negative
TATTTCGTCTATCGCC	Negative
TCAAGACAGCACTGGA	Hashtag5_Hashtag7
TCAAGCAAGATCACTC	Hashtag5
TCAAGCAAGGTAAGGA	Hashtag5
TCAAGCACAGATACTC	Hashtag7
TCAAGCAGTATCTTCT	Hashtag7
TCAAGCAGTGTCTTGA	Hashtag7
TCAAGCAGTTTGCAGT	Negative
TCAAGCATCACTGCTC	Negative
TCAAGCATCCTACCAC	Negative
TCAAGTGCAACCCTAA	Negative
TCAAGTGCAACTCCAA	Hashtag5
TCAAGTGCACTCCCTA	Hashtag5_Hashtag7
TCAAGTGCAGAGAGGG	Negative
TCAAGTGGTGACACAG	Hashtag5_Hashtag7
TCAAGTGTCAGAACCT	Hashtag5
TCAAGTGTCCACTTCG	Hashtag5
TCAAGTGTCTTAGCTT	Negative
TCAATCTAGAGCATAT	Negative
TCAATCTAGATGTAGT	Hashtag5
TCAATCTAGCACTCAT	Hashtag5
TCAATCTGTAAGTTAG	Hashtag5
TCAATCTGTGTTGAGG	Hashtag7
TCAATTCCATCAGCGC	Hashtag5_Hashtag7
TCAATTCGTACTCGTA	Negative
TCAATTCGTATTGACC	Negative
TCAATTCTCCGCTTAC	Negative
TCAATTCTCTGAATGC	Negative
TCACAAGAGGAACTCG	Hashtag5
TCACAAGCAATACGCT	Negative
TCACAAGCACGGTGCT	Hashtag7
TCACAAGGTCTCACGG	Hashtag7
TCACAAGGTCTGTAAC	Hashtag5_Hashtag7
TCACAAGTCAGGACGA	Hashtag5
TCACACCAGATGCTGG	Negative
TCACACCCAAATACAG	Hashtag5_Hashtag7
TCACACCCATCGGAAG	Hashtag5_Hashtag7
TCACACCGTTGAAGTA	Hashtag5
TCACATTAGAATCGCG	Hashtag5_Hashtag7
TCACATTAGGGAACAA	Negative
TCACATTCATAATCGC	Negative
TCACATTCATCACCAA	Hashtag5_Hashtag7
TCACGCTAGACTACGG	Hashtag5
TCACGCTAGCTACTGT	Negative
TCACGCTAGTGATGGC	Hashtag7
TCACGCTCAAGCTGTT	Hashtag5
TCACGCTCACACAGAG	Negative
TCACGCTCACCTGAAT	Hashtag7
TCACGCTCATGTGACT	Hashtag5
TCACGCTGTCGACTTA	Hashtag5
TCACGCTTCCAGCCTT	Hashtag5_Hashtag7
TCACGCTTCCATATGG	Hashtag7
TCACGCTTCTGAATGC	Hashtag5
TCACGGGAGCTAAATG	Hashtag5
TCACGGGAGTAGAGTT	Hashtag7
TCACGGGCAAGTGGAC	Negative
TCACGGGCACAGAGCA	Hashtag5
TCACGGGCATCGAAGG	Hashtag7
TCACTATAGACTAGAT	Hashtag5
TCACTATCAACCACAT	Negative
TCACTATCAACTGAAA	Negative
TCACTATCACGACAAG	Hashtag5_Hashtag7
TCACTATGTTCGTAAC	Hashtag5
TCACTCGAGTAAAGCT	Hashtag7
TCACTCGAGTTCCTGA	Hashtag7
TCACTCGCACGTCATA	Hashtag5
TCACTCGGTATGAGAT	Negative
TCACTCGGTTCAGTAC	Hashtag7
TCACTCGTCACCTTGC	Hashtag5
TCACTCGTCACTTGGA	Negative
TCACTCGTCATCGCTC	Negative
TCACTCGTCCCGTGAG	Hashtag7
TCAGCAAAGGATCATA	Hashtag5
TCAGCAACACAAGTGG	Negative
TCAGCAAGTCGTCATA	Hashtag5_Hashtag7
TCAGCAATCGAGTCTA	Hashtag5
TCAGCCTAGAGTCTGG	Negative
TCAGCCTAGGGAGAAT	Hashtag7
TCAGCCTCAACGGCCT	Hashtag5_Hashtag7
TCAGCCTTCACTCACC	Negative
TCAGCCTTCGTCAGAT	Hashtag7
TCAGGGCAGCGCCCAT	Hashtag5
TCAGGGCCAGCTACAT	Hashtag5
TCAGGGCCATCGGAAG	Hashtag5_Hashtag7
TCAGGGCGTCTACAAC	Negative
TCAGGTAAGTGGACTG	Hashtag7
TCAGGTACATAATCGC	Hashtag5
TCAGGTACATTGGATC	Hashtag5
TCAGGTATCAGGACGA	Negative
TCAGGTATCGCTTACC	Hashtag7
TCAGTCCAGGCACTCC	Hashtag5
TCAGTCCCAAGCACCC	Hashtag7
TCAGTCCGTACAATAG	Hashtag5
TCAGTCCGTACGATCT	Hashtag5
TCAGTCCGTCTCTCAC	Hashtag5
TCAGTCCGTTCTCGTC	Negative
TCAGTCCTCCACGTAA	Negative
TCAGTCCTCTAATTCC	Hashtag5_Hashtag7
TCAGTGAGTAGGAGGG	Negative
TCAGTGATCCTTCTTC	Hashtag7
TCAGTTTAGGCTCACC	Hashtag5
TCAGTTTCAATTTCCT	Hashtag7
TCAGTTTGTAGAGATT	Hashtag5
TCAGTTTTCGAACTCA	Hashtag5
TCATACTAGCGTGCCT	Negative
TCATACTCACGTAACT	Hashtag5
TCATACTCAGCAGGAT	Negative
TCATACTCAGTCGAGA	Hashtag5
TCATACTGTCTCCCTA	Negative
TCATACTGTGTCTAAC	Negative
TCATACTGTTCTCTCG	Hashtag5
TCATATCAGTGTCATC	Hashtag7
TCATATCAGTTACGTC	Hashtag7
TCATATCAGTTGGCTT	Hashtag7
TCATATCCAACGTTAC	Hashtag7
TCATATCCACCTGATA	Negative
TCATATCCAGTCGGTC	Hashtag5
TCATATCGTCTGTAGT	Negative
TCATATCGTGAGTTGG	Hashtag5_Hashtag7
TCATATCTCTAAGGAA	Hashtag5
TCATCATAGCCGATAG	Negative
TCATCATCACGACAGA	Hashtag7
TCATCATCAGTACTAC	Hashtag5
TCATCATGTGTCACAT	Negative
TCATCATGTTAATGAG	Hashtag5_Hashtag7
TCATCCGCATGGTACT	Hashtag5
TCATCCGGTAGATCCT	Hashtag7
TCATCCGGTTTGCCGG	Hashtag5_Hashtag7
TCATCCGTCCGGTTCT	Negative
TCATGAGCAATGCAGG	Hashtag7
TCATGAGCAGCAGTGA	Hashtag5
TCATGAGCATATGCGT	Hashtag7
TCATGAGGTAAGTTAG	Hashtag5_Hashtag7
TCATGAGGTACTCCGG	Hashtag5_Hashtag7
TCATGAGGTAGAGTTA	Negative
TCATGAGGTGCATGTT	Hashtag7
TCATGAGTCGCTTAAG	Hashtag5
TCATGAGTCTACCCAC	Negative
TCATGAGTCTATACGG	Hashtag5
TCATGCCCAGATACTC	Negative
TCATGCCCATAATGCC	Hashtag7
TCATGCCGTGGAAGTC	Hashtag5
TCATGGAAGTGAGGCT	Negative
TCATGGACACGTAACT	Hashtag5_Hashtag7
TCATGGAGTCAGTCCG	Negative
TCATGGAGTTATGTGC	Hashtag5_Hashtag7
TCATGGATCACCTTAT	Hashtag5
TCATGGATCAGGACAG	Hashtag5_Hashtag7
TCATGGATCTACGCAA	Hashtag5
TCATGTTAGCTTGTTG	Hashtag5_Hashtag7
TCATGTTAGGCTTAAA	Hashtag5
TCATGTTAGGGAGTGG	Hashtag5_Hashtag7
TCATGTTAGTATTGCC	Hashtag7
TCATGTTGTCTGCAAT	Negative
TCATGTTTCACTTATC	Negative
TCATGTTTCCCTCGAT	Negative
TCATGTTTCCGGTTCT	Negative
TCATGTTTCTTAGCTT	Hashtag5
TCATTACAGATGACAT	Hashtag5_Hashtag7
TCATTACCAATCTCGA	Hashtag5_Hashtag7
TCATTACCATTGTAGC	Hashtag5
TCATTACGTCTCTCTG	Negative
TCATTACGTTCCGCGA	Hashtag5_Hashtag7
TCATTACTCGCTAGCG	Hashtag5
TCATTCAAGCAGTACG	Hashtag7
TCATTCAAGCCTCTGG	Hashtag5_Hashtag7
TCATTCAAGTGTTCAC	Negative
TCATTCACAATCGAAA	Negative
TCATTCACAGGTCAAG	Negative
TCATTCAGTACCGGAA	Hashtag5
TCATTCAGTGACTATC	Hashtag7
TCATTGTCAAGCAGGT	Hashtag5
TCATTGTCAAGCTACT	Negative
TCATTGTCACAGCTTA	Hashtag7
TCATTGTCACTGCGTG	Hashtag5_Hashtag7
TCATTGTCACTGTGAT	Negative
TCATTGTCAGAACTCT	Hashtag7
TCATTGTCAGGCGAAT	Hashtag5
TCATTGTGTTAAGCAA	Negative
TCATTGTTCGCTTGCT	Hashtag5_Hashtag7
TCATTTGCAAGAGCTG	Negative
TCATTTGCATCGAACT	Negative
TCATTTGCATCGCCTT	Hashtag5_Hashtag7
TCATTTGGTCGACGCT	Hashtag7
TCATTTGGTGACTCTA	Hashtag7
TCATTTGGTGATTAGA	Negative
TCATTTGGTTGCTCAA	Negative
TCATTTGTCCTTATAC	Hashtag5
TCCACCAAGACATCAA	Hashtag5
TCCACCAAGCTAAGTA	Hashtag5
TCCACCAAGTAGTGCG	Hashtag5_Hashtag7
TCCACCACACCCAATA	Hashtag5_Hashtag7
TCCACCACACGAGAAC	Hashtag5
TCCACCACACGTCATA	Negative
TCCACCACATCATCTT	Hashtag5
TCCACCACATGATCTG	Hashtag5
TCCACCAGTACACTCA	Hashtag7
TCCACCAGTCGTTGGC	Negative
TCCACCATCACCCTGT	Hashtag5_Hashtag7
TCCACCATCGAACCTA	Hashtag7
TCCACGTAGATGTTCC	Negative
TCCACGTTCGAGCACC	Negative
TCCAGAAAGACCGTTT	Negative
TCCAGAAAGCGTTAGG	Negative
TCCAGAAAGGACAACC	Hashtag5_Hashtag7
TCCAGAAAGGTCATCT	Negative
TCCAGAAAGTAAACGT	Hashtag5
TCCAGAACAAATAAGC	Negative
TCCAGAATCATTGGTG	Hashtag5
TCCAGAATCGATTGGT	Hashtag5
TCCATCGCAAATCGTC	Hashtag7
TCCATCGCACTGAGGA	Hashtag5
TCCATCGCACTGGACC	Hashtag5_Hashtag7
TCCATCGCACTTGGGC	Hashtag7
TCCATCGGTTGTGTTG	Hashtag5
TCCATCGTCACGGGAA	Hashtag7
TCCATCGTCAGTCATG	Negative
TCCATCGTCTGACGCG	Hashtag5_Hashtag7
TCCATGCAGTCTAACC	Hashtag5_Hashtag7
TCCATGCCAGAAATTG	Negative
TCCATGCGTCATCCCT	Hashtag5_Hashtag7
TCCATGCGTGTCTTAG	Negative
TCCATGCTCCGTTGAA	Hashtag5
TCCCACAAGCATACTC	Hashtag5_Hashtag7
TCCCACACAAGTGACG	Hashtag5
TCCCACACATAGAAAC	Negative
TCCCACACATGGCTAT	Negative
TCCCACAGTATCCCTC	Negative
TCCCACAGTTCTTGCC	Negative
TCCCACATCCGCTTAC	Negative
TCCCAGTCAAGCACCC	Hashtag5_Hashtag7
TCCCAGTCAGTCAGCC	Hashtag5
TCCCAGTGTAACACCT	Hashtag7
TCCCAGTGTACGTGTT	Negative
TCCCAGTGTCGAGTTT	Hashtag5
TCCCAGTGTCGGTGAA	Hashtag5
TCCCAGTGTGCCCTTT	Hashtag5
TCCCAGTTCCCTATTA	Hashtag7
TCCCATGAGACGCTCC	Hashtag5
TCCCATGAGCCTCTCT	Hashtag7
TCCCATGAGCGAAACC	Hashtag7
TCCCATGAGGGACCAT	Negative
TCCCATGAGTTCCAGT	Hashtag5
TCCCATGAGTTCTCTT	Hashtag5_Hashtag7
TCCCATGCAAAGGATT	Negative
TCCCATGCAGTCACGC	Hashtag7
TCCCATGCATAGACTC	Negative
TCCCATGGTGGCCTCA	Negative
TCCCATGTCGCCTATC	Hashtag5_Hashtag7
TCCGAAAAGCGAGGAG	Hashtag5_Hashtag7
TCCGAAACAACATCGT	Hashtag7
TCCGAAAGTCCACGCA	Hashtag7
TCCGAAAGTGCGGATA	Hashtag5_Hashtag7
TCCGAAAGTTGGCCGT	Hashtag7
TCCGAAATCCCTTGTG	Negative
TCCGAAATCCGACGGT	Hashtag5_Hashtag7
TCCGAAATCTATCACT	Negative
TCCGAAATCTCACTCG	Negative
TCCGATCCAGAGTTGG	Hashtag5
TCCGATCCAGTTGAAA	Hashtag5_Hashtag7
TCCGATCGTGGCACTC	Hashtag5
TCCGATCTCACACGAT	Hashtag5_Hashtag7
TCCGATCTCGACATTG	Negative
TCCGATCTCGAGCTGC	Hashtag5_Hashtag7
TCCGGGAAGACCCTTA	Hashtag7
TCCGGGACAGATTCGT	Hashtag5
TCCGGGAGTCCTCCAT	Hashtag5
TCCGGGAGTGAGTAGC	Hashtag5_Hashtag7
TCCGGGATCATGGATC	Hashtag5
TCCGTGTCATACGCAT	Hashtag5
TCCGTGTGTAAGATAC	Negative
TCCGTGTGTAGCTAAA	Negative
TCCGTGTGTGATCATC	Negative
TCCGTGTTCCTCACCA	Negative
TCCGTGTTCCTGGTCT	Hashtag5
TCCGTGTTCGCAGTTA	Hashtag5
TCCTAATAGGATCACG	Hashtag5
TCCTAATCAATTCACG	Negative
TCCTAATCAGAGCTAG	Hashtag5_Hashtag7
TCCTAATGTCACTCTC	Hashtag5_Hashtag7
TCCTAATGTGTGTGTT	Hashtag7
TCCTAATGTTTGGGAG	Negative
TCCTCCCAGCTCCCTT	Negative
TCCTCCCAGCTTTGTG	Hashtag7
TCCTCCCCAGGGAGAG	Hashtag5_Hashtag7
TCCTCCCGTACTAACC	Hashtag5
TCCTCCCTCAAGAGTA	Hashtag5
TCCTCCCTCGTTCGCT	Hashtag5
TCCTCCCTCTTAGCAG	Negative
TCCTCGAAGAGCAGCT	Hashtag7
TCCTCGACACGTGAGA	Hashtag7
TCCTCGACAGTCTGGC	Hashtag5
TCCTCGATCCCGAACG	Negative
TCCTCGATCGTCGGGT	Negative
TCCTCTTAGAGATCGC	Negative
TCCTCTTCACTAACCA	Negative
TCCTCTTGTAGATTGA	Hashtag5_Hashtag7
TCCTCTTTCCAAGCAT	Hashtag7
TCCTGCAGTACGAGCA	Hashtag5_Hashtag7
TCCTGCAGTATCGTTG	Hashtag5_Hashtag7
TCCTGCAGTCATGCAT	Hashtag7
TCCTGCAGTGGGTCAA	Hashtag5
TCCTGCATCATGGGAG	Hashtag5_Hashtag7
TCCTTCTAGCGTTAGG	Hashtag5_Hashtag7
TCCTTCTCACGCTGCA	Hashtag5
TCCTTCTCAGTCGGTC	Hashtag5
TCCTTCTCATGACGGA	Hashtag5
TCCTTCTTCCGTAGTA	Hashtag5
TCCTTCTTCTAACACG	Negative
TCCTTTCAGATAACGT	Hashtag5_Hashtag7
TCCTTTCCAGTCAGCC	Hashtag5_Hashtag7
TCCTTTCGTAGGCTGA	Hashtag5
TCCTTTCGTGGATCAG	Negative
TCCTTTCTCGACCACG	Hashtag7
TCCTTTCTCGTGTGGC	Hashtag5
TCGAACAAGAACGCGT	Hashtag5_Hashtag7
TCGAACAAGGCATGGT	Hashtag5
TCGAACAAGTCGCCAC	Hashtag5_Hashtag7
TCGAACACATCGGAAG	Hashtag5
TCGAACAGTAGGGAGG	Hashtag5
TCGAACATCGTCAACA	Hashtag5_Hashtag7
TCGAAGTAGTGAGGTC	Hashtag5
TCGAAGTAGTGTTGTC	Hashtag5_Hashtag7
TCGAAGTCAAAGGGCT	Hashtag5
TCGAAGTCACCGTACG	Hashtag5_Hashtag7
TCGACCTCAGAGTCTT	Negative
TCGACCTCAGAGTTGG	Negative
TCGACCTGTTAATGAG	Negative
TCGACCTTCTGGAAGG	Hashtag5_Hashtag7
TCGACGGAGGTCACTT	Hashtag7
TCGACGGCAGATCACT	Hashtag5_Hashtag7
TCGACGGCATCGTCCT	Hashtag5_Hashtag7
TCGACGGGTCTAACGT	Negative
TCGACGGGTTGACTAC	Hashtag5
TCGACGGGTTGTTTGG	Negative
TCGATTTAGACTTCCA	Hashtag5
TCGATTTGTATCAGGG	Hashtag7
TCGATTTTCGATCCCT	Hashtag7
TCGCACTAGCAACTCT	Hashtag5_Hashtag7
TCGCACTCAACTCGAT	Negative
TCGCACTCATATTCGG	Hashtag5_Hashtag7
TCGCACTGTGGTACAG	Hashtag5
TCGCACTTCAAGCCTA	Hashtag5_Hashtag7
TCGCAGGAGAGGATCC	Hashtag7
TCGCAGGAGGCTGTAG	Hashtag5_Hashtag7
TCGCAGGAGTGGACTG	Hashtag5_Hashtag7
TCGCAGGCAACAGATA	Hashtag5_Hashtag7
TCGCAGGGTACGTTCA	Negative
TCGCAGGGTATGGGAC	Hashtag5
TCGCAGGGTGTCTTGA	Hashtag5
TCGCAGGTCATAGACC	Negative
TCGCTCAAGAGTCGAC	Negative
TCGCTCAAGTATGAAC	Hashtag7
TCGCTCAAGTCCGTCG	Hashtag5_Hashtag7
TCGCTCACACAATCTG	Negative
TCGCTCACACGGATCC	Hashtag5
TCGCTCATCCATCTCG	Hashtag5
TCGCTCATCCCGTAAA	Hashtag7
TCGCTCATCGATAACC	Negative
TCGCTTGCAACTTGCA	Hashtag5
TCGCTTGGTAGACGGT	Negative
TCGCTTGGTTATCTTC	Negative
TCGCTTGTCCTGTTAT	Hashtag7
TCGCTTGTCGCCTTTG	Negative
TCGCTTGTCGTTCCCA	Hashtag5_Hashtag7
TCGGATAAGACCTCCG	Hashtag7
TCGGATAAGTAGATCA	Hashtag7
TCGGATACATTGACAC	Hashtag5
TCGGATAGTGACGCCT	Hashtag5_Hashtag7
TCGGATAGTTCGAAGG	Negative
TCGGATATCATGCCGG	Hashtag5_Hashtag7
TCGGATATCCATTCAT	Hashtag5_Hashtag7
TCGGATATCCCGTGAG	Hashtag5_Hashtag7
TCGGGACAGAACCCGA	Hashtag5
TCGGGACAGTATAGAC	Hashtag7
TCGGGACCAATACCTG	Hashtag5
TCGGGACGTGGTCCCA	Hashtag5_Hashtag7
TCGGGACTCATGAGTC	Hashtag5_Hashtag7
TCGGGACTCCACGTAA	Negative
TCGGGACTCGCTTGAA	Hashtag5_Hashtag7
TCGGGACTCTAGACAC	Hashtag5_Hashtag7
TCGGGACTCTGGGCGT	Negative
TCGGGCAAGAAGCCAC	Hashtag5
TCGGGCAAGGCTTAGG	Hashtag7
TCGGGCAGTAGCCAGA	Negative
TCGGGCAGTGAGACGT	Hashtag5_Hashtag7
TCGGGCAGTTCTAACG	Hashtag7
TCGGGCATCCGGGACT	Hashtag5_Hashtag7
TCGGGCATCCGTGTAA	Hashtag5
TCGGGTGAGCAACTTC	Negative
TCGGGTGAGGAGACCT	Negative
TCGGGTGAGTGGTGAC	Hashtag5
TCGGGTGCACCATTCC	Negative
TCGGGTGCACTCCGGA	Hashtag7
TCGGGTGCACTTGTCC	Negative
TCGGGTGCAGTTCTAG	Hashtag7
TCGGGTGCATAATGAG	Hashtag5
TCGGGTGTCCATTGGA	Hashtag5
TCGGTCTAGAATTGCA	Hashtag7
TCGGTCTCATTGAGGG	Negative
TCGGTCTGTGACTCTA	Hashtag5
TCGGTCTGTGCACATT	Hashtag5
TCGGTCTGTTTCGTGA	Hashtag5
TCGGTCTTCTGCTAGA	Negative
TCGTAGAAGCTCGGCT	Negative
TCGTAGACAGCGTGAA	Hashtag7
TCGTAGAGTAGGTTTC	Hashtag5_Hashtag7
TCGTAGAGTCCCTGAG	Negative
TCGTAGAGTCGCCTAG	Hashtag5_Hashtag7
TCGTAGAGTTTACCTT	Hashtag5_Hashtag7
TCGTAGAGTTTATGCG	Negative
TCGTAGATCGCCACTT	Negative
TCGTCCAAGCCTCGTG	Negative
TCGTCCAAGGCCACCT	Hashtag5_Hashtag7
TCGTCCAGTAGGGTAC	Hashtag5_Hashtag7
TCGTCCAGTGGACTGA	Negative
TCGTCCATCTCCCATG	Hashtag5
TCGTGCTCAATGTCAC	Negative
TCGTGCTCAGGCCTGT	Negative
TCGTGCTTCGTGTTCC	Negative
TCGTGGGAGATTGACA	Negative
TCGTGGGAGCAGCCTC	Negative
TCGTGGGAGCCAGAGT	Hashtag5_Hashtag7
TCGTGGGAGTCTTCCC	Hashtag7
TCGTGGGCAACTGGTT	Negative
TCGTGGGGTCCCTAAA	Hashtag5_Hashtag7
TCTAACTAGCAAGCCA	Hashtag5
TCTAACTAGGCACCAA	Hashtag5
TCTAACTCATACCGTA	Negative
TCTAACTGTAGCTTTG	Hashtag7
TCTAACTGTGAAGCTG	Hashtag5
TCTAACTGTTAGGGAC	Negative
TCTAACTTCAGCGTCG	Hashtag5
TCTACATAGTGATTCC	Hashtag5
TCTACATCAAGCGGAT	Hashtag5
TCTACATGTACAGTCT	Hashtag5
TCTACATGTCGATTAC	Hashtag5
TCTACATGTGTGTTTG	Hashtag7
TCTACATTCCACTTTA	Hashtag7
TCTACATTCCTAAACG	Hashtag5_Hashtag7
TCTACCGAGCACACCC	Negative
TCTACCGCAACTTCTT	Hashtag7
TCTACCGCACGACAAG	Hashtag7
TCTACCGCAGGACAGT	Hashtag5
TCTACCGGTCATCACA	Negative
TCTACCGGTGCAGGAT	Negative
TCTACCGGTGGATCAG	Hashtag5
TCTACCGTCCGCACTT	Negative
TCTACCGTCGCTACGG	Hashtag5_Hashtag7
TCTATACAGTCGAATA	Hashtag7
TCTATACGTCAGACGA	Hashtag5
TCTATACGTTGAGTCT	Hashtag5_Hashtag7
TCTATACTCACTGGGC	Hashtag7
TCTATACTCCCTCATG	Hashtag5
TCTATACTCGAATGCT	Negative
TCTATCAAGGTAACTA	Hashtag5
TCTATCAAGTGAGGTC	Hashtag5_Hashtag7
TCTATCACAGAGGCAT	Negative
TCTATCACAGCGAACA	Hashtag5_Hashtag7
TCTATCAGTTCATCGA	Hashtag5
TCTATCATCGAGGCAA	Negative
TCTATCATCTACCTTA	Negative
TCTATCATCTTCACGC	Hashtag5
TCTATCATCTTCTAAC	Hashtag5_Hashtag7
TCTCACGCAAACTCGT	Hashtag7
TCTCACGCACTGGCCA	Negative
TCTCACGCAGAGTCTT	Hashtag5_Hashtag7
TCTCACGGTAAGATTG	Negative
TCTCACGTCGACCAAT	Negative
TCTCACGTCTGAGGTT	Negative
TCTCAGCCACTGATTG	Negative
TCTCAGCCAGCGCTTG	Hashtag5_Hashtag7
TCTCCGAAGAAACTGT	Negative
TCTCCGACAACCGACC	Hashtag5
TCTCCGAGTCCTCCAT	Hashtag5_Hashtag7
TCTCCGAGTGAGATAT	Negative
TCTCCGAGTTGGGCCT	Hashtag5
TCTCCGATCGACCATA	Hashtag7
TCTCCGATCTCTTAAC	Hashtag5_Hashtag7
TCTCCGATCTGTCTCG	Hashtag7
TCTCTGGAGCATCAAA	Negative
TCTCTGGAGTCCTGCG	Hashtag7
TCTCTGGGTCCACTTC	Hashtag5
TCTCTGGGTTCTTAGG	Negative
TCTCTGGTCGATTGAC	Hashtag5_Hashtag7
TCTGCCAAGATAGCTA	Hashtag5
TCTGCCAAGGAGATAG	Hashtag5_Hashtag7
TCTGCCAAGTTGGCTT	Hashtag7
TCTGCCACACTATGTG	Negative
TCTGCCACATTGACAC	Hashtag5
TCTGCCAGTAGCTTTG	Hashtag5_Hashtag7
TCTGCCATCCCGATCT	Hashtag5
TCTGCCATCCTACCGT	Hashtag5
TCTGCCATCGCTAAAC	Hashtag5
TCTGCCATCGCTGTTC	Hashtag7
TCTGGCTAGGTTCAGG	Negative
TCTGGCTCAGCTACTA	Hashtag5_Hashtag7
TCTGTCGAGTCCGCGT	Hashtag5
TCTGTCGCAAGAGGTC	Hashtag5
TCTGTCGCATGTTCAG	Hashtag5
TCTGTCGGTAAGACCG	Negative
TCTGTCGGTAAGGCCA	Hashtag5_Hashtag7
TCTGTCGGTGGAGGTT	Negative
TCTGTCGGTTATTCTC	Hashtag5
TCTTAGTAGGGCATGT	Negative
TCTTAGTCAACGTAAA	Hashtag5
TCTTAGTCAAGCCATT	Hashtag5
TCTTAGTCACAAACGG	Hashtag5
TCTTAGTCACTGCGAC	Negative
TCTTAGTGTCCAAATC	Hashtag5
TCTTAGTGTCTTTCAT	Hashtag7
TCTTAGTGTGACAACG	Hashtag7
TCTTAGTTCAGCGGAA	Hashtag7
TCTTAGTTCGCTGCGA	Hashtag7
TCTTCCTAGGGCGAGA	Hashtag7
TCTTCCTCACCTCAGG	Hashtag7
TCTTCCTCAGTTTGGT	Negative
TCTTCCTGTACGTGAG	Hashtag5_Hashtag7
TCTTCCTGTTCCTACC	Negative
TCTTCCTTCAAATGCC	Negative
TCTTCCTTCTCATGGA	Hashtag7
TCTTGCGAGATACATG	Hashtag7
TCTTGCGAGATGACCG	Negative
TCTTGCGGTAATTGGA	Hashtag5_Hashtag7
TCTTGCGTCAGTCACA	Hashtag5
TCTTTGAAGTAAGCAT	Hashtag5
TCTTTGACAGGCACTC	Hashtag7
TCTTTGATCTCAACCC	Hashtag5_Hashtag7
TGAACGTCAAACCATC	Hashtag5
TGAACGTGTACGTGTT	Negative
TGAACGTGTCATACCA	Hashtag5_Hashtag7
TGAACGTGTTTCGTTT	Negative
TGAATCGCAACTGGTT	Hashtag7
TGAATCGCAGGCTCTG	Hashtag5
TGAATCGTCCTCGCAT	Hashtag5_Hashtag7
TGAATCGTCGGAATTC	Negative
TGAATCGTCTGCGATA	Negative
TGAATGCAGGTAGCCA	Hashtag5_Hashtag7
TGAATGCCAGTCCCGA	Hashtag5_Hashtag7
TGAATGCCATAGCACT	Hashtag5
TGAATGCGTATCAAGA	Hashtag7
TGAATGCGTCACATTG	Hashtag5_Hashtag7
TGAATGCTCGAAATCC	Hashtag5_Hashtag7
TGACAGTCAAGCGCAA	Negative
TGACAGTCATCGTGCG	Negative
TGACAGTCATTGCCGG	Hashtag5_Hashtag7
TGACAGTGTGCAATGG	Hashtag5
TGACAGTGTGGACCTC	Hashtag7
TGACAGTTCAGAGCAG	Hashtag5
TGACAGTTCCTCACTG	Hashtag5
TGACAGTTCGCCGATG	Negative
TGACCCTAGTCTGGTT	Hashtag5
TGACCCTCAGCAGAAC	Hashtag7
TGACCCTCAGCGTTGC	Hashtag7
TGACCCTGTTCCAGGC	Hashtag5_Hashtag7
TGACCCTTCCTTTGAT	Hashtag5
TGACGCGCACAGCCAC	Hashtag5
TGACGCGCAGAAGCGT	Hashtag5
TGACGCGTCTCTCGAC	Hashtag5_Hashtag7
TGACTCCAGTTCCTGA	Hashtag5_Hashtag7
TGACTCCCAACTCGAT	Hashtag7
TGACTCCCACAACGCC	Negative
TGACTCCCAGATCACT	Hashtag7
TGACTCCGTAGATCGG	Hashtag5_Hashtag7
TGACTCCGTCTCGCGA	Hashtag7
TGACTCCGTGCTGTCG	Hashtag5_Hashtag7
TGACTCCTCTAGGAAA	Hashtag5
TGACTCCTCTTCCACG	Negative
TGAGACTAGATGTAGT	Hashtag5
TGAGACTAGATTAGAC	Negative
TGAGACTAGTCAGCCC	Hashtag5
TGAGACTCACTTTAGG	Negative
TGAGACTCATTAAAGG	Hashtag7
TGAGACTGTGGACAGT	Hashtag5
TGAGACTTCGTCTACC	Negative
TGAGCATAGTGCCAGA	Hashtag7
TGAGCATCACATGACT	Hashtag7
TGAGCATCATATTCGG	Hashtag7
TGAGCATCATCCGTTC	Negative
TGAGCATCATTCTGTT	Hashtag5_Hashtag7
TGAGCATGTATCCTTT	Hashtag5
TGAGCATTCGGTAGAG	Hashtag5_Hashtag7
TGAGCGCAGTAACGTA	Hashtag5_Hashtag7
TGAGCGCTCAAGGACG	Negative
TGAGCGCTCACCGGTG	Negative
TGAGGAGAGAAACCAT	Hashtag5_Hashtag7
TGAGGAGCAAATGGTA	Hashtag5_Hashtag7
TGAGGAGCATCTTCGC	Hashtag5_Hashtag7
TGAGGAGGTCTTCGAA	Negative
TGAGGAGGTTGCTCGG	Hashtag7
TGAGGAGGTTGGACTT	Negative
TGAGGAGTCTCTAGGA	Hashtag5
TGAGGGAAGCTGCGAA	Hashtag7
TGAGGGACAGTAGTGG	Hashtag5
TGAGGGAGTGTCTTGA	Hashtag5_Hashtag7
TGAGGGATCGTAACAC	Hashtag5
TGAGGTTAGGCTCTAT	Hashtag7
TGAGGTTTCCAACCGG	Negative
TGAGGTTTCGCTAGCG	Negative
TGAGTCAAGAGAGTGA	Negative
TGAGTCAAGATCGCCC	Hashtag5
TGAGTCAAGCTGGCTC	Hashtag7
TGAGTCATCAAGAAAC	Hashtag7
TGATCAGAGACATCCT	Hashtag5
TGATCAGCAGGACAGT	Hashtag5
TGATCAGCAGGCACAA	Hashtag5_Hashtag7
TGATCAGCATCAGTGT	Negative
TGATCAGGTCAAGCCC	Hashtag5_Hashtag7
TGATCTTCAAATAAGC	Negative
TGATCTTCATAGAATG	Hashtag5
TGATCTTCATCGAGCC	Hashtag5
TGATCTTGTATCTCTT	Negative
TGATCTTGTTGCCAAT	Hashtag5
TGATCTTTCGAAACAA	Hashtag7
TGATGCAAGAGCAGCT	Hashtag5_Hashtag7
TGATGCAAGTGGCCTC	Hashtag5
TGATGCACAGAGTCTT	Hashtag7
TGATGCATCAAAGCCT	Negative
TGATGCATCCGCACTT	Hashtag7
TGATGCATCCTTCGAC	Hashtag5
TGATGCATCTCCGAGG	Negative
TGATGCATCTGCTTAT	Hashtag5
TGATGCATCTTGGAAC	Hashtag5_Hashtag7
TGATGGTAGAATACAC	Negative
TGATGGTGTAAGTCAA	Hashtag7
TGATGGTGTGCCGAAA	Negative
TGATGGTGTTTCGTGA	Hashtag7
TGATGGTTCCTAGCTC	Negative
TGATGGTTCTTGTTAC	Negative
TGATTCTAGATTAGCA	Negative
TGATTCTCAGCAGATG	Hashtag5_Hashtag7
TGATTCTGTTGCTCAA	Hashtag5_Hashtag7
TGATTTCAGAAGGCTC	Hashtag5
TGATTTCAGCAGTACG	Negative
TGATTTCAGCTATCTG	Negative
TGATTTCGTGCAGATG	Negative
TGATTTCTCGCCTTTG	Hashtag7
TGCACGGAGCGGACAT	Hashtag5_Hashtag7
TGCACGGAGTGCAGCA	Hashtag7
TGCACGGGTCTGTAGT	Negative
TGCACGGGTGTAACGG	Hashtag5
TGCAGATCAATGGGTG	Hashtag7
TGCAGATTCACGGTCG	Hashtag5
TGCAGGCAGAACGCGT	Hashtag7
TGCAGGCAGACTACCT	Negative
TGCAGGCAGTATCTGC	Negative
TGCAGGCGTCCAGCGT	Hashtag5_Hashtag7
TGCAGGCGTCCTGAAT	Hashtag5
TGCAGGCGTTGTGGAG	Hashtag5
TGCAGGCGTTTGGAGG	Negative
TGCAGTAAGACATAGT	Negative
TGCAGTAAGGATACAT	Hashtag5_Hashtag7
TGCAGTACATCGATGT	Hashtag5_Hashtag7
TGCAGTAGTAATGCTC	Negative
TGCAGTAGTTAAAGTG	Negative
TGCAGTATCATGCCGG	Hashtag5_Hashtag7
TGCAGTATCCCAACTC	Hashtag7
TGCAGTATCTATTGTC	Negative
TGCAGTATCTCCTGTG	Hashtag7
TGCATCCAGTTCTCTT	Hashtag7
TGCATCCGTACAGTTC	Hashtag7
TGCATCCTCATTTGGG	Negative
TGCATGAAGTGCGCTC	Hashtag5
TGCATGACAGTTGTCA	Hashtag5
TGCATGACATATACCG	Negative
TGCATGAGTCAGCGTC	Hashtag7
TGCATGAGTGAGCGAT	Hashtag7
TGCATGATCGAAGGAC	Hashtag5_Hashtag7
TGCATGATCGACCAAT	Negative
TGCATGATCTGCCCTA	Hashtag5
TGCCGAGAGACGTCCC	Hashtag7
TGCCGAGAGTACGTCT	Hashtag5_Hashtag7
TGCCGAGCAATGACCT	Negative
TGCCGAGCACAAATCC	Hashtag7
TGCCGAGCACCCTCTA	Negative
TGCCGAGGTCCAAATC	Negative
TGCCGAGGTTAAGCAA	Hashtag5_Hashtag7
TGCGACGCAAGCACAG	Hashtag5
TGCGACGCACAAGCTT	Hashtag5
TGCGACGCATGGAGAC	Hashtag7
TGCGACGGTAGAATGT	Negative
TGCGACGGTCTTGGTA	Hashtag7
TGCGACGGTGTGCCTG	Hashtag5_Hashtag7
TGCGACGTCCTTTGAT	Hashtag7
TGCGACGTCTCACTCG	Hashtag5_Hashtag7
TGCGACGTCTTGGCTC	Negative
TGCGATACAGAGCGTA	Hashtag5
TGCGATACAGCACGAA	Negative
TGCGATATCGGTAACT	Hashtag5_Hashtag7
TGCGATATCTGGACTA	Hashtag7
TGCGATATCTTGATTC	Negative
TGCGGCACACGAAAGC	Negative
TGCGGCAGTATCGTAC	Hashtag5
TGCGGCAGTGCCCTTT	Negative
TGCGGCAGTGTGTTTG	Hashtag5_Hashtag7
TGCGGCATCGACGATT	Hashtag5_Hashtag7
TGCGGGTCAACGTTAC	Hashtag5
TGCGGGTCATCATCCC	Negative
TGCGGGTGTCTTCGAA	Hashtag7
TGCGGGTGTTGGGATG	Hashtag7
TGCGGGTTCGAGTTGT	Negative
TGCGGGTTCTATGCCC	Hashtag5
TGCTCCAAGCGGTAAC	Negative
TGCTCCAAGGATTTGA	Negative
TGCTCCAAGGTAGATT	Hashtag7
TGCTCCAAGTCACAGG	Negative
TGCTCCACAGGAATAT	Negative
TGCTCCAGTTAGTCGT	Hashtag5
TGCTCCAGTTCAGTAC	Hashtag5
TGCTCCAGTTGTTGTG	Negative
TGCTCGTAGCGACTAG	Hashtag7
TGCTCGTGTCAAGGCA	Negative
TGCTCGTGTGGTCTGC	Hashtag5
TGCTGAAAGGATACGC	Hashtag5
TGCTGAAAGTATGACA	Hashtag5_Hashtag7
TGCTGAACAAGTGCAG	Negative
TGCTGAACAGAAGCGT	Hashtag7
TGCTGAAGTATAATGG	Hashtag5_Hashtag7
TGCTGAATCTTACCGC	Negative
TGCTTCGAGGCACTAG	Hashtag7
TGCTTCGAGGTTAAAC	Negative
TGCTTCGCACAGTCAT	Hashtag5_Hashtag7
TGCTTCGGTTCAGTAC	Hashtag7
TGCTTCGTCGGCCAAC	Hashtag7
TGCTTCGTCTCGGGAC	Hashtag5_Hashtag7
TGCTTGCAGTAGGTTA	Hashtag5
TGCTTGCAGTTCATGC	Hashtag7
TGCTTGCCAACACAAA	Hashtag5
TGCTTGCGTCCGGCAT	Hashtag7
TGCTTGCTCTATCGGA	Hashtag5
TGGAACTAGCGCCCAT	Hashtag5
TGGAACTCAAGTACCT	Hashtag5
TGGAACTGTAATGTGA	Hashtag5_Hashtag7
TGGAACTGTCCGACGT	Negative
TGGAACTTCGCTGTCT	Negative
TGGAACTTCTTGCAAG	Hashtag5_Hashtag7
TGGAGAGAGGCATGCA	Negative
TGGAGAGAGGTTCCAT	Negative
TGGAGAGAGTTCCGGC	Negative
TGGAGAGGTACAAGTA	Hashtag5
TGGAGAGTCAATCCGA	Hashtag5_Hashtag7
TGGAGAGTCAGTAGGG	Hashtag5
TGGAGAGTCCCTTGTG	Negative
TGGAGAGTCCGTGGTG	Hashtag5_Hashtag7
TGGAGAGTCCTCTAGC	Hashtag7
TGGAGAGTCTAGCCTC	Hashtag5_Hashtag7
TGGAGGAAGCACTAAA	Hashtag7
TGGAGGAAGGTTCATC	Hashtag5_Hashtag7
TGGAGGACACGGTGCT	Negative
TGGAGGACATAATCCG	Hashtag5
TGGAGGAGTACGACTT	Hashtag5_Hashtag7
TGGAGGAGTATCAGCT	Hashtag5
TGGAGGAGTTCGGGTC	Hashtag5_Hashtag7
TGGAGGATCATGCAGT	Hashtag5
TGGAGGATCATGGATC	Negative
TGGATCAAGGTCACAG	Hashtag5_Hashtag7
TGGATCAAGTCTTGGT	Hashtag7
TGGATCAGTAGCGATG	Hashtag5_Hashtag7
TGGATCATCTGGCCAG	Hashtag7
TGGATGTAGACTGTTC	Negative
TGGATGTAGAGATCGC	Hashtag5_Hashtag7
TGGATGTAGAGTCGAC	Hashtag5_Hashtag7
TGGATGTCAAGGTCTT	Negative
TGGATGTCACCTGAAT	Hashtag5
TGGATGTCACTCTGCT	Hashtag7
TGGATGTGTCCTTGTC	Negative
TGGATGTGTGAGGAAA	Negative
TGGATGTTCCAGCCTT	Hashtag7
TGGATGTTCCTCCACA	Hashtag7
TGGCGTGAGTTAGTAG	Hashtag5_Hashtag7
TGGCGTGCAAATTGCC	Hashtag5
TGGCGTGCAATCGCGC	Hashtag5_Hashtag7
TGGCGTGCACGCTGTG	Hashtag5_Hashtag7
TGGCGTGCAGTAGGAC	Negative
TGGCGTGTCCCTCGTA	Negative
TGGGAAGAGAAGCCTG	Hashtag5
TGGGAAGCAAACTGCT	Hashtag5_Hashtag7
TGGGAAGGTCAGCGTC	Hashtag5
TGGGAAGGTCCACTTC	Hashtag7
TGGGAGACAAACGGCA	Hashtag5
TGGGAGACAAGTGCAG	Negative
TGGGAGACAGACAATA	Negative
TGGGAGACATGACGAG	Negative
TGGGAGAGTGCCTTCT	Hashtag5
TGGGAGATCAAGCCGC	Hashtag5_Hashtag7
TGGGAGATCGGCTGGT	Hashtag7
TGGGAGATCTGCGGAC	Hashtag5
TGGGATTAGGTACAGC	Hashtag5_Hashtag7
TGGGATTCAACACACT	Hashtag5_Hashtag7
TGGGATTTCCGGACTG	Hashtag5_Hashtag7
TGGGATTTCTGGGCGT	Hashtag5
TGGGCGTAGATAGCTA	Hashtag5_Hashtag7
TGGGCGTAGTCATGGG	Negative
TGGGCGTCACTGTCCT	Hashtag7
TGGGCGTCAGCACCCA	Negative
TGGGCGTGTCGTCAGC	Hashtag5
TGGGCTGAGAAGTCCG	Hashtag5_Hashtag7
TGGGCTGAGTGAGGTC	Negative
TGGGCTGCAGCGTGCT	Hashtag5_Hashtag7
TGGGCTGGTGGAACCA	Hashtag7
TGGGCTGTCATGCGGC	Hashtag5_Hashtag7
TGGGCTGTCATGCTAG	Hashtag5
TGGGCTGTCTGAATCG	Hashtag5
TGGGTTAAGATAGTGT	Negative
TGGGTTACAAGTGGTG	Hashtag5
TGGGTTACACCTAAAC	Negative
TGGGTTACACGTCATA	Hashtag5
TGGGTTACAGTACTAC	Hashtag5
TGGGTTATCATTGCCC	Negative
TGGTACAAGCGTCTCG	Hashtag5_Hashtag7
TGGTACAAGGCGAAGG	Hashtag7
TGGTACATCGCCGTGA	Hashtag5
TGGTAGTCAACTGCCG	Hashtag5
TGGTAGTCAATGTCTG	Hashtag5
TGGTAGTCACAAATAG	Negative
TGGTAGTGTAGAGACC	Hashtag5_Hashtag7
TGGTAGTTCGAGTACT	Hashtag7
TGGTAGTTCGCTTTAT	Hashtag5
TGGTAGTTCGTTAGTG	Hashtag5
TGGTGATAGGATTTGA	Hashtag5_Hashtag7
TGGTGATAGTCAATCC	Hashtag5
TGGTGATCATTCTCTA	Negative
TGGTGATGTACAAACA	Negative
TGGTGATGTACAAGCG	Hashtag5
TGGTGATTCCGCTAGG	Hashtag7
TGGTGATTCGGTCTAA	Hashtag5_Hashtag7
TGGTGATTCTCTGGTC	Negative
TGGTTAGGTGCGTCGT	Hashtag5
TGGTTAGTCCAAGGGA	Hashtag5
TGGTTAGTCCGGCTTT	Hashtag5
TGGTTAGTCTCTCGCA	Negative
TGTAACGAGGATATGT	Hashtag7
TGTAACGAGGTGGCTA	Hashtag5_Hashtag7
TGTAACGGTCCGCAGT	Hashtag7
TGTAACGTCTGCATGA	Hashtag5
TGTAAGCAGACGCTCC	Hashtag5
TGTAAGCAGGTTACCT	Hashtag5
TGTAAGCAGTAGACAT	Hashtag5
TGTAAGCAGTGCACAG	Hashtag5
TGTAAGCAGTTCACTG	Hashtag7
TGTAAGCCAAAGAACT	Negative
TGTAAGCGTGGCTGAA	Negative
TGTAAGCTCCCGTAAA	Negative
TGTACAGAGTCATGCT	Hashtag5_Hashtag7
TGTACAGCATGCAGCC	Hashtag7
TGTACAGGTCTTGTCC	Negative
TGTACAGTCGTAGAGG	Hashtag5
TGTAGACCAAGGTTGG	Hashtag5
TGTCAGAGTGAGATAT	Negative
TGTCAGAGTTCAGCTA	Negative
TGTCCACAGAACTGAT	Hashtag5
TGTCCACAGCGTGCTC	Hashtag5_Hashtag7
TGTCCACCACTGCTTC	Hashtag7
TGTCCACCAGTAGGAC	Hashtag7
TGTCCCAAGATTAGTG	Hashtag5
TGTCCCACAAATGCGG	Negative
TGTCCCACAATGAAAC	Hashtag5_Hashtag7
TGTCCCACAGATCACT	Negative
TGTCCCAGTTTCCATT	Hashtag5_Hashtag7
TGTCCCATCCATTCAT	Hashtag5
TGTCCCATCCTACGGG	Hashtag5
TGTCCTGCATGACCCG	Negative
TGTCCTGTCGACCCAG	Hashtag5
TGTCCTGTCTTAGGAC	Hashtag5_Hashtag7
TGTGAGTAGGATTTGA	Hashtag7
TGTGAGTGTAAGGTCG	Negative
TGTGAGTGTCCAGGTC	Negative
TGTGAGTTCTTCGACC	Hashtag5
TGTGATGCAACACGAG	Hashtag5
TGTGATGCATGACCCG	Hashtag5_Hashtag7
TGTGATGGTCTTGAAC	Hashtag7
TGTGATGGTTCTATCT	Negative
TGTGATGTCAGCGCGT	Hashtag5
TGTGATGTCGCCTTTG	Negative
TGTGATGTCTGGGCAC	Hashtag5
TGTGCGGAGATAGTGT	Negative
TGTGCGGCACAGTACT	Hashtag7
TGTGCGGCATCTAGAC	Negative
TGTGCGGCATGCCGGT	Hashtag5
TGTGCGGGTCTACGTA	Hashtag5
TGTGCGGTCAGCAGAG	Hashtag5_Hashtag7
TGTGGCGCACGAGGAT	Hashtag5
TGTGGCGTCACCTCGT	Hashtag5
TGTGTGAAGACATGCG	Negative
TGTGTGAAGGATTTAG	Hashtag5_Hashtag7
TGTGTGACATAGGAGC	Hashtag5
TGTGTGAGTCTCAGAT	Hashtag5_Hashtag7
TGTGTGATCCAAGAGG	Hashtag5
TGTGTGATCCTCACCA	Negative
TGTTACTGTTAGTTCG	Negative
TGTTACTGTTGTGGAG	Hashtag7
TGTTCATCAATTGAGA	Hashtag5_Hashtag7
TGTTCATCAGACGGAT	Hashtag5_Hashtag7
TGTTCATCAGCGGTTC	Negative
TGTTCATGTATCGTGT	Negative
TGTTCATGTCTTACTT	Hashtag7
TGTTCCGAGATACATG	Hashtag7
TGTTCCGAGCATGGGT	Negative
TGTTCCGAGGTAAGTT	Hashtag5_Hashtag7
TGTTCCGAGTCAGAGC	Hashtag5
TGTTCCGCAATACGCT	Hashtag5_Hashtag7
TGTTCCGGTCTGATCA	Hashtag5
TGTTCCGGTTATTCCT	Hashtag7
TGTTCCGTCGGTCACG	Hashtag5
TGTTCCGTCTACGCAA	Negative
TGTTCTACACTTGGCG	Hashtag5
TGTTCTAGTTTGGAAA	Hashtag5
TGTTCTATCGAGAGCA	Hashtag5
TGTTCTATCGAGCCTG	Negative
TGTTGAGAGTGGTTAA	Hashtag5_Hashtag7
TGTTGAGCAAACTAGA	Hashtag5
TGTTGAGCACCGTACG	Hashtag5_Hashtag7
TGTTGGAAGTCATCCA	Hashtag7
TGTTGGACATGTGTCA	Hashtag7
TGTTGGAGTACGATTC	Hashtag5_Hashtag7
TGTTGGAGTACGCTTA	Negative
TGTTGGAGTGCATTAC	Hashtag5
TGTTGGATCAGCTTGA	Negative
TGTTGGATCGGTCAGC	Hashtag7
TGTTTGTAGCTAGAGC	Hashtag5
TGTTTGTAGCTGTACT	Hashtag7
TGTTTGTAGGATGTTA	Hashtag7
TGTTTGTGTAGTCACT	Hashtag5
TGTTTGTGTTAATCGC	Hashtag5
TGTTTGTTCTAGCAAC	Negative
TTAATCCAGCGCTGCT	Negative
TTAATCCGTACAGAAT	Negative
TTAATCCGTACTTGTG	Negative
TTAATCCGTATAGGGC	Hashtag5
TTACAGGAGCCGTTGC	Hashtag5
TTACAGGAGTTTGGCT	Hashtag7
TTACAGGCAAGTCCAT	Hashtag5
TTACAGGTCCGCAAAT	Negative
TTACAGGTCGGTAGAG	Negative
TTACAGGTCTCTCTTC	Negative
TTACCATAGTTGCATC	Hashtag7
TTACCATCATGAGATA	Negative
TTACCATGTAGCGTTT	Hashtag5
TTACCATTCACTCCGT	Negative
TTACCATTCTCGTTTA	Hashtag5
TTACCGCAGCTGGAGT	Hashtag5
TTACCGCCAACGCCCA	Hashtag5
TTACCGCCAGAGGTTG	Hashtag5
TTACCGCCATGCCGAC	Negative
TTACCGCGTAGTTACC	Hashtag5
TTACGCCAGAATAGTC	Hashtag5_Hashtag7
TTACGTTAGACATCCT	Hashtag5
TTACGTTAGCAACAGC	Hashtag5
TTACGTTCACTATCCC	Hashtag7
TTACGTTGTCAAGCGA	Negative
TTACGTTGTGGTAACG	Negative
TTACGTTTCACAGTGT	Hashtag5
TTACGTTTCGGACGTC	Negative
TTACGTTTCTACTCAT	Negative
TTACGTTTCTGGCTGG	Hashtag5
TTACTGTAGCCACAAG	Negative
TTACTGTAGGACAAGA	Hashtag5
TTACTGTCACCTAAAC	Negative
TTACTGTCACTATCCC	Negative
TTACTGTCATCAGCGC	Hashtag5_Hashtag7
TTACTGTGTCTAACTG	Negative
TTACTGTGTGCTCTCT	Negative
TTACTGTTCAGAGCAG	Negative
TTACTGTTCCGACATA	Negative
TTAGGCAAGAATAGTC	Negative
TTAGGCAAGACCCTTA	Hashtag7
TTAGGCACACTAGAGG	Hashtag5
TTAGGCACAGTTGTTG	Negative
TTAGGCACATAGGCGA	Hashtag5
TTAGGCAGTGCATGTT	Hashtag5
TTAGGGTCAATCCTTT	Hashtag5_Hashtag7
TTAGGGTCATAGCTGT	Negative
TTAGGGTCATAGGCGA	Hashtag7
TTAGGGTGTACACGTT	Hashtag5
TTAGGGTGTCGGCACT	Hashtag7
TTAGGGTGTTAAGGAT	Hashtag5
TTAGTCTCAAACAGGC	Hashtag5
TTAGTCTCAAATACAG	Negative
TTAGTCTCAGACAATA	Negative
TTAGTCTGTAGCACAG	Hashtag5_Hashtag7
TTAGTCTGTCTCTCAC	Hashtag5
TTAGTCTGTGCGAACA	Hashtag7
TTAGTCTTCAAGTCGT	Hashtag5
TTAGTCTTCGGTGAAG	Hashtag5
TTATTGCAGGTATTGA	Negative
TTATTGCAGGTTATAG	Negative
TTATTGCAGTCTCTGA	Negative
TTATTGCCATCTATCT	Hashtag5
TTATTGCCATTGTGCA	Negative
TTATTGCGTCCTATAG	Hashtag5
TTATTGCTCAGCGTCG	Hashtag5
TTATTGCTCGAAACAA	Hashtag7
TTATTGCTCGGAAACG	Hashtag7
TTATTGCTCGGAAGGT	Hashtag7
TTCAATCAGCTACTGT	Hashtag5
TTCAATCCAAGAGTAT	Hashtag5_Hashtag7
TTCAATCCAGGTCCGT	Negative
TTCAATCCATCTGTTT	Negative
TTCAATCGTAGATTGA	Negative
TTCAATCGTATCGATC	Hashtag7
TTCAATCGTTAGAGAT	Hashtag7
TTCAATCTCACAAGGG	Negative
TTCAATCTCGAACACT	Hashtag7
TTCACCGGTCAAGGCA	Hashtag7
TTCACGCAGTGCAGGT	Hashtag5_Hashtag7
TTCACGCGTATACCTG	Negative
TTCACGCGTGTTTACG	Hashtag5
TTCACGCGTTTCACTT	Negative
TTCACGCTCATACGAC	Hashtag5_Hashtag7
TTCACGCTCTAAGCCA	Negative
TTCAGGAAGAGGGCGA	Hashtag5_Hashtag7
TTCAGGACACTTTAGG	Negative
TTCAGGAGTACAGTCT	Hashtag5
TTCAGGAGTCAGCTTA	Hashtag7
TTCAGGAGTGCTATTG	Hashtag5
TTCAGGATCATCACTT	Hashtag5_Hashtag7
TTCAGGATCCGCACTT	Hashtag5
TTCAGGATCGAAGTGG	Hashtag5
TTCAGGATCTTGGCTC	Negative
TTCATGTAGTTAACGA	Hashtag5
TTCATGTGTAAGTCAA	Negative
TTCATGTGTGAGCTCC	Negative
TTCATGTGTTAGAGTA	Negative
TTCATGTGTTAGGAGC	Hashtag7
TTCATGTGTTGATGTC	Hashtag5
TTCATGTTCAAAGACA	Hashtag5
TTCATGTTCACCGACG	Negative
TTCATGTTCCGCGGAT	Negative
TTCATTGCAAACACGG	Hashtag7
TTCATTGTCGACACCG	Hashtag5
TTCCAATAGATGCTGG	Negative
TTCCAATAGTCCCGAC	Hashtag7
TTCCAATCAAGAATGT	Hashtag5
TTCCAATCAATCTCGA	Hashtag5_Hashtag7
TTCCAATCACAAATAG	Hashtag5
TTCCAATGTAGTTAGA	Hashtag5
TTCCAATGTGCAGTGA	Hashtag7
TTCCACGCAAATAGCA	Hashtag5
TTCCACGGTAGTACGG	Hashtag5_Hashtag7
TTCCACGTCGCAGTTA	Hashtag5_Hashtag7
TTCCGGTAGACTCTTG	Hashtag5_Hashtag7
TTCCGGTAGGCGTCCT	Hashtag5_Hashtag7
TTCCGGTAGTTGCTCA	Negative
TTCCGGTCACTAGGTT	Hashtag5_Hashtag7
TTCCGGTCATACGCAT	Hashtag5
TTCCGGTGTCGTACAT	Negative
TTCCGGTGTTAGAAGT	Negative
TTCCGGTGTTTCTTAC	Negative
TTCCGGTGTTTGGGTT	Hashtag5_Hashtag7
TTCCGGTTCTATCGCC	Hashtag5
TTCCGTGCAGAGTCAG	Negative
TTCCGTGGTTCAAGTC	Negative
TTCCGTGGTTCGCGTG	Hashtag5_Hashtag7
TTCCGTGTCAATCTTC	Negative
TTCCGTGTCATAGACC	Hashtag5
TTCCTAAAGGATTCAA	Hashtag7
TTCCTAAAGTTGCGAG	Hashtag5_Hashtag7
TTCCTAACACTTGACA	Hashtag7
TTCCTAACAGACCTGC	Hashtag7
TTCCTAAGTACTGCGC	Hashtag5
TTCCTAAGTTCATCTT	Hashtag5
TTCCTCTAGCTCCACG	Negative
TTCCTCTCAGCCTATA	Hashtag5_Hashtag7
TTCCTCTCAGTGTGGA	Hashtag5_Hashtag7
TTCCTCTGTAGCGCCT	Hashtag7
TTCCTCTGTGAGTGAC	Hashtag5
TTCCTCTGTGTGTTTG	Hashtag5
TTCCTCTTCGAGCACC	Negative
TTCCTCTTCTTGAACG	Negative
TTCCTTCAGCACCGAA	Hashtag5_Hashtag7
TTCCTTCAGCCTTCTC	Hashtag5
TTCCTTCCAAGACAAT	Hashtag5
TTCCTTCCAAGTTCCA	Negative
TTCCTTCGTACAGAAT	Negative
TTCCTTCGTACGAAAT	Negative
TTCCTTCGTCTGATCA	Hashtag5
TTCCTTCGTTCAGCGC	Negative
TTCCTTCGTTTCGTGA	Negative
TTCCTTCTCCGGCAAC	Hashtag7
TTCCTTCTCCGTGTGG	Negative
TTCCTTCTCTCTTCAA	Hashtag5
TTCGATTGTAGACAGC	Hashtag5_Hashtag7
TTCGATTGTAGATGTA	Hashtag5_Hashtag7
TTCGATTTCATCGGGC	Hashtag7
TTCGCTGAGCCGATCC	Hashtag7
TTCGCTGAGTCATACC	Negative
TTCGCTGCAACGGGTA	Hashtag7
TTCGCTGCAAGTGGCA	Hashtag5_Hashtag7
TTCGCTGCATTGCTGA	Negative
TTCGCTGCATTGGATC	Hashtag7
TTCGCTGGTGATCGTT	Hashtag7
TTCGCTGGTGGCTGCT	Negative
TTCGGTCAGTATTAGG	Hashtag5
TTCGGTCGTACCTGTA	Hashtag5
TTCGGTCGTCCAACGC	Negative
TTCGGTCGTGATGTAA	Hashtag5_Hashtag7
TTCGGTCGTTAGGGAC	Hashtag5_Hashtag7
TTCGGTCTCAAACCCA	Hashtag5_Hashtag7
TTCGGTCTCACTCTTA	Negative
TTCGGTCTCTGGGCCA	Hashtag7
TTCTAACAGAATTCAG	Negative
TTCTAACAGCCGCTTG	Hashtag5
TTCTAACAGGTCGACA	Hashtag7
TTCTAACCACAGTCAT	Hashtag5
TTCTAACGTACAAACA	Negative
TTCTAACGTGAGTGAC	Hashtag5
TTCTAACGTTCGGTTA	Hashtag5
TTCTAGTCATGACGGA	Hashtag5
TTCTAGTTCAATCTCT	Negative
TTCTAGTTCGACGATT	Hashtag7
TTCTAGTTCGTGACTA	Hashtag7
TTCTAGTTCGTGGACC	Hashtag7
TTCTAGTTCTTCTGGC	Negative
TTCTCTCAGACCTGGA	Negative
TTCTCTCAGTAACGAT	Hashtag5
TTCTCTCGTACAGGTG	Hashtag5
TTCTCTCGTCGTATTG	Negative
TTCTCTCGTGTGTTTG	Negative
TTCTCTCTCTAGGAAA	Negative
TTCTGTAAGAAGTCAT	Hashtag5_Hashtag7
TTCTGTAAGCTTTCCC	Hashtag5
TTCTGTAAGGGACCAT	Negative
TTCTGTAGTGGATCAG	Hashtag5
TTCTGTAGTGTTGATC	Hashtag5_Hashtag7
TTCTGTATCAGGAACG	Hashtag5
TTCTGTATCCCTTCCC	Negative
TTCTTCCAGACTACGG	Negative
TTCTTCCAGCGTCTGC	Hashtag5
TTCTTCCAGGGACTGT	Negative
TTCTTCCCAGCTGAGA	Hashtag7
TTCTTCCCATGCGTGC	Negative
TTCTTCCGTCACGTGC	Hashtag7
TTCTTCCGTGGCAACA	Negative
TTCTTCCTCACGAGGA	Negative
TTCTTCCTCCCTTCCC	Hashtag7
TTCTTCCTCCGTTGAA	Hashtag7
TTCTTGAAGCACGGAT	Negative
TTCTTGAAGTATAACG	Hashtag5_Hashtag7
TTCTTGACAACCAATC	Hashtag7
TTCTTGACACACGGTC	Hashtag5_Hashtag7
TTCTTGACAGACGGAT	Hashtag5_Hashtag7
TTCTTGACATCATTGG	Hashtag5_Hashtag7
TTCTTGATCTTTGCAT	Hashtag5_Hashtag7
TTGAACGAGGTAGTAT	Hashtag5_Hashtag7
TTGAACGAGGTGAGCT	Hashtag7
TTGAACGCACTGCACG	Negative
TTGAACGGTATATGGA	Hashtag7
TTGAACGGTCGACTGC	Hashtag5
TTGAACGTCACCGGTG	Hashtag5
TTGAACGTCCGTAGGC	Negative
TTGAACGTCGACGTCG	Negative
TTGAACGTCGGTCACG	Hashtag5
TTGAGTGAGCTCGGCT	Negative
TTGAGTGCAAGAGATT	Negative
TTGAGTGCACGCGTCA	Negative
TTGAGTGCATTGTAGC	Negative
TTGAGTGTCCGAGGCT	Hashtag5
TTGATGGAGGGTATAT	Negative
TTGATGGCAAGAGGCT	Hashtag7
TTGATGGCAGACCTAT	Negative
TTGATGGCATCCGGCA	Hashtag5_Hashtag7
TTGATGGCATTCTCCG	Negative
TTGATGGGTACAGTAA	Hashtag5
TTGATGGGTTCGCGTG	Hashtag5
TTGATGGTCACTGGGC	Negative
TTGATGGTCAGAGCAG	Negative
TTGATGGTCAGTCCGG	Hashtag7
TTGATGGTCGGCATTA	Hashtag5_Hashtag7
TTGATGGTCGTGCACG	Hashtag5
TTGCATTAGCATGATA	Hashtag5
TTGCATTAGGTAAGTT	Hashtag5_Hashtag7
TTGCATTCACTGATTG	Negative
TTGCATTCATTGACCA	Hashtag7
TTGCATTGTCCTCCAT	Negative
TTGCATTTCCATAGAC	Negative
TTGCCTGAGTTGAAAC	Hashtag5
TTGCCTGCACTGGCCA	Negative
TTGCCTGGTGTACATC	Negative
TTGCCTGTCGTGACTA	Negative
TTGCCTGTCTCCGCAT	Hashtag5
TTGCCTGTCTGTGCGG	Hashtag5
TTGCGTCCACCGTCGA	Hashtag7
TTGCGTCGTAGGATAT	Negative
TTGCGTCTCTGGGCAC	Hashtag5
TTGCTGCAGATCGCCC	Negative
TTGCTGCCAATAGAGT	Hashtag7
TTGCTGCCAGACCAAG	Negative
TTGCTGCCAGTAGAGC	Hashtag5_Hashtag7
TTGCTGCCATGTTTGG	Hashtag7
TTGCTGCTCGTTGTGA	Hashtag5
TTGCTGCTCTATCCAT	Negative
TTGGATGCAAGATTGA	Negative
TTGGATGCAGCACGAA	Hashtag5_Hashtag7
TTGGATGTCTCAACGA	Hashtag5
TTGGGATCACCCTAGG	Hashtag5
TTGGGATCAGCAGGAT	Negative
TTGGGATCATAAGCAA	Negative
TTGGGATGTCTTGAAC	Hashtag5
TTGGGATTCAAATGAG	Hashtag5_Hashtag7
TTGGGATTCCCAGGAC	Negative
TTGGGCGCACCCATAA	Hashtag5
TTGGGCGCAGAACATA	Hashtag5_Hashtag7
TTGGGCGCATCAACCA	Hashtag5
TTGGGCGCATCCAATG	Hashtag5_Hashtag7
TTGGGCGGTGAATTAG	Hashtag5
TTGGGTAAGATTGGGC	Negative
TTGGGTAAGGCCTGCT	Negative
TTGGGTAAGGGATGTC	Hashtag5_Hashtag7
TTGGGTAAGTAAGCAT	Hashtag5
TTGGGTAAGTTCATCG	Hashtag5
TTGGGTAGTCATAAAG	Negative
TTGGTTTAGACAGCTG	Hashtag5
TTGGTTTAGATAGTGT	Hashtag7
TTGGTTTAGGCTAGCA	Hashtag5
TTGGTTTTCCGAAGGA	Negative
TTGGTTTTCTGCTGAA	Negative
TTGTGGAAGACGCATG	Hashtag5
TTGTGGAAGCCAAGTG	Hashtag7
TTGTGGAAGGATGCGT	Hashtag5
TTGTGGACAAGAGGCT	Hashtag5_Hashtag7
TTGTGGAGTTTCTATC	Hashtag7
TTGTGTTTCTGTTGGA	Hashtag5
TTGTTCAAGGGTTGCA	Hashtag7
TTGTTCACAAAGTGTA	Hashtag5_Hashtag7
TTGTTCAGTTTCGATG	Negative
TTGTTCATCGAAGCAG	Hashtag5_Hashtag7
TTGTTCATCTCAATCT	Hashtag5_Hashtag7
TTGTTCATCTTTCGAT	Hashtag5
TTGTTGTAGAATCGTA	Hashtag5_Hashtag7
TTGTTGTAGAGAGTTT	Negative
TTGTTGTGTCACTCTC	Hashtag7
TTGTTGTGTGAGTAGC	Hashtag5
TTGTTGTTCACTGAAC	Hashtag5
TTGTTGTTCCGGCAAC	Negative
TTGTTTGAGAAGCTGC	Hashtag5_Hashtag7
TTGTTTGCAACCCGCA	Hashtag7
TTGTTTGCAATGGCCC	Hashtag5
TTGTTTGTCTGCCTCA	Negative
TTGTTTGTCTTAGCAG	Hashtag5
TTTACCAAGCCTCTCT	Negative
TTTACCAAGCTCCGAC	Hashtag5_Hashtag7
TTTACCACATGAATAG	Hashtag5
TTTACCACATTGAGCT	Negative
TTTACCACATTGGGAG	Hashtag5
TTTACCAGTAACGATA	Hashtag7
TTTACCAGTATGCTTG	Hashtag5
TTTACCAGTGATACAA	Hashtag5_Hashtag7
TTTACCATCAAACTGC	Negative
TTTACCATCCTCAGGG	Hashtag5
TTTACGTAGGATACCG	Hashtag5
TTTACGTAGGTGCATG	Hashtag5_Hashtag7
TTTACGTCAGCGTAGA	Hashtag5_Hashtag7
TTTACGTGTAACACGG	Negative
TTTACGTGTTCAGCGC	Hashtag5
TTTACTGAGACTGAGC	Negative
TTTACTGCAGTAGATA	Hashtag7
TTTACTGTCCCGAGAC	Hashtag7
TTTACTGTCGAGAATA	Negative
TTTACTGTCGATAACC	Hashtag7
TTTAGTCCACTAACCA	Hashtag5
TTTAGTCGTTGCTCCT	Hashtag7
TTTAGTCTCAACTCTT	Hashtag7
TTTAGTCTCCGGCAAC	Negative
TTTAGTCTCTCTCCGA	Hashtag5
TTTATGCAGAGCTGCA	Negative
TTTATGCAGCCTCTCT	Negative
TTTATGCGTGACGCCT	Negative
TTTATGCGTGTCCAAT	Negative
TTTCACAAGCACGATG	Hashtag5
TTTCACACACAACGCC	Hashtag5_Hashtag7
TTTCACAGTAACAGGC	Hashtag5
TTTCACATCACAATGC	Hashtag7
TTTCACATCTACCCAC	Hashtag5
TTTCACATCTTTGCTA	Hashtag5_Hashtag7
TTTCAGTAGAGACAAG	Negative
TTTCAGTCATGACGAG	Hashtag7
TTTCAGTGTATGGTAA	Hashtag5
TTTCAGTGTCGTATGT	Hashtag5
TTTCAGTGTGTGTTTG	Negative
TTTCATGAGAAACTCA	Hashtag5_Hashtag7
TTTCATGAGAATTGCA	Hashtag7
TTTCATGAGAGTCTGG	Hashtag5
TTTCATGCATTCGGGC	Hashtag5
TTTCATGGTAGTCGTT	Hashtag7
TTTCATGGTATGAGAT	Negative
TTTCATGGTGGTAATA	Hashtag5
TTTCATGGTTTGTTCT	Negative
TTTCATGTCAAGCCGC	Negative
TTTCCTCAGGGAGATA	Negative
TTTCCTCAGTGATTCC	Hashtag7
TTTCCTCCATCATTTC	Negative
TTTCCTCTCACACCCT	Negative
TTTCCTCTCTCCTGTG	Hashtag7
TTTCGATAGTATGCAA	Negative
TTTCGATGTTAGGGAC	Negative
TTTCGATTCTACGGTA	Hashtag5
TTTGACTAGGGCTGAT	Negative
TTTGACTCAAGTTCGT	Negative
TTTGACTGTACAATAG	Negative
TTTGACTGTATAGGGC	Hashtag7
TTTGACTGTTTAGAGA	Negative
TTTGACTTCACCTGGG	Hashtag5_Hashtag7
TTTGACTTCCTGGGTG	Negative
TTTGATCAGCAAATCA	Hashtag5
TTTGATCAGGTATAGT	Hashtag5_Hashtag7
TTTGATCCAATCCTAG	Negative
TTTGATCCACTCCACT	Hashtag5_Hashtag7
TTTGATCCATTGTGCA	Hashtag5_Hashtag7
TTTGATCGTAACTAAG	Hashtag5_Hashtag7
TTTGATCGTAGACACG	Hashtag5
TTTGATCTCAGACCTA	Negative
TTTGGAGAGCTCGGCT	Hashtag5_Hashtag7
TTTGGAGCAGTCTGGC	Hashtag5_Hashtag7
TTTGGAGGTCCGGCAT	Negative
TTTGGAGGTTAGAAAC	Hashtag5
TTTGGAGTCAACGTGT	Hashtag7
TTTGGTTGTCACTTCC	Negative
TTTGGTTGTGACACGA	Hashtag7
TTTGGTTGTTAGAAGT	Hashtag5
TTTGTTGAGTATGATG	Negative
TTTGTTGCAGTCTCTC	Hashtag5
TTTGTTGGTGTGTCGC	Hashtag5
TTTGTTGGTTGGGCCT	Hashtag5
TTTGTTGTCGAATGCT	Hashtag5
TTTGTTGTCGACGCTG	Hashtag5
